LSOA Code,other,black,mixed,asian,white,eth_all
E01012334,5,1,29,27,2404,2466
E01012335,1,0,9,11,1362,1383
E01012366,0,6,16,20,1966,2008
E01033481,4,6,16,22,1316,1364
E01033482,1,11,20,23,1566,1621
E01012323,0,2,20,12,1529,1563
E01012324,2,1,7,5,1384,1399
E01032545,1,4,13,8,1233,1259
E01032546,3,8,13,28,1724,1776
E01012328,2,6,13,18,1532,1571
E01012329,0,0,16,20,1734,1770
E01012330,0,0,14,14,1117,1145
E01012331,0,0,13,21,1221,1255
E01012349,3,3,30,25,1471,1532
E01012350,2,8,21,14,1472,1517
E01012351,1,2,41,28,1366,1438
E01012352,2,12,14,26,1525,1579
E01012325,1,7,19,18,1411,1456
E01012326,3,6,14,3,1103,1129
E01012332,2,2,9,8,1406,1427
E01012333,0,5,19,15,1412,1451
E01012309,1,3,10,31,1813,1858
E01012310,4,2,5,7,1942,1960
E01012311,0,0,12,10,1545,1567
E01012312,2,1,11,17,1320,1351
E01012313,7,4,15,4,1372,1402
E01012314,0,3,8,11,1342,1364
E01012362,9,1,12,22,1332,1376
E01012363,12,2,13,20,1287,1334
E01012364,9,5,20,30,1421,1485
E01012365,0,1,9,23,1222,1255
E01012353,10,11,30,102,1459,1612
E01012354,10,19,10,289,1280,1608
E01012355,13,16,27,190,1245,1491
E01033483,0,9,18,48,965,1040
E01033484,0,10,11,34,1112,1167
E01012307,9,9,22,40,1817,1897
E01012327,2,7,16,29,1521,1575
E01012342,2,16,37,34,1689,1778
E01012343,16,10,22,27,1929,2004
E01012315,0,1,22,14,1611,1648
E01012316,18,7,32,43,2415,2515
E01012360,0,1,23,22,1696,1742
E01012336,10,2,15,51,1667,1745
E01012337,0,7,4,40,1682,1733
E01012347,8,2,20,33,1659,1722
E01012348,13,8,22,43,1900,1986
E01012361,3,0,5,30,1871,1909
E01012304,3,15,16,126,1050,1210
E01012305,4,3,10,44,1170,1231
E01012306,5,3,14,44,1525,1591
E01012340,8,5,26,47,2336,2422
E01012341,1,4,19,28,1707,1759
E01012317,1,5,7,16,1341,1370
E01012318,8,32,28,31,2236,2335
E01012319,2,10,40,38,2721,2811
E01012356,6,8,26,39,1521,1600
E01012357,0,2,24,36,1385,1447
E01012358,8,9,12,36,1614,1679
E01012359,0,4,48,22,1512,1586
E01012338,5,1,12,13,1877,1908
E01012339,2,1,12,14,1703,1732
E01012344,2,1,15,17,1302,1337
E01012345,2,7,4,8,1459,1480
E01012346,13,0,16,36,1768,1833
E01020613,0,1,4,28,1359,1392
E01020614,2,0,7,13,1407,1429
E01020622,1,0,9,7,1640,1657
E01020623,0,0,4,15,1484,1503
E01020606,1,1,6,10,1491,1509
E01020615,0,0,8,8,1762,1778
E01020616,0,1,4,18,1665,1688
E01020617,1,1,3,4,1803,1812
E01020596,2,1,5,4,1667,1679
E01020597,1,0,8,6,1480,1495
E01020598,0,2,25,32,1711,1770
E01020611,0,0,8,21,1317,1346
E01020612,0,0,14,31,1581,1626
E01020592,1,5,11,31,1466,1514
E01020593,1,1,7,3,1215,1227
E01020599,2,0,5,3,1691,1701
E01020601,1,3,7,8,1531,1550
E01020602,3,0,11,13,1802,1829
E01020618,1,2,6,18,1531,1558
E01020594,3,1,8,23,1606,1641
E01020595,4,2,12,8,1702,1728
E01020600,0,4,5,16,1490,1515
E01020603,1,2,14,21,1805,1843
E01020605,2,4,6,5,1740,1757
E01020590,0,0,8,7,1354,1369
E01020591,0,0,8,7,1466,1481
E01020608,0,1,25,14,1746,1786
E01020609,1,0,8,2,1392,1403
E01020610,1,0,9,14,1474,1498
E01020604,1,1,10,14,1394,1420
E01020607,3,1,11,10,1589,1614
E01020619,3,0,7,17,1513,1540
E01020620,2,3,4,15,1579,1603
E01020621,1,2,10,18,1825,1856
E01020634,4,1,4,4,1550,1563
E01020635,0,0,7,9,1363,1379
E01020636,3,1,10,6,1678,1698
E01020654,2,0,6,9,1729,1746
E01020676,0,1,6,7,1500,1514
E01020627,4,3,13,10,1508,1538
E01020628,0,1,10,7,1630,1648
E01020629,1,1,6,2,1497,1507
E01020655,1,2,11,12,1982,2008
E01020656,2,0,6,9,1441,1458
E01020657,1,3,6,6,1528,1544
E01020661,4,1,3,21,1851,1880
E01020662,2,1,15,19,1755,1792
E01020663,1,1,6,7,1832,1847
E01020674,0,1,1,6,1578,1586
E01020678,3,0,2,2,1362,1369
E01020626,0,1,2,7,1531,1541
E01020638,1,1,4,20,1536,1562
E01020639,3,0,1,1,1495,1500
E01020653,2,4,10,3,1530,1549
E01020677,0,2,8,2,1522,1534
E01020647,1,0,11,12,2118,2142
E01020648,0,1,3,18,1857,1879
E01020649,1,4,4,5,1533,1547
E01020673,1,3,4,10,1608,1626
E01020675,1,0,7,1,1691,1700
E01020624,0,3,5,8,1546,1562
E01020625,10,3,6,41,1549,1609
E01020670,0,5,10,2,1542,1559
E01020671,0,0,3,4,1339,1346
E01020672,0,1,9,0,1661,1671
E01020632,0,0,9,8,1801,1818
E01020640,3,1,24,34,2292,2354
E01020641,1,2,13,10,2170,2196
E01020642,0,0,3,3,1389,1395
E01020643,0,3,16,19,2119,2157
E01020667,0,0,8,0,1529,1537
E01020650,1,1,6,12,2163,2183
E01020651,2,0,10,28,1696,1736
E01020652,0,0,13,11,1982,2006
E01020668,0,0,2,11,1480,1493
E01020669,1,1,7,7,1458,1474
E01020630,0,3,5,3,1377,1388
E01020631,0,0,5,7,1637,1649
E01020637,0,0,7,1,1649,1657
E01020644,3,0,14,16,2424,2457
E01020645,1,1,9,7,1471,1489
E01020633,2,5,7,0,1550,1564
E01020664,0,0,8,14,1388,1410
E01020665,1,1,11,10,1333,1356
E01020666,1,4,8,7,1439,1459
E01020646,0,1,9,2,1574,1586
E01020658,1,1,6,5,1798,1811
E01020659,0,2,8,10,1556,1576
E01020660,1,5,1,2,1588,1597
E01020709,15,34,72,80,2263,2464
E01020717,6,1,7,40,1560,1614
E01020718,12,1,10,16,1284,1323
E01020719,10,0,9,16,1201,1236
E01020721,2,2,8,31,1139,1182
E01020708,10,2,20,39,1089,1160
E01020710,21,9,22,58,1471,1581
E01020711,5,6,29,78,1629,1747
E01020720,7,11,13,46,1337,1414
E01020679,4,0,9,16,1571,1600
E01020680,4,1,8,8,1614,1635
E01020681,1,0,3,8,1455,1467
E01020714,5,0,4,24,1518,1551
E01020716,5,2,6,9,1687,1709
E01020725,1,0,0,3,1530,1534
E01020726,0,3,1,13,1212,1229
E01020727,1,5,11,13,1057,1087
E01020729,0,6,15,14,2083,2118
E01020730,2,0,3,8,1672,1685
E01020731,2,0,1,12,1440,1455
E01020682,0,5,12,14,1853,1884
E01020683,1,1,6,14,1631,1653
E01020690,1,8,5,7,1269,1290
E01020691,0,2,10,13,1307,1332
E01020692,5,4,9,25,1347,1390
E01020693,11,8,14,49,1250,1332
E01020722,16,10,18,69,1895,2008
E01020723,23,11,30,66,1601,1731
E01020724,14,4,21,47,1527,1613
E01020703,14,8,55,90,1906,2073
E01033164,20,14,72,128,2050,2284
E01033195,7,8,28,66,1278,1387
E01033197,12,14,42,88,1854,2010
E01033221,72,54,95,514,3759,4494
E01020684,13,11,14,49,2230,2317
E01020702,65,29,58,115,2064,2331
E01020704,9,13,37,74,1765,1898
E01020712,14,8,33,50,1505,1610
E01020713,14,8,31,110,1865,2028
E01020705,0,3,7,7,1433,1450
E01020706,0,1,6,1,1832,1840
E01020715,0,6,8,21,2358,2393
E01020685,1,6,17,7,1626,1657
E01020686,5,5,7,10,1545,1572
E01020687,2,3,4,3,1415,1427
E01020688,5,1,16,4,1504,1530
E01020689,8,2,11,14,1442,1477
E01020694,12,0,5,24,1410,1451
E01020696,7,0,14,11,1244,1276
E01020697,14,2,16,90,1454,1576
E01020732,6,3,13,48,1726,1796
E01020695,0,1,7,15,1759,1782
E01020698,0,1,4,15,1580,1600
E01020699,5,0,5,1,1161,1172
E01020700,0,0,4,6,1565,1575
E01020701,4,0,9,19,1313,1345
E01020750,0,1,0,18,1228,1247
E01020781,0,0,4,9,1113,1126
E01020786,1,0,2,6,1597,1606
E01020787,1,0,9,9,1814,1833
E01033163,5,1,10,14,1948,1978
E01033202,1,0,3,2,1160,1166
E01020740,0,5,4,17,1388,1414
E01020741,1,1,10,22,1211,1245
E01020742,5,0,6,14,1656,1681
E01020782,3,1,2,6,1184,1196
E01020783,6,1,10,9,1321,1347
E01020784,6,4,7,15,1430,1462
E01020743,1,1,14,12,1390,1418
E01020747,0,0,4,3,1291,1298
E01020748,4,0,2,11,1268,1285
E01020749,5,1,6,7,1369,1388
E01020773,1,1,10,5,1372,1389
E01020775,0,4,12,4,1692,1712
E01020776,1,0,6,1,1847,1855
E01033161,1,0,8,7,1533,1549
E01033198,0,2,9,11,1448,1470
E01033205,5,0,15,20,1457,1497
E01033206,2,1,3,10,1519,1535
E01020751,0,0,5,6,1851,1862
E01020752,3,0,5,4,1187,1199
E01020754,0,0,9,7,1307,1323
E01020756,0,2,4,3,1339,1348
E01020745,0,2,8,8,1329,1347
E01020753,0,2,7,7,1945,1961
E01020757,1,1,6,1,1136,1145
E01020758,0,2,12,5,1422,1441
E01020759,1,0,8,10,1096,1115
E01020765,0,3,11,6,1693,1713
E01020760,0,0,7,8,1619,1634
E01020761,8,3,5,20,1255,1291
E01020762,0,1,3,11,1419,1434
E01020763,1,0,11,15,1804,1831
E01020764,1,0,7,3,1359,1370
E01020766,0,3,6,7,1436,1452
E01020767,0,0,15,47,1899,1961
E01020768,0,0,8,5,1578,1591
E01020733,1,1,6,16,1227,1251
E01020734,0,0,3,0,1222,1225
E01020735,0,0,2,0,1414,1416
E01020770,0,1,7,1,1219,1228
E01020771,0,0,5,5,1040,1050
E01020780,4,0,9,4,1150,1167
E01020746,0,0,5,14,1160,1179
E01020769,0,0,8,8,1252,1268
E01020777,0,1,8,6,1457,1472
E01020778,0,1,6,18,1171,1196
E01020779,2,4,5,16,1630,1657
E01020736,2,0,6,3,1193,1204
E01020737,1,1,2,5,1386,1395
E01020738,0,2,6,1,1004,1013
E01020739,3,0,4,12,1306,1325
E01020744,0,2,8,4,993,1007
E01020788,0,0,15,15,1508,1538
E01020789,1,2,9,16,1408,1436
E01020790,0,0,8,4,1316,1328
E01020791,0,6,8,5,1280,1299
E01020792,2,1,7,7,1467,1484
E01020772,3,2,21,19,1956,2001
E01020793,0,4,7,15,1681,1707
E01020794,1,0,4,10,1765,1780
E01020795,3,0,5,13,1769,1790
E01020817,2,0,5,1,1271,1279
E01020818,0,0,5,5,1467,1477
E01020819,4,1,6,5,1062,1078
E01020837,0,0,2,4,1728,1734
E01020843,2,0,11,20,1580,1613
E01020809,0,0,5,0,1430,1435
E01020810,0,0,10,0,1300,1310
E01020811,0,2,12,13,1251,1278
E01020812,1,1,5,6,1510,1523
E01020827,0,2,7,5,1810,1824
E01020806,0,0,8,14,1415,1437
E01020807,6,1,9,19,1288,1323
E01020820,0,5,4,1,1506,1516
E01020842,1,11,7,14,1980,2013
E01020797,1,3,11,21,2465,2501
E01020798,0,1,2,4,1477,1484
E01020799,0,4,8,2,1456,1470
E01020808,0,4,8,5,1404,1421
E01020821,4,3,10,10,1845,1872
E01020822,0,2,6,5,1821,1834
E01020823,2,1,8,10,1748,1769
E01020835,1,4,5,7,1647,1664
E01020836,2,1,6,5,1953,1967
E01020803,5,1,15,3,1951,1975
E01020805,0,0,3,1,1977,1981
E01033203,3,2,17,4,2779,2805
E01020796,2,6,5,3,1259,1275
E01020828,2,1,9,0,1639,1651
E01020829,7,3,22,12,2399,2443
E01020830,0,1,8,2,1499,1510
E01020801,2,1,8,6,1531,1548
E01020802,1,4,17,6,2077,2105
E01020838,0,0,3,0,1727,1730
E01020839,0,4,10,11,1612,1637
E01020840,1,0,8,3,1568,1580
E01020841,0,2,5,8,1748,1763
E01020813,1,0,10,5,1229,1245
E01020814,0,3,15,18,1429,1465
E01020815,0,0,3,3,1212,1218
E01020848,6,2,8,6,1120,1142
E01020850,0,0,6,35,1885,1926
E01020851,0,1,6,10,1404,1421
E01020816,9,6,12,22,1480,1529
E01020844,1,5,10,1,1567,1584
E01020847,0,0,12,1,1555,1568
E01020849,0,1,6,4,1275,1286
E01020825,0,1,6,0,1562,1569
E01020831,0,1,3,0,1435,1439
E01020833,1,0,9,4,1222,1236
E01020834,0,1,3,5,1274,1283
E01020824,0,2,12,8,1522,1544
E01020826,0,0,5,4,1501,1510
E01020832,1,1,8,5,1377,1392
E01020845,0,2,13,6,1330,1351
E01020846,2,4,7,3,1221,1237
E01020856,1,1,10,3,1516,1531
E01020858,0,0,0,1,1061,1062
E01020859,0,0,3,9,1216,1228
E01020860,0,1,8,2,1045,1056
E01020861,1,0,2,3,1163,1169
E01020862,1,4,10,7,2369,2391
E01020864,1,0,4,6,2057,2068
E01020867,0,3,15,4,2232,2254
E01020857,2,1,2,0,1517,1522
E01020863,0,0,6,7,1377,1390
E01020865,2,0,8,2,1316,1328
E01020866,2,0,12,0,987,1001
E01020852,1,0,9,30,1636,1676
E01020853,0,0,4,4,1520,1528
E01020854,11,13,41,28,2539,2632
E01020855,0,0,3,7,1194,1204
E01020889,0,0,8,6,1467,1481
E01020890,1,3,9,4,1760,1777
E01020891,0,2,9,5,1596,1612
E01020905,1,0,4,5,1520,1530
E01020906,0,1,8,18,1636,1663
E01020876,1,1,14,8,1714,1738
E01020878,0,6,12,11,1692,1721
E01020887,0,0,1,2,1880,1883
E01020892,1,0,8,5,1090,1104
E01020894,0,0,6,4,1241,1251
E01020898,1,0,9,11,1510,1531
E01020877,0,1,12,10,1539,1562
E01020879,0,0,2,10,2134,2146
E01020893,1,3,8,4,1679,1695
E01020899,0,3,5,2,1282,1292
E01020903,0,0,10,1,1153,1164
E01020904,5,1,5,15,1729,1755
E01020873,0,2,6,5,1440,1453
E01020875,1,0,7,2,1291,1301
E01020900,0,0,2,7,1400,1409
E01020901,2,1,9,14,1388,1414
E01020902,0,0,6,2,1440,1448
E01020868,3,0,11,19,1752,1785
E01020869,2,3,21,12,1358,1396
E01020874,3,1,5,8,1451,1468
E01020880,0,0,17,11,1533,1561
E01020881,0,0,4,29,1323,1356
E01020870,1,1,6,18,1334,1360
E01020871,1,5,11,12,1382,1411
E01020872,1,7,11,7,1782,1808
E01020883,2,1,4,14,1690,1711
E01020886,1,0,10,5,1243,1259
E01020882,0,0,8,3,1449,1460
E01020888,0,1,2,4,1950,1957
E01020895,0,2,9,20,1454,1485
E01020896,1,1,6,7,1365,1380
E01020897,0,3,28,21,2421,2473
E01020884,5,0,6,0,1406,1417
E01020885,1,5,5,7,1125,1143
E01020907,7,0,5,10,1586,1608
E01020908,2,0,8,7,1387,1404
E01020909,1,0,10,4,1670,1685
E01011954,1,1,6,3,2160,2171
E01011969,1,1,4,3,1364,1373
E01011970,0,0,5,12,1139,1156
E01011971,0,0,6,7,1439,1452
E01033465,1,1,12,42,1698,1754
E01033467,0,1,13,17,1147,1178
E01011952,2,7,11,21,1629,1670
E01011953,0,2,12,13,1859,1886
E01011991,0,1,12,9,1808,1830
E01011992,2,6,13,7,1554,1582
E01011993,1,3,13,14,1744,1775
E01011994,1,1,12,25,1534,1573
E01011955,0,2,10,28,1326,1366
E01011957,5,3,8,39,1262,1317
E01032540,0,3,3,2,991,999
E01032541,0,6,7,12,2146,2171
E01033466,0,4,6,4,1968,1982
E01011973,1,15,10,89,1205,1320
E01011974,6,12,29,78,1562,1687
E01011975,2,0,6,8,1308,1324
E01011976,8,4,3,47,964,1026
E01011965,0,0,10,28,1611,1649
E01011966,0,5,4,14,1344,1367
E01011983,4,1,7,34,1670,1716
E01012002,1,0,18,15,1344,1378
E01011951,2,3,4,16,1366,1391
E01011964,2,30,19,197,1241,1489
E01011967,0,0,7,7,1483,1497
E01011999,15,9,27,87,2053,2191
E01012000,2,11,16,40,1290,1359
E01011950,3,1,8,3,1437,1452
E01011986,0,1,2,6,1265,1274
E01011987,0,2,5,4,1391,1402
E01012001,10,2,8,21,1910,1951
E01011949,4,0,11,20,1907,1942
E01011980,2,0,6,18,1675,1701
E01011981,0,0,5,5,1656,1666
E01011984,0,3,10,3,1234,1250
E01011985,3,1,3,1,1161,1169
E01011988,1,0,6,18,1889,1914
E01011989,4,0,11,17,1845,1877
E01011990,0,0,6,9,1709,1724
E01011995,1,0,8,1,1419,1429
E01011996,3,0,5,15,1495,1518
E01011997,0,6,9,5,2021,2041
E01011998,2,0,12,2,1454,1470
E01011961,0,1,7,1,1433,1442
E01011962,1,1,7,17,1430,1456
E01011977,1,0,27,26,1694,1748
E01011978,0,1,14,1,1541,1557
E01011979,0,0,8,14,1525,1547
E01011959,3,11,15,61,1971,2061
E01011960,0,0,4,4,1386,1394
E01011963,1,1,5,6,1405,1418
E01011968,1,0,3,8,2120,2132
E01011982,1,5,9,29,1256,1300
E01012003,1,2,8,17,1513,1541
E01012005,6,0,15,54,1948,2023
E01012068,111,107,56,511,1584,2369
E01012092,150,127,58,511,1345,2191
E01012093,102,73,68,949,783,1975
E01012094,81,78,79,965,1371,2574
E01033468,106,71,77,813,1470,2537
E01012058,11,35,45,85,1449,1625
E01012059,5,30,45,125,1292,1497
E01012060,0,11,17,16,1639,1683
E01012061,7,9,19,19,1409,1463
E01012036,71,83,43,331,1006,1534
E01012037,38,101,42,166,1193,1540
E01012038,34,63,49,179,1181,1506
E01012039,45,108,63,358,936,1510
E01012040,53,63,40,370,940,1466
E01012041,24,28,22,51,903,1028
E01012074,1,9,18,19,1503,1550
E01012075,1,8,25,8,1563,1605
E01012076,4,27,13,8,1499,1551
E01012077,1,18,17,4,1323,1363
E01012088,1,5,31,10,1400,1447
E01012078,36,28,45,277,1067,1453
E01012079,15,6,17,173,1232,1443
E01012080,10,2,27,98,1132,1269
E01012081,15,17,55,312,1355,1754
E01012026,24,20,26,162,1362,1594
E01012027,13,6,29,84,1622,1754
E01033469,11,15,38,92,1842,1998
E01012015,3,8,10,10,1470,1501
E01012016,4,30,29,9,1626,1698
E01012017,2,8,13,19,1531,1573
E01012089,1,16,29,11,1492,1549
E01012090,2,33,13,20,1478,1546
E01012091,3,13,28,11,1693,1748
E01012011,18,13,41,21,1768,1861
E01012012,17,12,38,167,1561,1795
E01012013,2,14,17,15,1259,1307
E01012014,11,21,62,65,1393,1552
E01012053,26,6,47,311,1296,1686
E01012054,35,7,43,366,1309,1760
E01012055,13,6,44,334,1544,1941
E01012056,111,26,55,200,1912,2304
E01012057,30,16,56,294,1624,2020
E01012082,2,8,26,14,1528,1578
E01012083,0,19,23,5,1508,1555
E01012084,0,20,41,5,1584,1650
E01012085,0,1,27,7,1436,1471
E01012018,20,30,27,185,1414,1676
E01012019,6,9,36,11,1234,1296
E01012020,11,19,19,70,1458,1577
E01012021,9,8,21,26,1319,1383
E01012007,3,20,4,112,1346,1485
E01012008,1,3,15,69,1333,1421
E01012009,8,6,11,136,1596,1757
E01012010,9,8,16,139,1192,1364
E01012046,13,2,16,145,1554,1730
E01012047,7,2,17,234,1350,1610
E01012048,13,4,12,119,1586,1734
E01012049,9,11,19,49,1326,1414
E01012050,2,24,25,51,1376,1478
E01012051,11,26,26,44,1257,1364
E01012052,2,4,15,65,1241,1327
E01012022,3,5,12,25,1473,1518
E01012023,0,0,5,39,1328,1372
E01012024,2,0,20,34,1469,1525
E01012025,25,1,16,47,1208,1297
E01012065,1,7,11,30,1613,1662
E01012066,4,2,8,57,1970,2041
E01012067,12,0,12,74,1504,1602
E01012042,1,3,9,4,1440,1457
E01012043,1,7,11,5,1428,1452
E01012044,5,12,15,12,1530,1574
E01012045,3,14,21,7,1426,1471
E01032552,0,1,15,5,1626,1647
E01032553,1,3,14,8,1217,1243
E01012030,0,4,21,15,1488,1528
E01012031,6,4,18,12,1519,1559
E01012032,2,1,19,20,1693,1735
E01012033,3,2,13,3,1282,1303
E01012034,3,10,18,12,1458,1501
E01012035,2,12,13,12,1302,1341
E01012062,3,2,21,42,1409,1477
E01012063,1,2,13,23,1374,1413
E01012064,18,11,22,90,1697,1838
E01012071,2,13,9,56,1392,1472
E01012073,8,3,18,33,1362,1424
E01032593,16,11,23,68,1852,1970
E01027356,0,1,11,7,1700,1719
E01027357,2,0,6,9,1333,1350
E01027366,1,1,9,3,1511,1525
E01027367,3,2,13,14,1928,1960
E01027358,1,1,2,11,1985,2000
E01027359,1,3,13,24,2276,2317
E01033715,2,1,4,11,1019,1037
E01033717,2,0,10,16,1384,1412
E01027361,2,2,11,9,2085,2109
E01027362,0,2,5,7,1245,1259
E01027363,4,1,1,0,1191,1197
E01027364,1,1,4,3,2045,2054
E01027370,1,1,7,6,1822,1837
E01027371,0,0,2,1,1831,1834
E01027372,0,1,4,2,2111,2118
E01027365,0,0,3,5,2185,2193
E01027368,0,2,7,12,1745,1766
E01027369,1,1,5,7,1533,1547
E01027373,3,0,3,6,1991,2003
E01027376,0,0,8,9,1724,1741
E01027377,6,3,13,27,1623,1672
E01027385,0,4,7,12,1310,1333
E01027387,2,0,11,35,1755,1803
E01027388,3,2,12,6,1423,1446
E01027389,1,2,5,14,1603,1625
E01027378,0,0,7,7,1050,1064
E01027379,0,6,3,4,1361,1374
E01027380,0,3,9,11,1390,1413
E01027382,2,5,12,5,1663,1687
E01027386,0,1,2,4,1352,1359
E01027374,4,2,7,3,2037,2053
E01027375,2,0,8,8,1755,1773
E01027381,2,1,7,1,1837,1848
E01027383,0,0,2,5,1339,1346
E01027384,1,0,5,2,1439,1447
E01027390,1,0,4,2,1976,1983
E01027392,1,1,5,10,1686,1703
E01027393,1,0,15,11,1512,1539
E01027416,2,4,18,17,1517,1558
E01027424,4,1,12,19,2024,2060
E01027414,1,0,6,20,1442,1469
E01027415,0,0,17,31,1617,1665
E01027431,0,1,9,19,1678,1707
E01027441,1,1,10,19,1980,2011
E01027442,3,0,13,25,1538,1579
E01027391,0,0,4,27,1472,1503
E01027422,5,2,12,8,1818,1845
E01027423,0,1,5,6,1503,1515
E01027429,0,3,10,9,1827,1849
E01027430,0,0,12,6,1611,1629
E01027425,1,1,9,38,2239,2288
E01027426,1,0,10,49,1482,1542
E01027427,1,0,2,10,1644,1657
E01027428,1,1,2,18,1521,1543
E01027437,0,0,5,0,1812,1817
E01027438,1,0,1,1,1485,1488
E01027439,1,1,8,8,1936,1954
E01027440,1,0,1,11,1405,1418
E01027400,3,0,6,4,1347,1360
E01027401,2,1,8,11,1478,1500
E01027402,0,4,6,11,1313,1334
E01027403,2,4,7,5,1168,1186
E01027398,0,4,18,14,2265,2301
E01027409,1,1,9,6,1514,1531
E01027411,0,0,2,1,1355,1358
E01027412,1,2,21,2,1545,1571
E01027413,1,1,12,29,1829,1872
E01027395,0,1,15,11,1464,1491
E01027396,0,0,8,9,1375,1392
E01027397,1,0,10,7,1386,1404
E01027399,0,1,13,5,1489,1508
E01027404,0,0,15,3,1522,1540
E01027405,0,0,6,1,1441,1448
E01027417,0,1,7,7,1510,1525
E01027418,1,0,15,14,1811,1841
E01027419,0,3,6,5,1543,1557
E01027420,0,2,2,1,1407,1412
E01027421,1,0,10,0,1459,1470
E01027394,0,0,3,1,1149,1153
E01027406,0,0,4,5,1275,1284
E01027407,1,1,2,10,1263,1277
E01027408,0,0,5,8,1276,1289
E01027410,3,0,11,2,1598,1614
E01027432,1,1,16,9,1522,1549
E01027433,0,1,5,16,1656,1678
E01027434,0,1,5,1,1393,1400
E01027435,0,1,4,3,1423,1431
E01027436,1,0,5,7,1546,1559
E01027443,0,0,7,4,1472,1483
E01027444,9,88,55,84,2232,2468
E01027445,0,2,12,5,1598,1617
E01027446,0,0,7,6,1354,1367
E01027451,0,1,14,8,1835,1858
E01027474,0,0,8,17,1859,1884
E01027475,1,1,7,4,1402,1415
E01027457,2,6,8,12,1562,1590
E01027462,0,6,13,9,1853,1881
E01027463,1,4,9,12,1683,1709
E01027447,1,0,7,8,1761,1777
E01027448,2,0,6,15,1916,1939
E01027450,1,0,14,2,1628,1645
E01027473,3,1,8,6,1736,1754
E01027452,0,8,8,31,1382,1429
E01027453,4,7,9,5,1402,1427
E01027461,0,1,9,3,1328,1341
E01033718,0,5,14,9,2056,2084
E01027455,3,0,2,7,1508,1520
E01027456,8,0,1,18,1314,1341
E01027458,1,6,9,12,1575,1603
E01027460,8,0,13,27,1634,1682
E01027464,8,1,8,53,1283,1353
E01027465,0,0,9,23,1461,1493
E01027466,0,2,15,20,1178,1215
E01033714,9,11,16,152,2267,2455
E01027449,3,0,7,9,1544,1563
E01027468,6,0,9,40,1213,1268
E01027469,11,5,15,134,1299,1464
E01027471,3,3,16,129,1522,1673
E01027472,1,9,16,31,1683,1740
E01027479,3,2,11,6,2290,2312
E01027480,1,0,0,0,1218,1219
E01027503,0,2,11,14,1735,1762
E01027511,0,0,3,1,1101,1105
E01027484,5,2,9,4,2250,2270
E01027485,0,1,6,3,1482,1492
E01027486,0,4,2,4,1143,1153
E01027487,0,0,0,0,1146,1146
E01027512,0,1,6,4,1030,1041
E01027483,1,0,10,4,1373,1388
E01027496,0,1,14,10,1197,1222
E01027508,1,0,10,8,1067,1086
E01027513,2,2,11,3,1906,1924
E01027476,4,1,13,15,2278,2311
E01027489,10,0,13,10,1572,1605
E01027490,3,0,19,5,1813,1840
E01027491,0,0,16,6,1586,1608
E01027492,1,4,11,2,1855,1873
E01027493,1,0,16,18,1587,1622
E01027494,2,1,23,10,2202,2238
E01027497,0,1,13,6,2668,2688
E01027498,1,0,16,11,2625,2653
E01027499,2,1,2,5,1477,1487
E01027500,1,2,18,41,1627,1689
E01027501,0,1,5,8,1079,1093
E01027502,0,0,1,9,1233,1243
E01027481,1,1,10,3,1632,1647
E01027482,1,1,10,9,1498,1519
E01027504,2,2,12,9,1966,1991
E01027506,0,0,6,7,1135,1148
E01027507,1,0,10,8,1367,1386
E01027509,0,0,7,8,1346,1361
E01027477,0,1,8,3,1211,1223
E01027478,1,3,2,13,1058,1077
E01027488,0,2,12,9,2161,2184
E01027495,0,0,7,4,1069,1080
E01027505,1,2,9,1,1395,1408
E01027510,1,0,7,6,1150,1164
E01027541,1,1,6,15,1769,1792
E01027542,4,1,11,4,1791,1811
E01027543,0,1,10,10,1323,1344
E01027544,2,0,7,4,1348,1361
E01027528,0,1,10,34,1234,1279
E01027529,3,1,5,13,1131,1153
E01027539,2,5,7,79,1632,1725
E01027545,0,1,11,26,2011,2049
E01027546,7,2,17,29,1679,1734
E01027533,0,0,16,10,1683,1709
E01027540,1,2,12,60,1824,1899
E01027549,7,0,3,43,1520,1573
E01033716,0,0,9,27,2338,2374
E01027524,1,0,3,16,1449,1469
E01027525,0,0,8,5,1695,1708
E01027526,0,2,2,15,1252,1271
E01027527,5,0,17,13,1282,1317
E01027536,1,1,4,1,1455,1462
E01027532,1,1,10,9,1869,1890
E01027537,0,1,4,10,1362,1377
E01027538,2,0,5,6,1787,1800
E01027530,0,0,5,6,1431,1442
E01027531,1,0,7,15,1677,1700
E01027534,0,3,15,13,1878,1909
E01027535,0,1,7,2,1424,1434
E01027553,0,0,9,10,1624,1643
E01027554,0,1,3,1,1331,1336
E01027515,0,0,6,7,1420,1433
E01027517,4,6,2,11,1900,1923
E01027518,0,0,3,6,1460,1469
E01027519,1,0,9,5,1437,1452
E01027550,0,0,4,1,1283,1288
E01027551,1,0,5,7,1432,1445
E01027552,2,4,5,4,1250,1265
E01027514,0,2,8,7,1580,1597
E01027516,0,0,1,14,1249,1264
E01027520,0,0,5,7,1500,1512
E01027521,4,0,15,49,1640,1708
E01027522,0,0,6,2,1277,1285
E01027523,1,0,6,2,1143,1152
E01012100,1,3,16,20,1563,1603
E01012101,0,1,10,14,1486,1511
E01012102,0,6,20,16,2170,2212
E01012184,0,0,14,5,1465,1484
E01012105,1,2,10,9,1353,1375
E01012142,0,0,3,12,1679,1694
E01012143,0,1,9,8,1260,1278
E01012144,1,6,11,19,1350,1387
E01012106,0,1,11,7,1350,1369
E01012107,0,2,10,9,1383,1404
E01032560,0,0,5,2,1062,1069
E01032561,0,1,13,9,1515,1538
E01012176,0,0,16,11,1405,1432
E01012177,0,4,5,4,1473,1486
E01012178,1,2,7,5,1409,1424
E01012179,1,5,10,7,1459,1482
E01012180,0,0,9,5,1778,1792
E01012185,1,0,12,2,1450,1465
E01012186,3,1,15,10,1613,1642
E01012127,0,2,5,13,1022,1042
E01012128,0,1,6,2,1110,1119
E01012129,1,0,14,6,2164,2185
E01012130,6,3,12,5,1258,1284
E01012131,5,0,12,6,1392,1415
E01012138,0,1,13,16,2661,2691
E01012139,6,0,11,4,1921,1942
E01012140,0,1,8,3,1317,1329
E01012141,3,0,3,6,1087,1099
E01012154,1,1,5,4,1260,1271
E01012155,0,1,12,3,1456,1472
E01012156,2,1,10,11,1714,1738
E01012157,1,0,12,2,1619,1634
E01012158,1,0,6,4,1401,1412
E01012159,3,1,18,16,1573,1611
E01012160,1,0,8,3,1422,1434
E01012161,3,0,19,9,1470,1501
E01012113,1,0,5,8,1415,1429
E01012114,5,1,22,7,1361,1396
E01012175,6,0,16,1,1403,1426
E01033471,4,3,14,3,2239,2263
E01012095,0,1,8,1,1343,1353
E01012097,0,0,2,3,1175,1180
E01012098,0,2,9,2,1289,1302
E01012099,1,0,2,10,1546,1559
E01012108,0,2,7,5,1448,1462
E01012109,0,0,9,3,1384,1396
E01012110,0,4,1,4,1384,1393
E01012111,1,0,6,1,1280,1288
E01012171,0,0,7,5,1423,1435
E01012172,1,1,4,2,1375,1383
E01012162,2,2,1,1,1458,1464
E01012163,2,2,11,4,2162,2181
E01012164,1,0,22,3,1568,1594
E01012165,1,1,6,18,2189,2215
E01012096,3,1,10,2,1590,1606
E01012136,1,0,4,6,1415,1426
E01033473,4,3,8,1,2129,2145
E01012112,0,1,18,3,1444,1466
E01012145,1,1,7,4,1459,1472
E01012147,0,3,4,5,1583,1595
E01012149,1,0,6,1,1195,1203
E01012132,4,2,8,5,2003,2022
E01012134,1,0,9,7,1430,1447
E01012137,0,0,6,0,1358,1364
E01012181,1,0,14,27,1644,1686
E01012117,0,1,8,14,1397,1420
E01012118,3,1,9,1,1344,1358
E01012119,9,1,10,22,2087,2129
E01012121,0,1,7,7,1339,1354
E01032548,0,2,5,10,1549,1566
E01032549,1,3,13,26,1621,1664
E01033472,1,10,18,7,2492,2528
E01012120,4,0,5,8,1344,1361
E01012124,2,0,8,21,1402,1433
E01012182,0,0,0,1,1422,1423
E01012183,0,0,4,4,1533,1541
E01012148,5,5,10,10,1381,1411
E01012150,1,0,14,1,1516,1532
E01012151,5,1,8,8,1449,1471
E01012152,1,0,9,15,1538,1563
E01032594,4,2,14,8,1348,1376
E01012146,0,0,3,13,1233,1249
E01012167,0,0,6,16,1456,1478
E01012168,0,0,17,11,1892,1920
E01012170,0,4,20,51,1302,1377
E01012173,0,0,7,3,1153,1163
E01012174,0,3,8,3,1096,1110
E01033470,11,11,24,180,1547,1773
E01012242,3,1,13,7,1495,1519
E01012243,2,1,9,20,1574,1606
E01012244,0,4,3,6,1432,1445
E01012246,1,0,7,9,1434,1451
E01012296,1,1,4,18,1343,1367
E01012297,9,0,21,29,2585,2644
E01012197,1,1,22,3,2002,2029
E01012256,1,2,10,6,1302,1321
E01012257,0,2,3,3,1425,1433
E01012275,0,3,7,8,1526,1544
E01012276,2,1,12,7,1581,1603
E01012277,0,0,16,12,1637,1665
E01012196,1,0,8,5,1656,1670
E01012198,2,8,16,3,1446,1475
E01012214,2,4,14,4,1630,1654
E01012215,5,4,8,12,1278,1307
E01012216,1,2,11,10,1278,1302
E01012245,0,2,20,0,1583,1605
E01012278,5,2,8,23,1297,1335
E01012279,1,1,5,0,1769,1776
E01012280,3,2,20,2,1542,1569
E01012281,0,8,15,13,1273,1309
E01012255,0,0,1,5,1417,1423
E01012269,9,0,8,33,1623,1673
E01012294,0,1,13,20,1175,1209
E01012295,4,0,6,13,1187,1210
E01033476,9,9,40,133,1448,1639
E01033480,1,1,16,51,1570,1639
E01012210,0,2,8,42,1532,1584
E01012211,0,5,11,14,1810,1840
E01012212,2,1,8,17,1441,1469
E01012213,0,1,5,6,1381,1393
E01012192,0,4,12,13,1554,1583
E01012193,7,1,8,33,1507,1556
E01012260,3,2,9,16,1623,1653
E01012261,3,1,7,28,1470,1509
E01012247,4,8,18,37,1210,1277
E01012249,0,5,23,34,1518,1580
E01012271,1,10,20,32,1433,1496
E01012272,0,1,5,19,1040,1065
E01012273,2,8,12,8,1552,1582
E01012274,6,4,15,24,1292,1341
E01012248,2,2,11,39,1374,1428
E01012250,4,6,15,50,1386,1461
E01032542,3,5,7,25,1080,1120
E01032543,2,1,11,34,2165,2213
E01032544,5,7,26,64,1931,2033
E01012194,3,8,26,16,1486,1539
E01012195,3,12,30,33,1485,1563
E01012258,5,15,68,30,1936,2054
E01012259,1,3,13,18,1741,1776
E01012268,1,48,21,22,1570,1662
E01012187,0,0,1,35,1354,1390
E01012188,1,4,3,29,1168,1205
E01012189,1,0,6,24,1367,1398
E01012205,1,9,4,27,1361,1402
E01012219,10,8,20,50,1687,1775
E01012251,1,11,28,56,1569,1665
E01012252,4,18,23,23,1482,1550
E01012253,0,1,4,24,1281,1310
E01012254,7,34,21,72,1305,1439
E01012204,2,1,6,17,1277,1303
E01012206,2,5,8,50,1395,1460
E01012207,5,14,26,65,1822,1932
E01012208,3,2,8,29,1606,1648
E01012262,36,92,66,410,1620,2224
E01012264,22,34,35,126,2167,2384
E01012266,19,180,53,167,2016,2435
E01012267,22,43,26,252,1329,1672
E01033477,24,78,63,655,1698,2518
E01012190,9,1,3,16,1464,1493
E01012191,2,1,11,28,1616,1658
E01012224,3,5,15,16,1742,1781
E01012225,0,9,10,40,1472,1531
E01012226,1,1,1,22,1356,1381
E01012209,5,12,15,61,1616,1709
E01012217,16,12,31,147,1340,1546
E01012218,5,6,25,150,1393,1579
E01012223,1,1,15,32,1515,1564
E01012286,7,23,29,154,1230,1443
E01012287,41,29,39,321,1902,2332
E01012288,9,19,24,245,1176,1473
E01012289,2,12,5,179,1085,1283
E01012238,3,5,25,34,1478,1545
E01012239,4,25,55,37,1873,1994
E01012240,2,6,13,23,1742,1786
E01012241,1,3,12,5,1468,1489
E01012290,4,8,18,45,1684,1759
E01012291,8,9,24,83,1692,1816
E01012292,8,9,19,88,2192,2316
E01012282,6,5,5,26,1257,1299
E01012283,2,8,15,6,1297,1328
E01012284,3,10,14,22,1504,1553
E01012285,1,10,16,19,1279,1325
E01012199,2,2,16,33,1393,1446
E01012200,10,5,34,37,1919,2005
E01012201,0,6,12,42,1743,1803
E01012202,1,1,15,34,1457,1508
E01012203,4,11,19,52,1711,1797
E01012270,0,5,10,25,1329,1369
E01012228,2,4,8,50,1357,1421
E01012230,6,10,18,144,1410,1588
E01012233,4,2,13,37,1381,1437
E01012236,4,6,12,97,1232,1351
E01012237,10,1,16,119,1217,1363
E01012227,6,3,12,64,1474,1559
E01012231,9,2,14,75,1922,2022
E01012232,1,13,17,45,1355,1431
E01012234,1,7,13,40,1633,1694
E01033474,3,8,25,86,1523,1645
E01033475,9,14,19,157,1641,1840
E01033478,13,12,16,96,1754,1891
E01033479,8,6,19,82,1688,1803
E01012235,1,7,19,51,1283,1361
E01012298,1,4,23,55,1310,1393
E01012299,9,11,19,64,1378,1481
E01012300,11,3,17,29,1456,1516
E01012301,1,4,17,67,1279,1368
E01012302,4,3,15,19,1204,1245
E01012303,6,0,14,13,1348,1381
E01008246,0,1,3,6,1448,1458
E01008247,4,2,9,5,1596,1616
E01008248,2,5,5,13,1727,1752
E01008249,0,1,14,20,1519,1554
E01008250,1,1,9,5,1457,1473
E01008195,2,2,11,6,2044,2065
E01008197,0,1,3,10,1472,1486
E01008198,1,1,11,2,1416,1431
E01008199,0,0,7,7,1365,1379
E01008200,3,4,11,8,1310,1336
E01008245,0,0,12,6,1419,1437
E01008214,5,23,19,35,1598,1680
E01008215,12,21,32,23,1510,1598
E01008243,2,4,16,8,1495,1525
E01008244,9,7,18,67,1963,2064
E01008178,5,5,16,14,1670,1710
E01008180,2,2,15,8,1492,1519
E01008182,6,4,16,14,1601,1641
E01008277,0,4,2,15,1510,1531
E01008280,3,5,11,15,1821,1855
E01008177,6,0,8,23,1431,1468
E01008179,4,1,3,11,1205,1224
E01008181,3,5,10,13,1446,1477
E01008276,0,3,5,1,1450,1459
E01008279,1,0,11,6,1453,1471
E01008209,5,23,27,75,1958,2088
E01008210,7,8,15,32,1337,1399
E01008258,28,42,36,121,2093,2320
E01008259,50,50,37,96,1686,1919
E01008167,35,18,33,114,1468,1668
E01008169,82,11,10,94,1449,1646
E01008170,36,23,29,129,1791,2008
E01008171,37,22,11,43,1366,1479
E01008257,4,4,10,21,1403,1442
E01008262,11,3,15,88,1666,1783
E01008263,2,1,13,13,1503,1532
E01008264,2,2,10,10,1395,1419
E01008265,3,5,13,12,1446,1479
E01008266,2,10,8,7,1339,1366
E01008251,34,31,31,127,1533,1756
E01008252,22,29,23,90,1601,1765
E01008253,47,41,31,94,1500,1713
E01008254,28,32,16,58,1218,1352
E01008255,25,9,28,84,1595,1741
E01008165,14,11,16,16,1342,1399
E01008201,5,5,13,47,1526,1596
E01008202,5,11,15,32,1806,1869
E01008204,9,3,13,24,1501,1550
E01008212,14,9,11,19,1328,1381
E01008213,4,2,7,4,1466,1483
E01008216,8,9,7,28,1504,1556
E01008228,0,2,8,4,1179,1193
E01008206,0,11,11,9,1717,1748
E01008207,3,0,11,30,1413,1457
E01008208,1,5,14,13,1617,1650
E01008211,2,3,9,18,1678,1710
E01008283,1,0,6,26,1278,1311
E01008284,0,1,9,9,1452,1471
E01008286,7,1,7,32,1445,1492
E01008287,6,4,12,36,2013,2071
E01008231,7,5,15,21,1542,1590
E01008240,8,9,4,23,1470,1514
E01008241,0,5,6,12,1614,1637
E01008242,0,8,5,23,1634,1670
E01008281,0,5,7,33,1456,1501
E01008282,1,5,6,6,1469,1487
E01008219,23,3,11,31,1667,1735
E01008235,0,4,9,10,1443,1466
E01008236,7,6,7,30,1463,1513
E01008237,0,5,10,19,1520,1554
E01008238,2,1,12,13,1527,1555
E01008267,3,1,4,11,1519,1538
E01008269,0,2,12,9,1466,1489
E01008270,5,0,6,14,1305,1330
E01008271,0,0,4,7,1399,1410
E01008275,5,0,11,19,1470,1505
E01008229,3,3,4,4,1366,1380
E01008230,8,6,12,40,1333,1399
E01008232,0,4,5,16,1363,1388
E01008233,1,4,5,1,1363,1374
E01008285,0,0,9,10,1420,1439
E01008256,1,1,13,27,1729,1771
E01008260,5,2,16,55,1476,1554
E01008261,1,3,11,23,1422,1460
E01008268,0,4,14,11,1448,1477
E01008272,6,0,7,14,1390,1417
E01008273,0,0,11,13,1449,1473
E01008274,1,3,4,9,1437,1454
E01008193,0,0,11,20,1252,1283
E01008194,2,0,6,14,1368,1390
E01008234,2,0,14,43,2064,2123
E01008239,2,6,19,18,1479,1524
E01008218,5,5,3,13,1613,1639
E01008220,4,7,13,15,1245,1284
E01008221,2,16,4,25,1688,1735
E01008225,4,2,5,3,1677,1691
E01008227,11,40,26,30,1599,1706
E01008184,0,0,4,6,1399,1409
E01008185,0,1,9,3,1398,1411
E01008188,1,1,13,5,1438,1458
E01008278,1,0,3,6,1414,1424
E01008189,4,10,7,18,1342,1381
E01008190,2,0,7,16,1270,1295
E01008191,22,8,9,9,1436,1484
E01008192,1,7,5,14,1406,1433
E01008217,2,5,3,5,1548,1563
E01008183,7,1,5,14,1451,1478
E01008186,5,5,4,25,1926,1965
E01008187,6,5,4,8,1651,1674
E01008196,3,4,7,10,1904,1928
E01008222,0,1,9,5,1506,1521
E01008223,7,8,13,26,1728,1782
E01008224,7,3,14,34,1794,1852
E01008226,1,7,13,7,1470,1498
E01008172,11,2,12,20,1658,1703
E01008173,4,5,12,17,1568,1606
E01008174,1,7,14,26,2039,2087
E01008175,5,10,3,46,1411,1475
E01008176,0,0,1,8,1487,1496
E01008162,49,49,52,251,1976,2377
E01008164,13,38,17,79,1166,1313
E01008166,107,98,49,127,1178,1559
E01008168,28,39,41,110,2020,2238
E01008163,38,21,22,52,1867,2000
E01008203,41,37,18,88,1595,1779
E01008205,0,1,5,22,1521,1549
E01008294,71,7,15,93,1331,1517
E01008306,16,1,17,20,1582,1636
E01008307,2,1,7,7,1012,1029
E01008308,9,3,26,62,1295,1395
E01008311,63,7,22,120,1465,1677
E01008312,139,16,14,80,1015,1264
E01008313,53,7,14,103,1040,1217
E01008309,8,10,9,60,1742,1829
E01008352,44,41,25,196,1178,1484
E01008357,15,2,25,217,1378,1637
E01008358,21,19,8,120,1309,1477
E01033550,70,6,42,125,1813,2056
E01033551,11,16,28,166,1533,1754
E01008336,14,24,21,51,1256,1366
E01008337,31,46,16,41,1311,1445
E01008338,21,28,19,51,1140,1259
E01008339,11,22,4,65,1355,1457
E01008340,15,39,21,81,1332,1488
E01008341,14,6,18,49,1336,1423
E01008342,7,12,14,30,1325,1388
E01008293,61,19,17,54,1296,1447
E01008456,0,3,19,33,1443,1498
E01008457,11,10,7,27,1510,1565
E01008458,38,1,14,76,1532,1661
E01008459,22,21,16,91,1832,1982
E01008460,5,7,7,11,1520,1550
E01008351,6,21,16,113,1313,1469
E01008354,31,14,34,116,1513,1708
E01008418,15,10,20,104,1862,2011
E01008420,7,2,26,40,1272,1347
E01008422,15,5,24,90,1512,1646
E01008424,79,59,33,194,1378,1743
E01008353,25,25,9,94,1380,1533
E01008355,14,12,20,69,1439,1554
E01008356,24,19,33,222,1225,1523
E01008378,30,13,18,281,1110,1452
E01008419,11,1,22,73,1414,1521
E01008421,13,9,22,73,1404,1521
E01008423,3,5,37,122,1221,1388
E01008317,16,7,24,181,1301,1529
E01008319,17,14,18,353,1468,1870
E01008320,1,5,9,98,1349,1462
E01008321,53,19,33,240,1411,1756
E01008322,7,16,24,138,1345,1530
E01008323,15,23,21,139,1472,1670
E01008295,1,61,13,89,1424,1588
E01008374,17,15,33,102,1413,1580
E01008375,29,17,20,40,1408,1514
E01008376,5,21,14,92,1065,1197
E01008377,42,106,50,232,1785,2215
E01008379,15,27,12,135,1338,1527
E01008380,34,176,30,178,1284,1702
E01008296,2,10,5,15,1377,1409
E01008297,14,15,14,73,1281,1397
E01008298,4,11,21,44,1427,1507
E01008299,0,2,16,43,1281,1342
E01008314,6,20,23,171,1275,1495
E01008315,12,10,15,131,1388,1556
E01008316,9,2,18,121,1459,1609
E01008318,16,7,21,126,1235,1405
E01008363,3,12,25,75,1480,1595
E01008365,7,13,24,130,1505,1679
E01008366,7,5,40,120,1909,2081
E01008369,11,11,45,86,1844,1997
E01008371,8,5,37,128,1187,1365
E01008372,18,20,47,121,1729,1935
E01008373,13,16,44,112,2163,2348
E01008400,1,8,17,6,1285,1317
E01008401,0,4,11,7,1492,1514
E01008402,2,2,10,17,1445,1476
E01008403,13,0,11,12,1421,1457
E01008404,2,0,13,22,1610,1647
E01008405,3,1,8,7,1398,1417
E01008443,0,0,3,13,1417,1433
E01008324,7,10,9,7,1317,1350
E01008325,7,2,12,12,1387,1420
E01008326,3,5,19,13,1448,1488
E01008327,1,8,5,9,1272,1295
E01008328,0,6,2,13,1246,1267
E01008329,2,18,19,27,1396,1462
E01008330,2,0,12,17,1354,1385
E01008300,17,40,29,143,1443,1672
E01008450,12,43,40,225,1160,1480
E01008451,42,24,36,163,1523,1788
E01008452,27,10,29,519,843,1428
E01008367,22,35,48,120,1967,2192
E01008368,16,18,18,52,1712,1816
E01008370,11,30,49,180,1446,1716
E01008409,7,16,25,86,1576,1710
E01008411,13,33,24,230,1477,1777
E01008303,22,54,35,77,1789,1977
E01008359,7,22,46,109,1423,1607
E01008360,13,37,27,119,1472,1668
E01008361,15,30,27,127,1394,1593
E01008362,6,20,47,105,1617,1795
E01008364,7,25,36,147,1481,1696
E01008343,6,15,16,129,1381,1547
E01008344,12,6,19,87,1478,1602
E01008345,7,8,14,22,1540,1591
E01008346,6,18,23,175,1404,1626
E01008347,11,2,15,268,1134,1430
E01008348,2,15,26,253,881,1177
E01008349,61,23,16,939,526,1565
E01008350,6,15,13,64,1203,1301
E01008430,13,8,6,15,1312,1354
E01008431,1,0,6,14,1332,1353
E01008433,5,2,11,8,1357,1383
E01008434,9,5,8,10,1445,1477
E01008435,6,39,7,37,1385,1474
E01008436,18,54,12,84,1321,1489
E01008381,1,1,5,8,1361,1376
E01008382,1,6,8,3,1321,1339
E01008383,5,3,17,13,1456,1494
E01008384,2,5,5,8,1379,1399
E01008385,8,7,15,25,1343,1398
E01008386,10,10,6,11,1327,1364
E01008387,11,9,5,29,1310,1364
E01008396,145,175,92,969,1610,2991
E01008398,147,162,60,475,851,1695
E01008449,148,97,31,735,772,1783
E01008453,54,5,41,507,1062,1669
E01008455,119,63,29,1018,417,1646
E01033556,84,140,88,916,1284,2512
E01008406,22,41,38,345,1111,1557
E01008407,30,70,38,397,2259,2794
E01008410,10,39,34,151,1486,1720
E01008412,9,13,37,76,1522,1657
E01008413,9,32,32,108,1292,1473
E01033548,46,41,24,151,855,1117
E01033553,73,63,44,441,1987,2608
E01008394,24,18,28,167,1202,1439
E01008395,44,66,30,330,1052,1522
E01008397,51,44,43,581,1075,1794
E01008399,84,153,86,354,1219,1896
E01008439,55,93,45,328,1307,1828
E01033543,138,42,41,388,693,1302
E01033545,115,20,38,219,795,1187
E01033554,64,49,52,327,821,1313
E01008415,0,13,24,50,1127,1214
E01008416,2,4,12,49,1623,1690
E01033547,2,34,34,112,1945,2127
E01008301,9,49,32,60,1626,1776
E01008302,5,44,21,46,1526,1642
E01008304,29,126,40,86,1619,1900
E01008305,66,153,32,93,1832,2176
E01008391,1,14,14,31,1425,1485
E01008392,20,34,26,57,1414,1551
E01008432,2,16,7,14,1316,1355
E01008288,9,19,10,41,1242,1321
E01008289,0,4,30,67,1489,1590
E01008290,6,27,28,60,1156,1277
E01008291,39,118,62,224,1690,2133
E01008292,2,3,7,61,1269,1342
E01008388,7,44,15,71,1664,1801
E01008389,2,22,20,37,1658,1739
E01008426,2,32,28,49,1543,1654
E01008429,1,19,10,17,1373,1420
E01008331,55,98,39,1117,573,1882
E01008332,96,167,84,667,1257,2271
E01008333,77,53,49,822,850,1851
E01008334,68,111,47,716,1098,2040
E01008335,31,120,65,1077,786,2079
E01008437,32,67,28,79,1013,1219
E01008438,60,97,28,189,1274,1648
E01008390,20,73,36,34,1629,1792
E01008425,37,101,37,73,1547,1795
E01008427,15,50,17,18,1072,1172
E01008428,6,15,16,26,1232,1295
E01008441,12,8,8,19,1602,1649
E01008442,0,0,10,28,1336,1374
E01008444,2,3,7,33,1500,1545
E01008445,2,6,5,27,1890,1930
E01008446,0,0,6,8,1403,1417
E01008447,1,2,14,30,1270,1317
E01008448,1,1,5,17,1458,1482
E01008547,1,10,5,28,1340,1384
E01008548,9,0,7,37,1244,1297
E01008549,3,0,1,23,1459,1486
E01008551,1,0,5,8,1444,1458
E01008478,1,4,21,6,1533,1565
E01008480,0,2,6,16,1531,1555
E01008504,3,1,7,25,1492,1528
E01008578,2,8,13,15,1358,1396
E01008583,1,1,8,20,1434,1464
E01008520,1,1,10,20,1341,1373
E01008523,1,0,14,17,1285,1317
E01008546,0,1,15,12,1449,1477
E01008550,2,3,23,18,1576,1622
E01008577,0,3,9,8,1345,1365
E01008579,2,5,12,8,1470,1497
E01008580,1,8,10,9,1361,1389
E01008581,1,3,3,18,1342,1367
E01008582,0,16,8,17,1308,1349
E01008517,1,0,19,6,1567,1593
E01008519,0,2,8,22,1329,1361
E01008521,1,2,15,13,1455,1486
E01008522,1,0,7,9,1580,1597
E01008584,8,3,25,38,1470,1544
E01008585,3,0,14,77,1521,1615
E01008587,1,1,11,39,1338,1390
E01008588,12,2,32,58,1470,1574
E01008589,5,0,9,14,1418,1446
E01008518,10,1,14,7,1607,1639
E01008564,1,3,8,3,1437,1452
E01008565,7,4,14,25,1976,2026
E01008567,2,0,10,19,1383,1414
E01008475,2,2,7,24,1621,1656
E01008476,0,6,17,8,1672,1703
E01008477,1,10,14,9,1608,1642
E01008479,2,6,7,23,1318,1356
E01008552,0,6,2,15,1607,1630
E01008553,1,5,21,19,1786,1832
E01008554,2,6,17,81,1584,1690
E01008555,1,1,18,69,1540,1629
E01008586,11,1,24,47,1470,1553
E01008495,3,1,7,19,1693,1723
E01008496,1,5,23,11,1457,1497
E01008497,0,0,7,4,1440,1451
E01008498,1,1,2,16,1489,1509
E01008568,5,4,13,18,1439,1479
E01008569,2,2,19,23,1416,1462
E01008570,5,6,14,49,1263,1337
E01032647,23,5,14,75,1607,1724
E01032648,5,13,20,57,1435,1530
E01008500,6,1,19,45,1530,1601
E01008505,1,9,11,33,1614,1668
E01008506,2,4,11,7,1366,1390
E01008507,0,1,9,37,1455,1502
E01008493,6,1,2,18,1476,1503
E01008494,0,1,14,53,1451,1519
E01008556,5,4,15,91,1869,1984
E01008557,2,9,19,70,1530,1630
E01008470,0,0,20,20,1369,1409
E01008499,4,5,17,7,1650,1683
E01008502,0,2,21,31,1576,1630
E01008516,3,3,10,7,1294,1317
E01008488,9,18,10,28,1358,1423
E01008489,19,8,23,125,1553,1728
E01008490,2,4,8,28,1510,1552
E01008491,7,0,20,88,1463,1578
E01008558,4,3,17,13,1490,1527
E01008560,3,10,22,28,1637,1700
E01008561,1,3,17,6,1555,1582
E01008562,0,2,16,13,1464,1495
E01008525,3,0,11,9,1535,1558
E01008527,0,7,18,14,1456,1495
E01008559,2,1,22,17,1482,1524
E01008563,1,3,18,18,1408,1448
E01008469,3,3,7,40,1420,1473
E01008472,1,5,8,10,1470,1494
E01008473,3,2,9,20,1255,1289
E01008501,14,7,27,118,1925,2091
E01008503,5,4,11,24,1594,1638
E01008471,2,5,14,47,1561,1629
E01008474,3,13,17,32,1389,1454
E01008513,9,34,34,134,2024,2235
E01008514,0,7,28,68,1704,1807
E01032649,3,4,12,45,1031,1095
E01032650,1,7,7,30,993,1038
E01008486,6,1,10,11,1392,1420
E01008487,5,0,5,22,1397,1429
E01008526,6,1,9,11,1437,1464
E01008530,5,1,17,20,1562,1605
E01008461,1,8,5,21,1393,1428
E01008466,0,1,5,13,1307,1326
E01008467,0,4,9,7,1389,1409
E01008468,0,2,5,15,1414,1436
E01008483,3,5,22,36,1495,1561
E01008524,2,7,14,25,1633,1681
E01008528,5,2,14,9,1397,1427
E01008529,6,7,30,23,1559,1625
E01008481,2,10,13,30,1425,1480
E01008482,4,12,20,28,1615,1679
E01008484,0,6,8,27,1301,1342
E01008485,2,9,17,17,1505,1550
E01008492,4,9,31,39,1641,1724
E01008462,1,13,7,4,1228,1253
E01008463,2,4,11,11,1306,1334
E01008464,1,3,9,9,1361,1383
E01008465,0,3,6,4,1414,1427
E01008531,8,3,9,73,1346,1439
E01008532,1,4,13,56,1452,1526
E01008534,0,0,14,77,1281,1372
E01008538,2,3,3,12,1231,1251
E01008508,2,5,5,16,1539,1567
E01008509,0,5,9,13,1600,1627
E01008510,2,2,14,18,1525,1561
E01008512,1,10,16,26,1499,1552
E01008539,3,7,6,11,1401,1428
E01008540,0,5,26,27,1579,1637
E01008541,2,7,28,36,1506,1579
E01008544,13,5,32,27,1548,1625
E01008545,11,20,15,22,1222,1290
E01008511,3,10,6,20,1645,1684
E01008542,1,50,23,30,1475,1579
E01008543,1,16,31,60,2114,2222
E01008571,11,8,17,31,1729,1796
E01008572,5,22,17,46,1561,1651
E01008573,1,35,27,42,1499,1604
E01008574,2,1,15,17,1558,1593
E01008576,4,9,17,58,1991,2079
E01008533,0,1,15,17,1456,1489
E01008535,2,3,6,12,1450,1473
E01008536,0,10,9,22,1392,1433
E01008537,2,9,11,36,1252,1310
E01008575,10,22,11,52,1238,1333
E01008595,11,9,25,32,1485,1562
E01008596,73,18,24,508,862,1485
E01008597,31,4,24,72,2223,2354
E01008598,27,14,34,333,1164,1572
E01008599,19,13,20,180,1241,1473
E01008664,113,20,42,233,1073,1481
E01008665,26,11,16,51,1330,1434
E01008666,60,26,27,129,1152,1394
E01008667,21,9,36,52,1454,1572
E01008668,31,14,26,132,1312,1515
E01008673,16,1,7,7,1168,1199
E01008675,10,16,18,37,1342,1423
E01008676,6,0,15,30,1191,1242
E01008677,4,5,6,12,1395,1422
E01008678,36,1,21,32,1176,1266
E01008647,1,1,6,15,1437,1460
E01008648,3,0,9,20,1351,1383
E01008649,8,0,21,18,1598,1645
E01008651,1,6,7,31,1872,1917
E01008679,14,5,22,25,1237,1303
E01008680,2,4,14,6,1399,1425
E01008682,3,4,26,19,1190,1242
E01008683,19,4,23,31,1365,1442
E01008635,1,1,14,6,1348,1370
E01008650,1,4,10,8,1396,1419
E01008674,7,6,11,16,1226,1266
E01008681,14,1,12,31,1344,1402
E01008600,7,4,13,39,1255,1318
E01008604,4,2,25,25,1574,1630
E01008660,17,0,11,16,1370,1414
E01008661,0,0,2,10,1121,1133
E01008633,1,2,16,13,1391,1423
E01008634,3,1,5,10,1299,1318
E01008636,1,7,9,5,1420,1442
E01008637,2,1,14,5,1432,1454
E01008639,5,3,13,36,1887,1944
E01008652,4,0,8,4,1087,1103
E01008653,15,2,10,11,1235,1273
E01008654,2,1,11,16,1204,1234
E01008655,6,6,6,5,1447,1470
E01008657,8,1,9,7,1338,1363
E01008638,1,1,12,15,1376,1405
E01008640,7,5,10,13,1941,1976
E01008641,5,1,12,13,1480,1511
E01008642,14,1,7,15,1401,1438
E01008590,11,3,11,39,1437,1501
E01008591,5,16,31,44,1315,1411
E01008592,18,11,14,32,1382,1457
E01008594,6,2,16,38,1721,1783
E01008601,9,4,13,15,1496,1537
E01008669,8,8,15,19,1327,1377
E01008671,17,6,24,19,1153,1219
E01008672,4,1,7,2,1302,1316
E01008622,12,2,9,12,1570,1605
E01008625,4,2,10,19,1435,1470
E01033074,8,13,17,22,2059,2119
E01008602,5,1,14,9,1437,1466
E01008603,3,4,12,14,1261,1294
E01008608,3,2,19,4,1113,1141
E01008670,5,4,8,15,1486,1518
E01008643,2,0,7,5,1416,1430
E01008644,4,9,11,1,1478,1503
E01008645,0,0,11,11,1432,1454
E01008646,2,6,10,14,1374,1406
E01008656,1,3,6,3,1407,1420
E01008658,9,8,16,14,1396,1443
E01008593,21,17,27,22,1175,1262
E01008605,7,0,8,8,1140,1163
E01008606,7,5,17,8,1376,1413
E01008607,2,13,12,6,1347,1380
E01008609,13,8,18,3,1419,1461
E01008631,6,0,6,19,1441,1472
E01008632,1,3,3,4,1225,1236
E01008659,6,3,9,5,1460,1483
E01008662,5,1,4,10,1227,1247
E01008663,4,2,8,2,1383,1399
E01008624,1,2,10,1,1403,1417
E01008684,7,0,7,5,1196,1215
E01008685,17,0,16,33,1792,1858
E01008686,0,0,13,15,1677,1705
E01008687,6,0,13,18,1670,1707
E01008688,1,0,9,2,1405,1417
E01008689,3,0,9,13,1514,1539
E01008690,1,3,9,5,1412,1430
E01008691,0,0,13,17,1232,1262
E01008692,4,0,7,5,1351,1367
E01008627,2,0,5,6,1303,1316
E01008628,1,0,3,3,1438,1445
E01008629,0,1,1,10,1405,1417
E01008630,1,1,10,6,1427,1445
E01008610,3,0,9,16,1379,1407
E01008611,2,5,8,57,1403,1475
E01008612,0,0,6,30,1432,1468
E01008613,5,0,8,39,1497,1549
E01008616,2,0,6,19,1543,1570
E01008618,24,1,9,79,1161,1274
E01008619,13,1,2,43,1507,1566
E01008621,3,1,17,56,1342,1419
E01008614,0,7,7,10,1612,1636
E01008615,0,1,3,22,1363,1389
E01008617,7,3,10,25,1437,1482
E01008620,1,2,13,14,1419,1449
E01008713,3,1,6,19,1575,1604
E01008722,0,3,6,7,1463,1479
E01008724,3,0,5,0,1198,1206
E01008726,0,1,10,4,1484,1499
E01008723,1,0,9,11,1385,1406
E01008725,3,0,5,8,1391,1407
E01008727,0,0,7,6,1526,1539
E01008728,0,0,5,3,1445,1453
E01008792,0,0,13,9,1306,1328
E01008698,5,4,7,2,1448,1466
E01008837,0,0,4,5,1283,1292
E01008838,2,3,10,7,1568,1590
E01008839,0,3,5,10,1350,1368
E01008840,0,8,10,13,1431,1462
E01008841,0,3,9,5,1188,1205
E01008712,2,12,9,11,1616,1650
E01008817,0,3,7,2,1146,1158
E01008819,0,0,7,4,1397,1408
E01008821,0,1,11,6,1374,1392
E01008822,1,0,10,3,1607,1621
E01008842,0,0,2,2,1441,1445
E01008708,2,0,7,6,1465,1480
E01008709,0,5,6,12,1389,1412
E01008711,0,5,9,13,1436,1463
E01008820,1,4,5,0,1143,1153
E01033075,1,2,8,15,2051,2077
E01008786,7,0,7,5,1412,1431
E01008787,9,28,17,131,1447,1632
E01008788,4,6,5,33,1462,1510
E01008789,20,1,11,46,1318,1396
E01008790,6,0,14,42,1460,1522
E01008791,21,72,15,183,1495,1786
E01008855,0,2,21,23,1440,1486
E01008856,0,0,9,6,1370,1385
E01008876,2,14,8,74,1425,1523
E01008877,1,1,3,5,1447,1457
E01008693,0,5,4,2,1249,1260
E01008694,5,1,18,16,1390,1430
E01008695,3,0,11,6,1514,1534
E01008696,0,0,16,9,1287,1312
E01008697,1,3,5,7,1296,1312
E01008699,3,4,5,4,1396,1412
E01008853,0,8,6,21,1336,1371
E01008854,2,6,14,20,1479,1521
E01008857,2,1,10,5,1372,1390
E01008858,1,1,9,2,1355,1368
E01008859,1,21,10,10,1340,1382
E01008860,0,16,11,4,1363,1394
E01008878,0,7,4,24,1543,1578
E01008873,2,0,19,8,1270,1299
E01008874,1,1,10,14,1777,1803
E01008875,4,1,4,11,1551,1571
E01008879,0,0,6,7,1430,1443
E01008880,1,1,5,6,1146,1159
E01008701,19,53,14,178,1565,1829
E01008704,13,36,14,294,1174,1531
E01008706,25,15,28,295,1285,1648
E01008707,23,40,23,452,1077,1615
E01008756,0,13,10,75,1415,1513
E01008762,0,5,5,39,1469,1518
E01008812,2,7,15,45,1654,1723
E01033076,0,4,7,7,1530,1548
E01008700,9,26,24,66,1132,1257
E01008703,39,57,32,264,1788,2180
E01008705,20,34,18,163,894,1129
E01008831,95,127,81,449,1490,2242
E01008834,13,34,40,106,1643,1836
E01008810,0,2,10,9,1631,1652
E01008811,1,3,9,4,1634,1651
E01008813,1,8,12,25,1555,1601
E01008814,0,1,4,27,1521,1553
E01008757,7,8,11,133,1319,1478
E01008758,2,1,11,12,1419,1445
E01008759,0,9,6,68,1408,1491
E01008761,1,6,3,28,1406,1444
E01008702,0,14,3,34,1056,1107
E01008735,8,22,34,117,1826,2007
E01008736,0,9,20,36,1167,1232
E01008737,5,9,9,54,1311,1388
E01008738,12,22,8,30,1244,1316
E01008836,9,37,23,376,1070,1515
E01008845,0,1,13,9,1400,1423
E01008846,2,5,17,19,1140,1183
E01008847,0,21,4,9,1342,1376
E01008850,5,2,22,71,1623,1723
E01008851,3,0,1,14,1574,1592
E01008760,3,9,12,57,1414,1495
E01008830,21,54,32,364,1052,1523
E01008832,15,12,10,346,1187,1570
E01008833,12,24,17,248,1169,1470
E01008843,7,5,2,16,1252,1282
E01008844,0,0,6,4,1422,1432
E01008848,1,1,7,2,1332,1343
E01008849,1,4,7,16,1229,1257
E01008852,3,5,7,5,1225,1245
E01008867,6,8,13,15,1620,1662
E01008868,3,1,9,14,1192,1219
E01008869,0,0,4,5,1306,1315
E01008870,1,2,16,11,1413,1443
E01008871,0,0,8,11,1447,1466
E01008872,0,0,12,11,1454,1477
E01008729,0,0,3,1,1068,1072
E01008730,0,2,8,21,1630,1661
E01008731,0,2,8,9,1258,1277
E01008732,0,5,12,24,2078,2119
E01008733,3,2,5,24,1607,1641
E01008734,0,1,3,6,1404,1414
E01008740,13,4,14,76,1347,1454
E01008781,6,12,8,129,1399,1554
E01008782,10,3,7,41,1398,1459
E01008783,0,5,6,35,1364,1410
E01008784,10,3,10,45,1516,1584
E01008785,5,3,8,15,1408,1439
E01008835,57,7,17,200,1287,1568
E01008823,0,0,3,30,1374,1407
E01008824,2,0,1,11,1493,1507
E01008825,4,2,4,3,1520,1533
E01008826,5,9,3,6,1423,1446
E01008827,7,5,8,27,1198,1245
E01008828,0,10,5,53,1517,1585
E01008829,2,9,13,18,1328,1370
E01008739,4,9,27,23,1522,1585
E01008741,2,4,3,28,1414,1451
E01008779,6,2,10,29,1399,1446
E01008780,4,5,24,55,1837,1925
E01008799,3,1,11,33,1617,1665
E01008861,1,2,4,44,1472,1523
E01008862,6,2,11,18,1404,1441
E01008863,8,5,12,69,1527,1621
E01008864,6,1,17,58,1207,1289
E01008865,0,1,6,22,1350,1379
E01008866,4,0,4,12,1390,1410
E01008773,3,4,7,13,1375,1402
E01008776,1,5,4,2,1231,1243
E01008777,3,3,12,3,1327,1348
E01008778,0,0,2,16,1361,1379
E01008809,1,1,5,12,1522,1541
E01008803,2,0,7,18,1406,1433
E01008804,1,0,7,7,1618,1633
E01008805,4,1,4,16,1401,1426
E01033077,2,0,8,2,1786,1798
E01008763,17,8,16,17,1447,1505
E01008764,5,4,1,34,1452,1496
E01008766,6,0,5,11,2258,2280
E01008768,0,3,11,10,1413,1437
E01008769,16,2,7,33,1659,1717
E01008772,2,4,6,7,1347,1366
E01008774,1,0,2,8,1293,1304
E01008775,4,5,5,17,1376,1407
E01008802,8,0,3,24,1387,1422
E01008808,2,0,9,11,1420,1442
E01008793,1,4,4,13,1679,1701
E01008795,1,4,5,41,1746,1797
E01008797,13,6,13,43,1922,1997
E01008800,1,2,1,9,1423,1436
E01008801,1,0,7,6,1583,1597
E01008765,4,0,10,14,1503,1531
E01008767,4,3,10,16,1459,1492
E01008770,4,6,1,3,1390,1404
E01008771,9,0,3,9,1500,1521
E01008720,2,1,3,2,1381,1389
E01008721,0,10,4,17,1589,1620
E01008796,3,3,7,19,1564,1596
E01032483,5,7,11,8,1671,1702
E01032484,1,5,4,0,1280,1290
E01008750,1,1,10,17,1877,1906
E01008751,6,0,6,14,1012,1038
E01008752,0,7,6,20,1601,1634
E01008753,1,1,7,4,1200,1213
E01008755,1,4,4,7,1322,1338
E01008714,5,5,10,20,1244,1284
E01008715,1,6,6,7,1283,1303
E01008716,0,3,6,2,1334,1345
E01008717,2,2,12,12,1607,1635
E01008749,0,0,4,3,1415,1422
E01008754,1,5,7,2,1402,1417
E01008718,1,2,10,2,1375,1390
E01008719,0,1,5,5,1217,1228
E01008742,4,1,8,12,1667,1692
E01008747,0,2,10,6,1392,1410
E01008748,0,3,1,2,1339,1345
E01008743,0,2,8,0,1678,1688
E01008744,6,2,10,14,1591,1623
E01008745,0,3,4,2,1636,1645
E01008746,6,2,3,19,1613,1643
E01012607,5,6,28,435,1030,1504
E01012608,4,8,25,371,1264,1672
E01012633,3,3,19,170,1397,1592
E01012634,5,14,22,302,1043,1386
E01012635,5,6,41,847,742,1641
E01012636,2,5,17,37,1442,1503
E01012581,7,7,11,268,950,1243
E01012582,40,10,21,729,839,1639
E01012583,16,1,28,467,1130,1642
E01012587,22,3,26,1035,902,1988
E01012588,77,2,33,1561,432,2105
E01012574,13,6,19,736,673,1447
E01012577,15,11,31,1673,184,1914
E01012578,11,4,24,1736,201,1976
E01012605,10,15,34,1565,271,1895
E01012606,11,3,22,1274,371,1681
E01012579,43,14,44,1241,308,1650
E01012580,27,25,11,2058,38,2159
E01012642,29,13,25,1401,274,1742
E01012645,14,3,19,1491,465,1992
E01012585,25,1,24,1018,565,1633
E01012586,23,15,16,1110,463,1627
E01012656,25,31,40,1007,565,1668
E01012657,35,37,30,1259,670,2031
E01012658,14,9,14,415,1373,1825
E01012629,7,9,19,357,753,1145
E01012631,15,12,18,449,798,1292
E01012643,29,11,14,1209,372,1635
E01012644,39,12,48,2238,202,2539
E01012655,53,75,34,334,1358,1854
E01012571,42,24,28,1071,309,1474
E01012572,33,14,36,1197,272,1552
E01012573,10,16,27,1587,160,1800
E01012575,32,13,18,738,483,1284
E01012630,88,9,41,1872,261,2271
E01012576,23,23,16,999,565,1626
E01012637,5,15,15,19,1529,1583
E01012638,30,25,16,59,1532,1662
E01012639,5,12,17,234,1535,1803
E01012640,7,3,25,425,1291,1751
E01012641,26,34,33,530,1089,1712
E01012595,14,13,41,94,1741,1903
E01012596,13,27,38,158,1540,1776
E01012622,9,43,40,302,1257,1651
E01012623,10,0,14,75,1434,1533
E01012624,0,9,13,7,1541,1570
E01012625,3,2,20,17,1591,1633
E01012584,19,12,28,576,838,1473
E01012609,4,5,7,3,1558,1577
E01012610,9,1,12,12,1240,1274
E01012611,4,0,5,14,1028,1051
E01012612,2,1,3,5,1388,1399
E01012613,0,3,14,14,1316,1347
E01012600,3,5,12,128,1294,1442
E01012601,2,7,14,37,1471,1531
E01012602,6,11,7,40,1537,1601
E01012603,0,14,20,27,1519,1580
E01012604,39,30,27,182,1408,1686
E01012632,42,20,51,882,1095,2090
E01012594,6,10,17,24,1416,1473
E01012618,7,8,12,10,1428,1465
E01012619,2,5,17,26,1350,1400
E01012620,1,3,6,15,1363,1388
E01012621,6,13,16,38,1417,1490
E01012593,3,11,21,49,1691,1775
E01012597,1,3,14,45,1704,1767
E01012598,11,10,33,97,2841,2992
E01012599,1,4,5,14,1145,1169
E01012589,5,4,15,67,1331,1422
E01012590,7,6,16,43,1284,1356
E01012591,3,3,13,33,1509,1561
E01012648,5,7,8,45,1113,1178
E01012652,6,2,6,20,1505,1539
E01012617,1,6,10,44,1332,1393
E01012646,2,4,13,64,1586,1669
E01012647,2,8,17,45,1270,1342
E01012650,13,5,19,178,1164,1379
E01012649,6,24,21,100,1311,1462
E01012651,3,1,8,51,1630,1693
E01012653,0,2,15,26,1251,1294
E01012654,9,5,11,161,1471,1657
E01012614,1,7,9,50,1678,1745
E01012615,4,5,14,41,1431,1495
E01012616,6,2,22,11,1741,1782
E01012659,3,6,10,21,1371,1411
E01012660,0,1,5,22,1142,1170
E01012661,1,2,12,17,1466,1498
E01012592,6,1,11,16,1890,1924
E01012628,4,1,12,9,1139,1165
E01032485,1,0,10,10,1745,1766
E01032486,0,2,10,5,1397,1414
E01012663,0,7,20,9,1566,1602
E01012664,1,3,9,16,1610,1639
E01012665,1,2,3,12,1624,1642
E01012716,0,2,12,14,1451,1479
E01012719,1,2,12,8,1423,1446
E01012662,2,3,11,14,1429,1459
E01012703,1,1,13,8,1476,1499
E01012704,3,5,33,32,1920,1993
E01012706,1,2,7,12,1623,1645
E01012717,2,1,6,4,1647,1660
E01012666,6,2,17,20,1413,1458
E01012667,8,2,13,1,1539,1563
E01012668,2,3,14,16,1535,1570
E01012669,4,3,26,24,1727,1784
E01012718,0,2,7,13,1599,1621
E01012690,2,1,18,20,1686,1727
E01012691,1,7,21,20,1819,1868
E01012692,0,5,23,18,1674,1720
E01012705,0,2,14,18,1590,1624
E01012723,4,3,21,29,1378,1435
E01012693,1,2,19,26,1502,1550
E01012711,3,4,18,15,1344,1384
E01012747,4,3,9,12,1487,1515
E01012750,7,2,8,30,1693,1740
E01012681,8,6,34,47,1455,1550
E01012683,6,2,27,49,1361,1445
E01012748,5,8,22,33,1588,1656
E01012749,5,9,29,26,1686,1755
E01012707,4,5,16,24,1179,1228
E01012720,0,6,15,27,1553,1601
E01012721,3,5,24,9,1638,1679
E01012724,5,3,13,1,1240,1262
E01012678,2,4,44,32,1304,1386
E01012679,6,3,55,27,1357,1448
E01012680,2,1,32,37,1521,1593
E01012682,10,14,31,22,1356,1433
E01012684,7,9,23,34,1384,1457
E01012676,14,0,10,73,1273,1370
E01012677,7,7,28,44,1295,1381
E01012708,0,2,20,49,1288,1359
E01012709,6,0,24,46,1536,1612
E01012710,5,0,16,79,1162,1262
E01012722,13,11,16,101,1143,1284
E01012673,3,10,31,63,1260,1367
E01012675,7,7,21,71,1447,1553
E01012735,11,13,15,22,1261,1322
E01012736,8,10,23,25,1316,1382
E01012737,12,6,25,34,1380,1457
E01012670,14,6,19,22,1187,1248
E01012733,3,2,24,13,985,1027
E01012734,4,4,12,21,1389,1430
E01012738,7,9,11,62,1183,1272
E01012739,0,2,11,26,1344,1383
E01012742,2,3,11,21,1105,1142
E01012712,2,0,12,13,1671,1698
E01012713,1,2,17,33,1865,1918
E01012715,2,3,22,8,1520,1555
E01012740,1,1,15,25,1460,1502
E01012741,8,0,16,16,1322,1362
E01012671,4,2,27,28,1324,1385
E01012672,1,5,26,40,1210,1282
E01012674,1,5,32,50,1557,1645
E01012751,6,9,33,54,1363,1465
E01012686,1,4,11,11,1445,1472
E01012687,7,1,9,5,1403,1425
E01012688,7,3,11,37,1173,1231
E01012689,0,1,16,5,1271,1293
E01012714,2,2,16,4,1657,1681
E01012695,2,8,15,12,1358,1395
E01012743,8,5,17,39,1638,1707
E01012744,2,2,33,20,1552,1609
E01012745,6,3,20,6,1647,1682
E01012746,2,7,21,31,1749,1810
E01012685,0,2,21,4,1462,1489
E01012694,1,2,27,9,1341,1380
E01012696,1,1,6,20,1535,1563
E01012697,3,1,18,4,1351,1377
E01012698,1,0,20,25,1474,1520
E01012726,1,3,19,9,1773,1805
E01012728,6,8,14,23,1503,1554
E01012752,2,0,13,20,1332,1367
E01012753,1,3,12,13,1160,1189
E01012754,2,1,23,28,1143,1197
E01012755,2,5,13,7,1448,1475
E01012701,8,1,7,6,1431,1453
E01012729,9,2,17,8,1564,1600
E01012730,1,3,22,21,1593,1640
E01012731,6,3,25,12,1556,1602
E01012732,1,2,15,20,1650,1688
E01012699,1,3,19,25,1677,1725
E01012700,2,3,16,22,1782,1825
E01012702,1,2,16,16,1419,1454
E01012725,0,1,12,12,1443,1468
E01012727,0,1,13,10,1586,1610
E01018393,2,1,7,5,2032,2047
E01018411,8,1,12,7,2292,2320
E01018412,0,0,9,10,1507,1526
E01018413,0,2,17,18,1240,1277
E01018414,0,3,13,12,1344,1372
E01018415,2,1,13,14,1612,1642
E01018416,1,3,12,13,1285,1314
E01018424,1,1,16,12,1666,1696
E01018425,2,3,8,4,1608,1625
E01018426,2,0,11,7,1582,1602
E01018427,1,2,9,3,1310,1325
E01018419,0,1,8,12,1340,1361
E01018420,0,0,22,16,1864,1902
E01018421,0,1,10,19,1312,1342
E01018422,1,2,13,10,1260,1286
E01018423,1,0,5,4,1446,1456
E01018395,4,4,17,11,1567,1603
E01018396,1,6,5,17,1453,1482
E01018400,1,1,10,17,2128,2157
E01018401,4,3,16,12,1541,1576
E01018398,0,1,3,16,1439,1459
E01018399,3,4,12,49,1433,1501
E01018402,3,6,13,44,1844,1910
E01018403,6,2,13,14,1918,1953
E01018397,6,5,11,14,1795,1831
E01018408,4,2,8,17,1753,1784
E01018409,0,2,13,16,1816,1847
E01018410,5,6,11,22,1523,1567
E01018404,4,2,5,6,1473,1490
E01018405,1,0,6,10,1380,1397
E01018406,0,0,11,14,1419,1444
E01018407,0,0,2,3,1476,1481
E01018436,5,3,8,10,1390,1416
E01018437,3,4,20,19,1533,1579
E01018438,1,2,11,2,1398,1414
E01018439,1,1,0,10,1327,1339
E01018440,6,7,12,27,1728,1780
E01018441,1,1,16,20,1652,1690
E01018442,10,5,15,17,1782,1829
E01018443,0,2,5,15,1471,1493
E01018432,1,0,17,16,1461,1495
E01018433,0,2,1,1,1249,1253
E01018434,1,1,14,6,1313,1335
E01018435,1,1,5,23,1323,1353
E01018394,0,1,18,9,2025,2053
E01018417,9,5,19,8,1588,1629
E01018418,4,1,6,6,1493,1510
E01018428,0,0,5,2,1392,1399
E01018429,4,0,3,4,1481,1492
E01018430,0,0,4,1,1383,1388
E01018431,0,3,5,5,1150,1163
E01018387,1,2,14,13,1654,1684
E01018388,2,4,39,23,1500,1568
E01018389,2,2,24,17,1562,1607
E01018390,0,2,11,25,1628,1666
E01018386,2,8,12,16,1380,1418
E01018391,1,0,17,11,1904,1933
E01018392,1,0,13,16,1869,1899
E01018472,0,8,15,10,1353,1386
E01018473,6,4,14,21,1626,1671
E01018474,7,6,29,48,1780,1870
E01018475,2,4,25,44,1798,1873
E01018463,3,17,15,20,1427,1482
E01018476,1,15,32,13,1367,1428
E01018477,1,3,33,7,1489,1533
E01018478,0,12,10,10,1435,1467
E01018479,0,3,14,13,1573,1603
E01018459,2,24,17,29,1338,1410
E01018460,2,9,10,15,1364,1400
E01018461,5,4,18,10,1364,1401
E01018466,3,21,41,38,2201,2304
E01018467,7,36,62,89,1998,2192
E01018482,0,4,17,10,1370,1401
E01018483,0,4,5,16,1345,1370
E01018484,2,6,40,43,2311,2402
E01018485,10,6,29,19,1476,1540
E01018499,4,9,13,7,1511,1544
E01018500,1,11,5,4,1233,1254
E01018501,5,9,18,22,1525,1579
E01018502,5,66,43,79,1866,2059
E01018462,16,32,35,59,1331,1473
E01018464,0,7,21,10,1352,1390
E01018496,9,15,26,26,1611,1687
E01018497,4,14,18,26,1112,1174
E01018498,9,22,70,20,1449,1570
E01018465,0,5,24,30,2784,2843
E01018468,1,6,12,16,1588,1623
E01018469,2,6,4,1,1608,1621
E01018470,3,2,16,3,1458,1482
E01018471,4,0,8,4,1477,1493
E01018486,8,36,27,94,1309,1474
E01018487,22,39,60,154,1375,1650
E01018488,1,20,30,7,1460,1518
E01018489,2,19,23,136,1186,1366
E01018510,5,2,12,4,1593,1616
E01018511,3,3,14,21,1404,1445
E01018512,7,4,37,35,1607,1690
E01018513,0,6,22,22,1573,1623
E01018445,6,17,52,31,1821,1927
E01018446,1,10,23,16,1286,1336
E01018447,16,10,40,61,1612,1739
E01018448,8,28,32,17,1650,1735
E01018490,2,6,10,9,1421,1448
E01018491,2,0,8,8,1410,1428
E01018492,0,1,6,1,1058,1066
E01018505,0,1,8,13,1064,1086
E01018506,5,2,11,13,1390,1421
E01018507,1,4,16,8,1375,1404
E01018451,1,2,9,7,1305,1324
E01018454,1,3,9,12,1497,1522
E01018455,9,2,9,8,1297,1325
E01018456,0,2,4,7,1281,1294
E01018457,1,9,14,11,1398,1433
E01018444,1,3,26,15,2112,2157
E01018480,5,4,4,8,2151,2172
E01018515,0,5,38,48,2234,2325
E01018516,0,3,8,6,1443,1460
E01033375,0,6,13,24,1299,1342
E01033376,1,1,19,16,1141,1178
E01033378,1,1,5,12,1382,1401
E01018493,3,3,1,3,1226,1236
E01018494,4,2,8,11,1320,1345
E01018495,5,4,12,8,1212,1241
E01018508,0,4,8,2,1166,1180
E01018509,1,2,3,3,1093,1102
E01018452,1,3,8,4,1123,1139
E01018503,0,10,14,12,1594,1630
E01018504,2,6,10,16,1731,1765
E01033372,3,3,7,18,1228,1259
E01033373,2,8,14,4,1245,1273
E01018449,0,0,9,6,1710,1725
E01018450,1,2,13,14,2191,2221
E01018458,1,0,3,3,2129,2136
E01018481,0,3,9,3,1970,1985
E01018514,0,1,16,16,1943,1976
E01018585,2,2,15,11,1352,1382
E01018586,1,2,11,6,1516,1536
E01018587,10,2,14,14,1486,1526
E01018661,1,2,2,4,1235,1244
E01018657,4,1,9,6,1084,1104
E01018662,0,2,13,16,1159,1190
E01018663,1,0,1,27,1500,1529
E01018664,11,1,10,30,1410,1462
E01018665,3,0,7,3,1104,1117
E01018655,0,2,8,15,1489,1514
E01018656,0,1,7,24,1519,1551
E01018658,0,3,11,22,1260,1296
E01018659,8,0,6,10,1224,1248
E01018660,0,1,4,6,994,1005
E01018582,12,10,38,115,1578,1753
E01018592,21,20,23,87,1563,1714
E01018593,22,10,34,84,1524,1674
E01018594,7,12,22,50,1571,1662
E01018595,6,13,25,51,1425,1520
E01018596,21,14,45,108,1730,1918
E01018583,17,16,49,140,1600,1822
E01018584,31,20,37,172,1625,1885
E01018612,1,14,27,21,1143,1206
E01018613,7,14,15,35,1412,1483
E01018600,17,3,32,162,1395,1609
E01018601,16,9,36,45,1611,1717
E01018602,7,12,23,76,1592,1710
E01018652,19,3,27,42,1478,1569
E01018598,1,2,6,12,1560,1581
E01018599,4,2,13,14,1112,1145
E01018648,9,5,38,44,2076,2172
E01018649,1,1,15,8,1337,1362
E01018650,2,5,13,22,1646,1688
E01018651,14,21,28,72,1447,1582
E01018654,2,8,18,14,2235,2277
E01018588,3,1,15,19,1505,1543
E01018589,5,5,12,29,1557,1608
E01018590,3,3,21,30,1783,1840
E01018653,5,5,22,31,1936,1999
E01018605,2,2,11,9,1113,1137
E01018609,5,5,16,38,1624,1688
E01018610,4,9,22,42,1833,1910
E01018611,5,8,30,63,1577,1683
E01018666,7,15,32,45,1684,1783
E01018667,4,3,24,12,1572,1615
E01018668,3,3,9,8,1707,1730
E01018603,6,1,17,16,1240,1280
E01018604,3,0,6,14,1317,1340
E01018606,5,6,25,23,1413,1472
E01018607,5,1,11,17,1265,1299
E01018608,2,4,18,11,1347,1382
E01018572,5,5,33,37,1717,1797
E01018573,10,13,27,44,1450,1544
E01018574,11,20,32,59,1813,1935
E01018580,7,6,10,38,1470,1531
E01018581,4,1,16,14,1184,1219
E01018575,0,4,7,7,1083,1101
E01018576,0,3,8,26,1711,1748
E01018577,2,3,20,12,2398,2435
E01018578,0,3,12,4,1195,1214
E01018579,4,3,7,2,1079,1095
E01018641,1,7,12,15,1245,1280
E01018642,6,3,7,51,1315,1382
E01018643,9,2,11,35,1868,1925
E01018644,3,0,10,63,1298,1374
E01018614,0,8,33,121,1737,1899
E01018618,5,13,21,93,1335,1467
E01018619,0,6,9,10,1401,1426
E01018620,3,12,17,77,1323,1432
E01018621,0,6,7,16,1291,1320
E01018626,2,7,19,29,2092,2149
E01018628,2,12,11,7,1558,1590
E01018629,0,10,28,59,1761,1858
E01018630,4,3,13,11,1249,1280
E01018631,2,1,6,8,1363,1380
E01018615,3,4,15,27,1129,1178
E01018616,3,5,17,29,1266,1320
E01018617,3,0,3,11,1420,1437
E01018632,6,9,13,20,1536,1584
E01018633,5,2,1,11,1482,1501
E01018622,4,4,13,65,1239,1325
E01018623,1,4,20,17,1447,1489
E01018624,3,19,36,147,1619,1824
E01018625,6,4,23,42,1350,1425
E01018627,1,19,23,65,1471,1579
E01018635,3,1,16,21,1184,1225
E01018636,1,2,16,32,1370,1421
E01018634,1,3,23,20,1827,1874
E01018645,0,23,12,26,1736,1797
E01018646,1,4,23,24,1729,1781
E01018647,1,4,24,23,1492,1544
E01018591,3,0,16,16,2304,2339
E01018597,4,6,18,7,2338,2373
E01018669,3,0,16,8,2561,2588
E01018670,0,1,20,7,2329,2357
E01018637,3,11,8,25,1776,1823
E01018638,1,3,23,13,1545,1585
E01018639,3,2,19,73,1304,1401
E01018640,3,5,8,39,1256,1311
E01018308,2,3,22,18,1857,1902
E01018336,2,2,3,4,1222,1233
E01018337,3,2,14,13,1299,1331
E01018338,0,4,21,14,1751,1790
E01018358,6,12,19,31,1204,1272
E01018359,2,0,4,13,1062,1081
E01018360,14,22,18,46,1996,2096
E01018366,1,10,18,11,1475,1515
E01018367,4,1,16,22,1941,1984
E01018364,7,9,18,99,1432,1565
E01018365,5,0,12,29,1814,1860
E01018378,6,7,9,59,1149,1230
E01018379,2,5,16,27,1297,1347
E01018380,3,3,9,62,1099,1176
E01018362,0,2,17,57,1440,1516
E01018363,3,1,8,21,1015,1048
E01018374,8,21,37,78,1750,1894
E01018375,19,24,26,44,1689,1802
E01018376,11,13,11,32,1573,1640
E01018377,1,11,11,24,1600,1647
E01018309,0,1,13,18,1616,1648
E01018310,1,1,20,10,1499,1531
E01018311,1,1,23,13,1350,1388
E01018312,4,4,23,10,1452,1493
E01018313,1,1,7,4,1344,1357
E01018314,0,6,20,28,1590,1644
E01018315,0,1,11,3,1110,1125
E01018316,1,4,20,30,1376,1431
E01018317,1,23,23,10,1425,1482
E01018349,2,1,8,12,1595,1618
E01018350,4,0,20,6,1897,1927
E01018368,0,5,9,4,1359,1377
E01018370,1,4,9,5,1332,1351
E01018345,9,4,10,46,1248,1317
E01018346,0,2,9,7,1352,1370
E01018347,1,7,13,41,1293,1355
E01018383,0,1,13,19,1498,1531
E01018384,2,12,11,16,1405,1446
E01018327,23,16,37,51,1871,1998
E01018343,5,16,30,42,1552,1645
E01018361,6,22,25,37,1381,1471
E01032930,17,34,27,89,1685,1852
E01032931,1,7,16,37,1024,1085
E01018326,5,10,30,49,1918,2012
E01018328,6,12,38,35,1776,1867
E01018329,17,39,50,55,1976,2137
E01018330,2,5,17,19,1200,1243
E01018331,1,13,38,42,1556,1650
E01018319,4,7,22,33,2043,2109
E01018344,6,11,34,32,1853,1936
E01018381,0,4,25,21,1146,1196
E01018382,3,6,15,19,1489,1532
E01018323,4,2,14,11,1352,1383
E01018324,0,6,7,22,1282,1317
E01018325,0,5,24,22,1416,1467
E01018385,2,0,9,20,1997,2028
E01018320,0,1,11,17,1426,1455
E01018321,1,3,16,18,1162,1200
E01018322,5,2,15,31,1119,1172
E01018348,1,2,26,31,2055,2115
E01018332,1,1,10,29,1022,1063
E01018333,2,4,16,42,1439,1503
E01018334,6,1,23,45,1436,1511
E01018340,2,1,22,37,1366,1428
E01018341,2,5,21,25,1055,1108
E01018342,4,13,30,44,1477,1568
E01018351,0,2,17,12,1417,1448
E01018352,12,17,27,38,1696,1790
E01018353,1,5,24,34,1511,1575
E01018354,5,10,23,34,1534,1606
E01018335,1,4,25,15,2070,2115
E01018369,0,1,9,4,1664,1678
E01018371,0,2,6,10,1789,1807
E01018372,0,0,12,8,1876,1896
E01018339,3,0,2,1,2012,2018
E01018355,0,3,3,3,1201,1210
E01018356,0,1,7,1,1465,1474
E01018357,2,2,9,5,1273,1291
E01018373,0,5,17,3,1955,1980
E01018534,9,4,36,33,2439,2521
E01018535,2,1,15,16,1490,1524
E01018536,1,0,17,11,1618,1647
E01018537,9,3,22,21,1889,1944
E01018518,0,0,11,11,1485,1507
E01018569,0,5,9,2,1267,1283
E01018570,2,2,17,1,1178,1200
E01018571,4,1,9,4,1324,1342
E01018546,0,4,16,3,1456,1479
E01018547,0,2,9,2,1371,1384
E01018548,1,5,10,15,1546,1577
E01018549,2,6,8,10,1386,1412
E01018532,5,1,20,5,1824,1855
E01018533,1,0,5,8,1492,1506
E01018544,3,1,4,6,1477,1491
E01018545,0,3,11,3,1903,1920
E01018519,5,3,14,34,1360,1416
E01018520,0,13,6,33,983,1035
E01018525,1,3,12,3,1310,1329
E01018563,0,7,28,20,2046,2101
E01018564,2,2,16,26,2201,2247
E01018523,0,0,9,9,1329,1347
E01018524,1,2,15,1,1394,1413
E01018541,1,6,11,7,1360,1385
E01018542,0,2,17,14,1284,1317
E01018543,2,1,8,5,1303,1319
E01018528,0,0,8,11,1157,1176
E01018529,3,2,11,5,1486,1507
E01018530,2,1,20,13,1481,1517
E01018531,7,7,7,15,1530,1566
E01018560,0,3,4,24,1138,1169
E01018561,0,1,11,19,1205,1236
E01018562,1,1,6,31,1415,1454
E01018522,1,1,16,4,1360,1382
E01018538,0,5,13,10,1171,1199
E01018539,0,5,10,14,1059,1088
E01018540,0,9,23,8,1404,1444
E01018521,3,0,18,9,1183,1213
E01018550,5,4,7,21,1037,1074
E01018551,2,12,27,30,1433,1504
E01018552,2,7,18,15,1512,1554
E01018553,5,1,11,23,1470,1510
E01018556,0,5,9,11,1410,1435
E01018557,1,0,7,20,1427,1455
E01018558,0,0,12,17,1264,1293
E01018559,0,0,5,12,1151,1168
E01018565,5,0,8,27,1528,1568
E01018566,0,0,6,6,1320,1332
E01018567,5,4,4,16,1395,1424
E01018568,0,2,23,64,1478,1567
E01018526,0,1,18,14,1591,1624
E01018527,6,1,13,24,1683,1727
E01018554,5,9,8,22,2303,2347
E01018555,3,0,2,4,1163,1172
E01018685,0,0,12,5,1199,1216
E01018686,1,5,7,10,1391,1414
E01018687,2,2,11,3,1347,1365
E01018688,2,5,17,33,1503,1560
E01018689,1,1,17,31,1400,1450
E01018690,0,1,12,13,2046,2072
E01018675,1,5,19,0,2067,2092
E01018708,1,4,10,10,2096,2121
E01018721,1,0,9,2,2189,2201
E01018671,0,1,9,11,1237,1258
E01018672,0,0,7,8,1591,1606
E01018673,0,3,7,3,1179,1192
E01018674,1,4,8,5,1540,1558
E01018684,1,3,5,5,2241,2255
E01018695,0,2,11,40,1631,1684
E01018696,4,0,7,6,1456,1473
E01018697,6,3,14,3,1789,1815
E01018698,3,2,12,11,1959,1987
E01018704,0,1,6,24,1153,1184
E01018705,0,6,10,11,1503,1530
E01018706,0,0,16,46,1336,1398
E01018718,0,0,4,12,1617,1633
E01018722,2,2,17,10,2233,2264
E01018713,5,3,18,53,2634,2713
E01018714,2,12,22,39,1753,1828
E01018715,6,0,18,36,1669,1729
E01018726,0,0,9,2,1492,1503
E01018727,3,1,9,6,1633,1652
E01018728,6,1,13,28,1515,1563
E01018729,5,2,9,3,1654,1673
E01018709,2,5,4,27,1454,1492
E01018710,2,8,12,21,1444,1487
E01018711,7,2,17,16,1484,1526
E01018712,8,3,28,12,1513,1564
E01018699,2,3,18,14,1592,1629
E01018701,0,3,4,10,1445,1462
E01018716,2,3,14,11,1514,1544
E01018717,2,7,37,39,1678,1763
E01018719,3,6,16,12,1513,1550
E01018720,3,1,18,9,1534,1565
E01018691,6,6,7,18,1545,1582
E01018693,0,2,12,33,1542,1589
E01018694,0,0,9,18,1557,1584
E01018700,4,5,28,33,1971,2041
E01018702,3,2,5,12,1264,1286
E01018703,3,4,21,23,1760,1811
E01018676,1,1,13,10,1426,1451
E01018677,4,0,5,2,1419,1430
E01018678,2,2,8,8,1294,1314
E01018679,1,2,17,18,1689,1727
E01018692,10,3,15,35,1912,1975
E01018680,0,4,7,10,1601,1622
E01018681,1,3,6,6,1435,1451
E01018682,0,0,2,4,1069,1075
E01018683,1,2,8,0,1487,1498
E01018733,1,3,6,13,1452,1475
E01018734,0,4,9,8,1252,1273
E01018748,0,1,13,2,1374,1390
E01018749,1,9,24,45,2430,2509
E01018736,1,9,14,15,1590,1629
E01018737,6,1,18,5,1308,1338
E01018743,1,2,10,2,1448,1463
E01018744,0,4,29,30,1644,1707
E01018732,2,1,16,9,1397,1425
E01018745,3,0,9,3,1541,1556
E01018746,0,1,6,22,1603,1632
E01018747,2,5,10,16,1478,1511
E01018730,0,8,11,18,1426,1463
E01018738,0,1,13,12,1448,1474
E01018739,1,3,25,19,1395,1443
E01018741,0,2,14,36,1211,1263
E01018731,0,4,10,11,1575,1600
E01018735,0,3,11,7,1280,1301
E01018740,2,2,10,9,1514,1537
E01018742,0,1,11,11,1469,1492
E01018707,3,0,4,22,1702,1731
E01018723,1,4,5,3,1111,1124
E01018724,0,3,7,4,1476,1490
E01018725,0,3,9,4,1294,1310
E01012392,4,9,32,20,2285,2350
E01012393,7,2,27,8,1984,2028
E01012395,4,4,7,21,1409,1445
E01012411,5,6,10,10,1283,1314
E01012374,1,4,23,40,2665,2733
E01012375,0,0,12,34,1537,1583
E01012376,2,9,33,50,2499,2593
E01012421,0,3,8,21,1307,1339
E01012423,0,1,8,17,1392,1418
E01012368,0,0,13,14,1911,1938
E01012410,0,1,7,11,1246,1265
E01012412,0,12,18,12,1407,1449
E01012413,0,4,18,11,1452,1485
E01012414,3,0,7,5,1217,1232
E01012377,2,4,6,6,1776,1794
E01012390,1,0,4,0,1592,1597
E01012419,1,1,11,0,1130,1143
E01012420,10,2,33,9,1427,1481
E01012422,4,9,21,4,1442,1480
E01012369,1,0,8,5,1503,1517
E01012394,0,0,4,9,1472,1485
E01012425,9,3,10,15,1576,1613
E01012426,2,1,11,2,1329,1345
E01012427,2,0,32,18,1713,1765
E01012378,1,5,18,3,1471,1498
E01012379,1,0,6,2,1472,1481
E01012380,0,1,9,1,1380,1391
E01012388,0,1,19,0,1794,1814
E01012442,1,1,14,11,1594,1621
E01012367,5,3,19,28,1536,1591
E01012370,0,1,31,24,1687,1743
E01012424,2,10,16,13,1836,1877
E01012441,8,8,37,9,2239,2301
E01012389,1,1,11,9,1763,1785
E01012391,7,12,33,18,2060,2130
E01012401,0,7,23,6,1805,1841
E01012443,2,0,14,15,1566,1597
E01012385,0,4,17,23,1397,1441
E01012386,2,1,22,37,1883,1945
E01012387,1,0,9,11,1094,1115
E01012434,3,7,21,16,1530,1577
E01012435,1,4,21,24,2064,2114
E01012381,0,1,15,9,1326,1351
E01012382,1,3,32,12,1449,1497
E01012384,2,3,18,8,1557,1588
E01012444,0,0,6,3,1130,1139
E01012445,0,0,16,7,1253,1276
E01012398,0,0,13,4,1222,1239
E01012400,0,0,13,3,1224,1240
E01012402,2,2,3,7,1572,1586
E01012404,0,7,6,3,1387,1403
E01012405,1,3,18,11,1959,1992
E01012416,0,4,15,13,1760,1792
E01012417,3,0,17,9,1265,1294
E01012428,0,7,24,22,2147,2200
E01012429,0,3,9,4,1371,1387
E01012430,1,7,25,9,1713,1755
E01012431,8,12,30,22,1992,2064
E01012383,3,1,20,16,1662,1702
E01012396,1,3,11,17,1499,1531
E01012397,0,5,20,14,1466,1505
E01012399,0,0,15,17,1376,1408
E01012403,5,3,12,3,1601,1624
E01012408,1,7,24,14,2000,2046
E01012432,0,0,20,7,1382,1409
E01012433,1,10,32,5,1572,1620
E01012436,1,1,29,3,1300,1334
E01012438,4,1,27,8,1149,1189
E01012440,5,2,10,12,1344,1373
E01012406,1,6,12,14,1563,1596
E01012407,1,15,44,7,1527,1594
E01012409,1,5,19,17,1392,1434
E01012437,0,4,25,3,1322,1354
E01012439,3,1,29,8,1481,1522
E01012371,3,1,11,4,1225,1244
E01012372,3,1,12,12,1111,1139
E01012373,2,1,10,3,1274,1290
E01012415,0,0,4,11,1384,1399
E01012418,0,0,7,10,1359,1376
E01012471,16,87,60,92,2034,2289
E01012472,6,1,13,9,1794,1823
E01012476,7,2,25,7,1503,1544
E01012477,2,3,13,14,1527,1559
E01012473,0,2,17,11,1528,1558
E01012474,0,2,17,23,1385,1427
E01012475,1,9,15,11,1454,1490
E01012554,0,3,14,18,1925,1960
E01012467,0,0,1,14,1209,1224
E01012468,9,10,28,50,2338,2435
E01012469,0,0,14,13,1519,1546
E01012470,0,1,7,7,1128,1143
E01012460,1,9,23,31,1356,1420
E01012462,5,4,19,59,1202,1289
E01012463,0,2,10,12,1104,1128
E01012464,6,3,22,29,1339,1399
E01012459,2,5,25,13,1316,1361
E01012461,4,3,19,26,1256,1308
E01012465,2,4,23,25,1235,1289
E01012466,5,5,24,39,1434,1507
E01012526,3,12,16,31,1638,1700
E01012534,0,6,26,6,1482,1520
E01012535,1,4,23,9,1618,1655
E01012537,0,0,15,5,1476,1496
E01012539,1,4,15,5,1524,1549
E01012538,3,3,13,11,1397,1427
E01012540,3,3,16,18,1326,1366
E01012541,4,4,16,9,1270,1303
E01012542,6,2,15,7,1326,1356
E01012543,1,10,20,6,1610,1647
E01012544,3,10,18,11,1362,1404
E01012521,2,0,14,13,1542,1571
E01012522,1,2,15,21,1320,1359
E01012533,2,2,28,10,1403,1445
E01012536,0,5,15,12,1404,1436
E01012545,6,7,26,34,1519,1592
E01012546,3,5,17,10,1563,1598
E01012561,4,0,11,77,1497,1589
E01012562,14,12,35,139,1526,1726
E01012567,7,1,29,66,1772,1875
E01012568,3,16,32,174,2275,2500
E01012563,8,8,10,121,1582,1729
E01012564,7,11,12,40,1332,1402
E01012565,5,14,18,211,2246,2494
E01012566,15,15,40,280,1806,2156
E01012569,10,9,18,164,1724,1925
E01012570,1,6,18,49,1130,1204
E01012481,2,2,24,21,1545,1594
E01012482,2,3,12,23,1561,1601
E01012520,10,3,29,12,1452,1506
E01012523,1,7,16,13,1405,1442
E01012524,2,0,12,4,1505,1523
E01012525,5,2,15,27,1468,1517
E01012478,3,3,10,3,1427,1446
E01012547,2,6,10,6,1692,1716
E01012548,3,3,10,7,1770,1793
E01012549,2,2,6,2,1381,1393
E01012550,2,1,10,3,1567,1583
E01012453,4,11,21,26,1653,1715
E01012454,6,8,13,167,1840,2034
E01012455,6,8,34,71,1815,1934
E01012457,16,10,16,192,1428,1662
E01012551,4,8,9,28,1511,1560
E01012552,2,2,19,35,1299,1357
E01012553,0,1,5,12,1336,1354
E01012555,4,0,9,14,1375,1402
E01012556,2,3,6,17,1455,1483
E01012491,0,3,10,11,1398,1422
E01012492,0,7,4,21,1412,1444
E01012493,4,3,10,13,1789,1819
E01012494,3,5,18,20,1608,1654
E01012500,1,2,9,7,1335,1354
E01012495,5,3,7,62,1636,1713
E01012496,0,2,11,27,1360,1400
E01012497,1,10,15,55,1190,1271
E01012498,4,10,26,33,1450,1523
E01012499,0,9,16,59,1824,1908
E01012501,1,7,9,16,1386,1419
E01012479,3,7,19,54,1535,1618
E01012480,7,13,10,131,1799,1960
E01012510,5,4,31,61,1650,1751
E01012511,3,19,19,41,1588,1670
E01033299,20,14,22,85,1869,2010
E01033303,8,5,17,39,1096,1165
E01012458,7,2,23,77,2258,2367
E01012483,4,10,18,62,1527,1621
E01012509,5,3,24,23,1736,1791
E01012512,0,1,10,18,1529,1558
E01033300,24,15,17,141,885,1082
E01033302,18,15,23,157,1332,1545
E01012527,2,2,14,28,1445,1491
E01012528,3,0,8,10,1220,1241
E01012529,1,2,17,13,1393,1426
E01012530,3,0,5,11,1423,1442
E01012531,0,0,8,17,1488,1513
E01012532,1,3,6,5,1415,1430
E01012504,13,9,25,28,1710,1785
E01012505,5,4,21,18,1352,1400
E01012506,3,2,7,12,1520,1544
E01012507,6,6,15,43,1775,1845
E01012508,0,6,18,37,1499,1560
E01012513,5,3,26,37,1909,1980
E01012514,0,3,19,25,1817,1864
E01012515,2,4,21,23,1421,1471
E01012516,1,1,6,17,1317,1342
E01012517,10,8,32,43,2123,2216
E01012518,1,8,29,10,1955,2003
E01012519,4,3,17,11,1439,1474
E01012485,0,3,14,22,1529,1568
E01012486,1,2,14,13,1453,1483
E01012487,0,0,4,18,1515,1537
E01012489,0,6,22,33,1837,1898
E01012490,0,2,7,5,1452,1466
E01012450,1,2,14,42,1344,1403
E01012451,0,9,13,15,1521,1558
E01012557,2,2,27,28,1515,1574
E01012558,0,0,16,31,1740,1787
E01012559,4,4,11,19,1516,1554
E01012560,7,0,15,19,1435,1476
E01012448,4,6,29,52,1488,1579
E01012488,6,4,8,31,1686,1735
E01012502,1,0,10,22,1600,1633
E01012503,4,2,20,28,1397,1451
E01012446,5,1,16,53,1354,1429
E01012447,9,3,8,67,1407,1494
E01012449,3,0,5,34,1361,1403
E01012452,0,6,23,53,1688,1770
E01019126,0,0,13,3,1687,1703
E01019127,0,0,3,5,1557,1565
E01019132,0,0,4,0,1799,1803
E01019134,0,0,3,4,1516,1523
E01019135,0,0,7,0,1586,1593
E01019136,1,1,5,6,1607,1620
E01019137,0,1,5,7,1082,1095
E01019083,3,1,12,9,1807,1832
E01019107,1,1,3,2,1601,1608
E01019130,2,0,3,0,1678,1683
E01019131,0,0,8,4,1928,1940
E01019081,0,1,4,0,1879,1884
E01019082,1,3,8,2,1482,1496
E01019102,3,1,9,6,1709,1728
E01019128,1,0,6,1,1623,1631
E01019133,2,0,8,5,1531,1546
E01019093,0,1,4,6,1550,1561
E01019094,0,1,9,2,1691,1703
E01019096,1,0,7,4,2262,2274
E01019114,0,3,7,4,1458,1472
E01019115,1,2,7,16,1583,1609
E01019095,1,0,17,11,1507,1536
E01019097,1,5,14,8,1775,1803
E01019098,0,0,6,1,1637,1644
E01019099,0,0,11,4,1692,1707
E01019084,1,1,8,6,1492,1508
E01019085,3,6,6,33,1502,1550
E01019086,0,1,4,11,1104,1120
E01019088,0,4,18,38,1654,1714
E01019091,1,0,5,0,1852,1858
E01019078,1,1,6,7,1531,1546
E01019079,0,0,2,6,1461,1469
E01019080,1,1,10,25,1772,1809
E01019087,1,0,5,7,1612,1625
E01019090,1,0,6,4,1561,1572
E01019116,0,0,3,9,1240,1252
E01019118,0,1,11,9,1348,1369
E01019122,1,0,3,13,1398,1415
E01019123,0,0,14,12,1551,1577
E01019124,1,0,7,11,2064,2083
E01019125,0,0,5,3,1528,1536
E01019111,1,0,4,1,1531,1537
E01019112,0,2,5,6,1680,1693
E01019113,7,2,7,5,1728,1749
E01019120,3,2,9,8,1761,1783
E01019121,0,2,15,24,1948,1989
E01019108,0,1,3,14,1469,1487
E01019109,2,3,3,16,1794,1818
E01019110,0,0,1,0,1672,1673
E01019117,1,0,5,2,1301,1309
E01019119,1,0,3,0,1505,1509
E01019089,2,1,4,4,1583,1594
E01019100,3,2,6,4,1645,1660
E01019101,0,1,8,1,1497,1507
E01019129,2,1,6,1,1684,1694
E01019092,3,5,17,18,1572,1615
E01019103,1,4,4,15,1267,1291
E01019104,2,6,9,10,1330,1357
E01019105,4,2,14,32,1075,1127
E01019106,0,3,7,12,1446,1468
E01019144,3,0,11,4,1440,1458
E01019145,0,0,6,8,1990,2004
E01019146,1,3,5,3,1358,1370
E01019147,5,1,16,4,1549,1575
E01019148,0,3,12,2,1387,1404
E01019149,0,0,3,13,1489,1505
E01019150,0,4,9,3,1523,1539
E01019151,1,0,0,14,1472,1487
E01019152,1,2,10,52,1151,1216
E01019153,0,0,3,9,1062,1074
E01019154,8,0,4,29,1212,1253
E01019155,0,1,4,33,1341,1379
E01019162,1,0,6,10,1455,1472
E01019163,9,5,8,20,1273,1315
E01019156,1,0,10,30,1382,1423
E01019159,2,0,2,12,1036,1052
E01019164,4,0,10,2,1435,1451
E01019165,0,3,7,22,1376,1408
E01019166,1,1,6,6,1357,1371
E01019167,0,2,4,8,1469,1483
E01019168,2,0,9,14,1370,1395
E01019169,0,2,10,13,1324,1349
E01019170,0,8,6,20,1248,1282
E01019171,1,5,11,17,1286,1320
E01019161,5,1,11,16,1719,1752
E01019176,2,0,6,10,1686,1704
E01019177,9,4,5,12,1370,1400
E01019178,0,2,7,9,1491,1509
E01019179,2,0,6,9,1212,1229
E01019140,0,3,4,8,1036,1051
E01019160,0,1,5,6,1368,1380
E01019172,1,0,16,13,1353,1383
E01019173,0,0,7,12,1301,1320
E01019174,1,0,2,15,1145,1163
E01019175,1,0,10,9,1416,1436
E01019141,2,3,5,34,1184,1228
E01019142,4,0,6,8,1413,1431
E01019143,3,5,12,34,1558,1612
E01019157,2,1,7,43,1391,1444
E01019158,3,3,13,16,1158,1193
E01019180,1,0,8,4,1846,1859
E01019182,0,0,9,4,1370,1383
E01019184,1,1,4,2,1327,1335
E01033160,6,1,12,3,2080,2102
E01019138,1,1,4,3,1253,1262
E01019139,0,2,10,7,1335,1354
E01019185,0,1,4,2,1403,1410
E01019186,0,0,7,3,1270,1280
E01019187,0,1,8,3,1270,1282
E01019226,3,1,7,4,1144,1159
E01019227,0,0,5,3,1403,1411
E01019228,2,3,4,13,1531,1553
E01019229,1,0,2,2,1928,1933
E01019200,2,2,6,6,1535,1551
E01019201,0,7,4,7,1412,1430
E01019202,0,3,9,6,1628,1646
E01019225,0,1,13,3,1985,2002
E01019188,0,1,4,33,1450,1488
E01019189,4,4,11,47,1479,1545
E01019190,0,0,0,31,1534,1565
E01019191,2,1,7,36,1505,1551
E01019244,0,1,7,5,1447,1460
E01019196,6,4,15,22,1746,1793
E01019238,0,1,9,20,1281,1311
E01019240,7,3,8,7,1743,1768
E01019241,0,3,10,27,1572,1612
E01019243,1,0,11,19,1502,1533
E01019251,2,0,6,9,1723,1740
E01019192,0,0,5,5,1446,1456
E01019195,3,1,8,7,1407,1426
E01019203,2,0,8,6,2101,2117
E01019254,1,0,2,1,1352,1356
E01019255,0,0,4,2,1360,1366
E01019204,1,7,10,33,1225,1276
E01019206,2,5,17,63,1383,1470
E01019234,1,5,24,70,1447,1547
E01019235,0,3,7,15,1462,1487
E01019237,0,3,10,18,1454,1485
E01019242,1,2,14,21,1291,1329
E01019219,1,6,10,11,2129,2157
E01019224,2,4,5,6,2047,2064
E01019239,0,0,3,6,1551,1560
E01019249,0,1,2,7,1429,1439
E01019250,0,0,6,16,1340,1362
E01019205,11,19,22,86,1576,1714
E01019207,6,10,11,16,1351,1394
E01019215,1,4,12,14,1469,1500
E01019218,0,1,12,13,1549,1575
E01019233,0,0,4,7,1321,1332
E01019193,1,5,10,14,1486,1516
E01019194,6,0,9,23,2055,2093
E01019230,0,0,3,6,1533,1542
E01019231,0,1,3,9,1459,1472
E01019232,1,1,4,8,1465,1479
E01019252,1,0,9,0,1382,1392
E01019209,1,1,10,19,1413,1444
E01019211,3,3,9,34,1732,1781
E01019216,0,1,8,32,1542,1583
E01019217,1,1,16,33,1674,1725
E01019220,1,2,7,18,1530,1558
E01019236,4,4,11,90,1498,1607
E01019197,12,1,9,24,1943,1989
E01019198,3,1,3,3,1340,1350
E01019199,0,0,5,3,1054,1062
E01019221,1,3,9,16,1935,1964
E01019222,4,0,9,9,1633,1655
E01019245,2,1,5,20,1533,1561
E01019208,0,0,5,14,1507,1526
E01019210,0,3,3,12,1449,1467
E01019246,0,0,3,2,1262,1267
E01019247,0,4,7,14,1483,1508
E01019248,0,1,9,10,1120,1140
E01019212,0,3,4,58,1468,1533
E01019213,3,1,8,25,2700,2737
E01019214,2,0,5,8,1766,1781
E01019223,6,0,10,6,1514,1536
E01019253,0,4,8,15,1766,1793
E01019268,1,1,6,3,1119,1130
E01019269,5,0,7,8,1546,1566
E01019270,0,0,4,6,1352,1362
E01019297,0,1,3,6,1438,1448
E01019260,0,1,4,20,1482,1507
E01019280,0,2,13,48,1498,1561
E01019281,0,1,4,18,1214,1237
E01019282,0,1,6,12,1288,1307
E01019261,1,0,6,19,1730,1756
E01019262,4,3,11,24,1704,1746
E01019284,1,3,2,12,1237,1255
E01019285,6,8,16,91,1450,1571
E01019286,3,1,2,14,1299,1319
E01019287,0,0,1,8,1199,1208
E01019288,7,1,3,12,1454,1477
E01019256,3,2,8,9,1478,1500
E01019263,0,0,2,10,1126,1138
E01019264,1,0,9,1,1690,1701
E01019265,1,0,4,16,1260,1281
E01019266,3,0,4,13,1451,1471
E01019267,0,0,7,7,1331,1345
E01019276,2,0,4,5,1014,1025
E01019277,1,0,9,2,1200,1212
E01019278,1,2,9,3,1331,1346
E01019291,0,0,10,1,1306,1317
E01019292,0,0,11,4,1105,1120
E01019294,1,0,0,3,1442,1446
E01019295,0,0,9,12,1546,1567
E01019296,3,0,9,5,1468,1485
E01019301,2,0,8,22,1406,1438
E01019302,1,0,8,10,1006,1025
E01019271,0,1,4,7,1351,1363
E01019272,0,2,3,5,1475,1485
E01019273,1,2,8,7,1590,1608
E01019274,1,3,21,19,1498,1542
E01019275,2,4,4,2,2184,2196
E01019257,0,5,7,3,1483,1498
E01019258,0,2,6,4,1514,1526
E01019279,0,0,8,3,1385,1396
E01019300,0,1,7,61,1732,1801
E01019303,1,5,9,10,1498,1523
E01019304,1,2,1,11,1285,1300
E01019259,2,4,7,2,1285,1300
E01019283,2,23,23,52,1749,1849
E01019289,0,1,3,4,1378,1386
E01019290,1,0,1,3,1090,1095
E01019293,0,0,7,2,1360,1369
E01019298,1,1,8,1,1503,1514
E01019299,1,1,13,9,1961,1985
E01019305,6,2,3,6,2071,2088
E01019314,0,1,1,2,1269,1273
E01019320,1,0,12,6,1452,1471
E01019321,0,0,11,1,1550,1562
E01019315,0,1,7,8,1683,1699
E01019316,0,1,4,9,1480,1494
E01019322,6,0,3,2,1377,1388
E01019338,0,1,4,10,1482,1497
E01019327,0,0,11,14,1317,1342
E01019332,0,0,7,6,1385,1398
E01019333,0,0,3,19,1112,1134
E01019335,0,0,6,14,1502,1522
E01019336,5,0,9,31,1678,1723
E01019312,2,0,6,12,1427,1447
E01019326,2,1,8,5,1524,1540
E01019328,0,0,5,5,1332,1342
E01019329,6,1,8,8,1117,1140
E01019330,0,2,6,24,1423,1455
E01019331,1,0,6,14,1508,1529
E01019334,2,1,3,3,1353,1362
E01019308,4,1,15,2,1410,1432
E01019311,1,0,3,10,1424,1438
E01019313,0,0,2,2,1370,1374
E01019339,0,3,12,10,1397,1422
E01019306,0,0,5,9,1279,1293
E01019307,0,2,7,5,1741,1755
E01019310,1,2,5,1,1387,1396
E01019319,0,0,3,4,1556,1563
E01019323,0,0,5,3,1194,1202
E01019324,0,0,10,7,1283,1300
E01019337,0,0,6,4,1384,1394
E01019309,0,2,3,7,2281,2293
E01019317,0,0,3,6,1310,1319
E01019318,0,0,4,9,1248,1261
E01019325,2,0,1,11,1350,1364
E01019340,1,1,4,3,1343,1352
E01019374,0,6,16,32,1479,1533
E01019375,0,3,11,7,1424,1445
E01019376,0,6,6,6,1424,1442
E01019395,3,7,27,43,1994,2074
E01019387,0,5,14,8,2089,2116
E01019396,0,6,16,18,2021,2061
E01019397,2,14,20,46,1893,1975
E01019398,0,3,10,14,1165,1192
E01019399,0,12,7,14,1024,1057
E01019346,1,2,7,0,1905,1915
E01019359,1,0,11,4,2040,2056
E01019365,1,1,20,8,2171,2201
E01019370,1,3,19,6,2190,2219
E01019360,7,8,26,26,2016,2083
E01019363,4,6,16,41,1859,1926
E01019364,4,3,17,44,1867,1935
E01019371,0,4,20,12,2167,2203
E01019358,2,1,8,7,1814,1832
E01019362,1,1,11,9,1944,1966
E01019366,5,5,12,5,1855,1882
E01019394,4,1,11,5,2292,2313
E01019361,3,8,9,11,1819,1850
E01019367,2,13,20,32,2401,2468
E01019368,8,1,7,13,2081,2110
E01019369,3,0,7,7,1838,1855
E01019356,0,1,14,6,1414,1435
E01019381,2,3,20,5,2084,2114
E01019386,2,1,12,5,1707,1727
E01019344,0,1,6,1,1023,1031
E01019345,0,0,3,1,1170,1174
E01019350,0,0,5,3,1609,1617
E01019351,1,2,1,4,1745,1753
E01019372,1,0,15,4,1037,1057
E01019373,1,5,11,65,1365,1447
E01019384,4,0,17,53,2527,2601
E01019385,3,0,7,9,1121,1140
E01019348,2,0,0,1,1224,1227
E01019352,0,3,7,3,2222,2235
E01019377,0,0,5,7,1736,1748
E01019383,0,0,3,0,1972,1975
E01019341,3,0,6,11,1511,1531
E01019342,0,1,3,5,1054,1063
E01019343,1,4,10,3,1506,1524
E01019347,2,0,6,11,1737,1756
E01019382,5,7,25,23,2139,2199
E01019388,1,1,13,19,1890,1924
E01019389,3,2,13,15,2235,2268
E01019390,6,5,14,18,1954,1997
E01019392,0,2,20,27,1784,1833
E01019349,1,0,4,2,1824,1831
E01019353,0,6,5,8,1477,1496
E01019354,0,3,6,11,1300,1320
E01019355,0,1,2,3,1292,1298
E01019357,1,6,6,14,1842,1869
E01019378,0,0,10,10,1581,1601
E01019379,0,3,5,4,1416,1428
E01019380,0,2,2,3,1067,1074
E01019391,0,1,4,2,1710,1717
E01019393,2,4,5,13,1915,1939
E01004768,5,4,28,63,1501,1601
E01004803,3,2,16,18,1596,1635
E01004804,4,1,10,15,1422,1452
E01004807,2,2,8,24,1415,1451
E01004808,3,1,19,18,1602,1643
E01004788,0,3,12,15,1362,1392
E01004790,1,6,12,17,1396,1432
E01004805,4,2,24,18,1585,1633
E01004806,2,6,12,9,1486,1515
E01004810,3,5,14,22,1553,1597
E01004769,2,1,21,83,1427,1534
E01004770,10,2,12,236,1205,1465
E01004771,3,8,21,127,1482,1641
E01004773,20,31,25,345,1541,1962
E01004809,3,2,30,7,1721,1763
E01004777,4,4,28,17,1548,1601
E01004881,8,4,7,1,1417,1437
E01004888,1,3,10,16,1292,1322
E01004889,4,5,10,13,1401,1433
E01004890,2,7,15,14,1364,1402
E01004766,2,28,26,161,1375,1592
E01004767,3,10,30,298,1337,1678
E01004772,12,28,44,77,1570,1731
E01004774,4,17,36,175,1443,1675
E01004824,10,48,36,1410,227,1731
E01004784,2,3,10,12,1234,1261
E01004785,6,8,15,36,1358,1423
E01004786,1,6,17,15,1414,1453
E01004789,1,1,12,1,1391,1406
E01004791,0,1,9,8,1216,1234
E01004792,2,1,10,14,1438,1465
E01004779,1,2,22,27,1505,1557
E01004781,6,14,41,145,1610,1816
E01004882,0,6,22,13,1321,1362
E01004883,5,5,20,10,1391,1431
E01004884,0,2,10,13,1445,1470
E01004864,3,9,46,67,1425,1550
E01004867,11,7,23,380,1096,1517
E01004921,9,17,32,73,1430,1561
E01004924,2,11,24,39,1462,1538
E01004925,2,8,23,71,1412,1516
E01004778,0,1,14,8,1163,1186
E01004780,4,2,19,22,1940,1987
E01004782,0,0,8,9,1101,1118
E01004783,0,9,3,1,1477,1490
E01004802,10,79,83,50,1587,1809
E01004926,5,28,28,20,1221,1302
E01004927,13,64,52,72,1855,2056
E01004929,17,39,34,83,1802,1975
E01004820,31,101,48,707,714,1601
E01004825,38,23,45,1058,477,1641
E01004826,11,45,45,632,853,1586
E01004865,9,5,21,300,1010,1345
E01004866,31,99,49,465,1097,1741
E01004840,4,11,20,91,1526,1652
E01004841,11,74,39,34,1562,1720
E01004842,5,7,32,93,1565,1702
E01004919,7,12,15,40,1431,1505
E01004920,7,22,30,32,1493,1584
E01004787,3,22,24,23,1536,1608
E01004793,1,49,23,33,1511,1617
E01004794,3,118,33,25,1596,1775
E01004795,7,8,20,8,1455,1498
E01004797,15,27,16,41,1272,1371
E01004775,5,13,27,57,1410,1512
E01004885,0,11,20,94,1241,1366
E01004886,4,7,2,33,1337,1383
E01004887,1,6,25,13,1370,1415
E01004868,15,43,29,495,1097,1679
E01004869,10,27,37,283,1317,1674
E01004870,39,57,42,832,919,1889
E01004871,30,92,27,929,551,1629
E01004922,13,32,37,190,1470,1742
E01004822,29,44,55,924,627,1679
E01004823,33,49,59,436,1155,1732
E01004848,36,103,46,399,1109,1693
E01033217,34,64,42,154,743,1037
E01033220,44,115,47,155,933,1294
E01004818,20,72,48,465,984,1589
E01004819,10,68,23,259,1153,1513
E01004928,9,14,22,25,1338,1408
E01004930,1,4,22,33,1457,1517
E01004931,2,16,24,32,1510,1584
E01004932,4,19,40,91,1380,1534
E01004834,13,35,49,661,856,1614
E01004838,22,85,33,437,1095,1672
E01004843,3,8,39,122,1345,1517
E01004845,3,18,40,302,1351,1714
E01004923,10,36,44,286,1208,1584
E01004796,0,3,28,42,1421,1494
E01004798,0,8,18,48,1578,1652
E01004799,2,8,10,47,1250,1317
E01004800,0,9,21,65,1208,1303
E01004801,1,38,54,40,1502,1635
E01004917,8,17,34,37,1948,2044
E01004835,14,13,20,435,1006,1488
E01004836,11,2,14,420,1044,1491
E01004837,4,19,33,426,1150,1632
E01004844,10,12,24,237,1298,1581
E01004897,3,7,21,91,963,1085
E01004827,46,99,43,450,977,1615
E01004849,51,196,48,1208,228,1731
E01004850,102,148,50,764,679,1743
E01004851,34,97,55,921,445,1552
E01004853,42,79,43,1064,371,1599
E01004811,20,53,58,666,760,1557
E01004812,28,97,34,846,843,1848
E01004813,18,47,43,530,754,1392
E01004815,21,58,24,708,767,1578
E01004817,21,33,31,406,1071,1562
E01004828,32,109,41,869,749,1800
E01004829,18,60,34,921,338,1371
E01004832,12,27,31,223,1239,1532
E01004854,41,31,29,1279,151,1531
E01004878,6,29,33,583,824,1475
E01004911,3,8,26,29,1500,1566
E01004912,3,5,18,60,1362,1448
E01004913,15,5,33,63,1844,1960
E01004914,1,5,24,20,1144,1194
E01004915,6,2,8,22,1302,1340
E01004916,6,8,19,29,1398,1460
E01004918,0,7,19,27,1250,1303
E01004846,25,42,38,525,642,1272
E01004847,57,148,57,973,769,2004
E01004852,18,77,25,1290,202,1612
E01004877,24,93,63,582,1030,1792
E01004879,18,68,35,512,827,1460
E01004830,10,22,25,207,1287,1551
E01004831,21,11,21,365,1212,1630
E01004833,10,11,25,176,1308,1530
E01004839,14,38,57,262,1607,1978
E01004814,21,42,32,412,949,1456
E01004855,12,15,37,121,1298,1483
E01004856,19,23,9,266,1105,1422
E01004857,16,6,20,313,1151,1506
E01004891,4,7,18,17,1548,1594
E01004893,1,4,15,55,1457,1532
E01004894,2,1,29,31,1777,1840
E01004901,0,5,17,41,1749,1812
E01033218,4,4,36,77,1460,1581
E01033219,9,12,17,54,1404,1496
E01004816,8,32,26,696,826,1588
E01004872,8,13,30,137,1372,1560
E01004873,18,42,35,247,1420,1762
E01004875,0,14,24,101,1451,1590
E01004880,1,19,16,224,1073,1333
E01004892,5,2,9,30,1485,1531
E01004896,1,15,20,15,1309,1360
E01004899,13,12,34,248,1232,1539
E01004900,7,17,42,389,1144,1599
E01004776,2,4,12,32,1752,1802
E01004895,3,4,23,7,1288,1325
E01004936,1,5,25,32,1966,2029
E01004938,3,2,31,30,1427,1493
E01004939,5,5,16,18,1475,1519
E01004858,4,9,29,90,1468,1600
E01004859,7,17,28,61,1350,1463
E01004860,2,14,15,27,1429,1487
E01004902,3,20,14,55,1587,1679
E01004906,2,20,32,39,1591,1684
E01004861,3,28,53,102,1477,1663
E01004862,10,16,23,46,1279,1374
E01004863,14,5,38,49,1430,1536
E01004874,17,25,31,61,1670,1804
E01004876,11,36,20,104,1695,1866
E01004903,5,9,16,38,1402,1470
E01004904,6,10,28,18,1561,1623
E01004905,3,12,22,29,1535,1601
E01004907,5,7,21,18,1250,1301
E01004908,7,6,5,52,1277,1347
E01004909,4,8,15,13,1371,1411
E01004910,7,14,27,40,2008,2096
E01004933,0,2,10,24,1293,1329
E01004934,1,6,28,38,1445,1518
E01004935,2,5,29,51,1683,1770
E01004937,2,4,22,30,1466,1524
E01004940,6,11,24,26,1396,1463
E01005014,3,6,18,19,1416,1462
E01005015,0,1,11,17,1494,1523
E01005016,3,2,20,15,1477,1517
E01005017,1,12,35,20,1665,1733
E01005018,1,12,12,9,1469,1503
E01005021,1,5,60,170,993,1229
E01005019,1,2,19,19,1461,1502
E01005023,0,1,14,3,1291,1309
E01005046,1,0,13,7,1414,1435
E01005048,1,8,7,14,1657,1687
E01005020,1,2,13,13,1436,1465
E01005022,0,4,31,28,1534,1597
E01005047,2,4,10,6,1453,1475
E01005049,1,4,28,12,1650,1695
E01005051,3,2,25,18,1526,1574
E01004976,2,32,21,163,1329,1547
E01004977,9,8,38,67,1599,1721
E01004978,11,15,33,291,1338,1688
E01004981,3,5,11,9,1427,1455
E01004982,2,7,19,29,1392,1449
E01004961,7,11,50,34,1443,1545
E01004965,8,8,14,52,1145,1227
E01004966,8,34,51,51,1633,1777
E01004967,0,8,13,157,1106,1284
E01004963,1,4,16,23,1428,1472
E01004968,5,3,15,28,1525,1576
E01005050,1,6,21,29,1984,2041
E01005052,0,1,3,13,1447,1464
E01005053,1,4,14,32,1479,1530
E01004954,15,17,7,86,1339,1464
E01004955,3,14,18,111,1202,1348
E01004956,32,10,25,62,1405,1534
E01004957,22,42,53,144,1487,1748
E01004960,18,74,37,72,1313,1514
E01004958,6,13,20,155,1206,1400
E01004959,27,31,66,191,1343,1658
E01004979,19,43,37,471,974,1544
E01004980,15,19,23,264,965,1286
E01005024,18,9,38,802,580,1447
E01005026,2,33,31,982,581,1629
E01004947,6,13,19,81,1301,1420
E01004948,12,26,47,114,1665,1864
E01004962,2,4,29,46,1589,1670
E01004964,8,8,25,93,1699,1833
E01004949,0,3,10,30,1427,1470
E01004950,1,2,14,41,1452,1510
E01004951,4,8,12,94,1461,1579
E01004952,5,0,10,41,1323,1379
E01004953,5,0,18,48,1421,1492
E01005025,11,13,8,130,1327,1489
E01005027,19,20,61,533,1138,1771
E01005028,36,28,58,463,1278,1863
E01005029,25,21,26,692,1087,1851
E01005000,2,10,10,28,1505,1555
E01005001,8,11,10,46,1264,1339
E01005005,0,2,10,8,1384,1404
E01005006,3,7,17,30,1462,1519
E01005030,9,15,23,248,1295,1590
E01005054,17,1,24,32,1424,1498
E01005059,8,17,52,334,1296,1707
E01005060,3,12,45,177,1432,1669
E01004997,7,2,18,55,1474,1556
E01004998,2,2,6,20,1434,1464
E01004999,1,2,26,36,1415,1480
E01005002,1,7,21,48,1513,1590
E01005003,4,9,18,25,1406,1462
E01004991,7,11,23,49,1324,1414
E01004992,5,17,41,85,1333,1481
E01004993,4,2,24,80,1301,1411
E01004994,17,12,24,71,1183,1307
E01004990,1,13,32,23,1448,1517
E01004996,5,13,32,44,1350,1444
E01005004,4,17,24,30,1383,1458
E01005008,28,18,49,110,1661,1866
E01005009,3,17,34,98,1329,1481
E01004945,1,7,12,34,1504,1558
E01005055,4,5,25,120,1339,1493
E01005056,9,1,10,71,1165,1256
E01005057,4,6,26,32,1492,1560
E01005058,0,10,22,102,1199,1333
E01004995,7,9,10,35,1482,1543
E01005010,8,12,20,26,1555,1621
E01005012,22,20,41,58,1570,1711
E01005013,16,36,62,134,2130,2378
E01004984,27,2,11,76,1251,1367
E01004985,30,10,12,125,1262,1439
E01004989,18,13,20,100,1306,1457
E01005007,8,12,18,37,1395,1470
E01005011,8,5,14,28,1330,1385
E01004983,13,30,51,194,1003,1291
E01004986,16,25,38,80,1479,1638
E01004987,8,11,13,38,1131,1201
E01004988,23,10,14,44,1347,1438
E01004941,7,74,56,73,1573,1783
E01004942,19,76,59,45,1322,1521
E01004943,23,75,73,122,1338,1631
E01004944,8,56,36,106,1409,1615
E01004946,17,30,60,18,1499,1624
E01004969,29,19,27,39,1358,1472
E01004970,32,25,29,165,1321,1572
E01004971,8,8,25,142,1336,1519
E01005034,3,15,23,56,1360,1457
E01004972,18,31,34,115,1287,1485
E01004973,9,20,38,94,1364,1525
E01004975,12,27,52,72,1358,1521
E01005039,13,26,25,67,1355,1486
E01005045,11,30,41,103,1414,1599
E01004974,21,12,40,89,1265,1427
E01005033,24,6,31,144,1323,1528
E01005036,32,28,39,142,1575,1816
E01005037,11,21,18,75,1297,1422
E01005031,10,30,26,98,1299,1463
E01005032,10,48,36,61,1101,1256
E01005035,3,5,46,28,1320,1402
E01005038,5,29,46,139,1128,1347
E01005040,58,35,59,456,1204,1812
E01005041,39,30,39,353,1153,1614
E01005042,49,16,28,145,1664,1902
E01005043,86,11,31,213,1531,1872
E01005044,57,7,39,142,1548,1793
E01005098,11,50,41,46,1374,1522
E01005099,12,189,65,117,1436,1819
E01005100,5,57,39,57,1430,1588
E01005102,5,10,24,4,1315,1358
E01005103,2,83,50,52,1453,1640
E01005101,23,96,46,55,1484,1704
E01005135,38,137,56,88,1302,1621
E01005136,7,27,46,26,1400,1506
E01005138,13,171,63,66,1442,1755
E01005140,76,136,105,215,2272,2804
E01005139,3,89,48,105,1481,1726
E01005141,16,104,58,22,1538,1738
E01005251,13,103,55,39,1384,1594
E01005252,4,81,37,35,1677,1834
E01033685,16,172,45,179,1149,1561
E01033687,37,62,65,98,1155,1417
E01005104,48,227,81,125,1308,1789
E01005160,65,41,43,617,1003,1769
E01005161,24,47,56,340,1087,1554
E01005162,51,43,56,480,1080,1710
E01005163,75,65,55,523,933,1651
E01005247,3,27,25,34,1365,1454
E01005248,11,69,32,142,1115,1369
E01005249,7,83,67,121,1568,1846
E01005250,6,218,72,47,1438,1781
E01005253,9,90,49,23,1414,1585
E01005254,1,14,20,21,1542,1598
E01005164,96,134,78,498,765,1571
E01005205,19,219,82,165,1502,1987
E01005206,18,108,66,190,1311,1693
E01005207,56,335,80,156,1288,1915
E01005223,13,108,30,75,1008,1234
E01005224,14,438,102,192,1073,1819
E01005225,22,203,59,59,1504,1847
E01005226,12,259,64,96,1168,1599
E01005229,9,18,38,14,1460,1539
E01005145,275,177,80,1809,370,2711
E01005146,132,154,85,1190,800,2361
E01005149,86,51,49,1368,189,1743
E01005165,107,141,134,714,1013,2109
E01005166,105,132,71,952,602,1862
E01005167,209,164,96,1059,457,1985
E01005202,5,218,66,110,1379,1778
E01005203,49,282,115,204,1255,1905
E01005227,22,242,59,122,1240,1685
E01005228,24,258,101,70,1238,1691
E01033678,29,253,79,175,1038,1574
E01033679,22,227,85,97,978,1409
E01005256,17,230,112,104,1532,1995
E01005257,12,170,95,81,1440,1798
E01005258,22,42,32,51,1560,1707
E01005259,17,81,52,72,1380,1602
E01005260,28,29,35,76,1331,1499
E01005093,22,218,76,116,1292,1724
E01005094,20,182,58,79,1124,1463
E01005097,13,299,101,72,1246,1731
E01005255,24,161,62,45,1317,1609
E01005261,2,112,101,48,1379,1642
E01005129,20,207,65,168,1001,1461
E01005132,6,192,65,109,1108,1480
E01005133,24,84,46,110,1011,1275
E01033663,47,50,46,112,928,1183
E01033684,31,29,46,106,991,1203
E01033688,23,208,82,196,996,1505
E01005092,25,286,46,98,1174,1629
E01005105,36,302,82,486,1054,1960
E01005106,23,323,117,216,1198,1877
E01005107,28,389,133,90,1163,1803
E01033668,32,135,54,139,776,1136
E01033669,7,194,88,86,1022,1397
E01005108,22,590,136,167,1715,2630
E01005189,17,203,72,73,1326,1691
E01005190,16,326,91,101,1483,2017
E01033666,32,397,85,118,2032,2664
E01005061,65,538,151,254,640,1648
E01005062,205,345,167,1115,1061,2893
E01005063,84,388,111,367,536,1486
E01005065,212,520,159,522,818,2231
E01005066,96,254,68,584,698,1700
E01005208,184,425,194,399,1136,2338
E01005209,151,546,156,641,1205,2699
E01005210,134,302,176,1184,1448,3244
E01005214,124,401,176,349,1229,2279
E01005067,28,225,77,105,927,1362
E01005186,29,423,92,400,1432,2376
E01005232,69,186,108,913,591,1867
E01005235,85,231,105,590,749,1760
E01005239,109,532,141,481,499,1762
E01005187,35,358,80,142,1311,1926
E01005188,4,164,73,80,1393,1714
E01005191,19,210,78,68,1282,1657
E01005192,16,136,63,112,1257,1584
E01005193,21,160,74,124,1419,1798
E01005230,127,217,105,671,949,2069
E01005231,115,232,99,596,1584,2626
E01005236,104,170,101,974,712,2061
E01005237,44,146,59,1509,236,1994
E01033652,60,166,82,493,817,1618
E01033657,32,221,60,494,750,1557
E01005195,21,315,107,227,1316,1986
E01005196,34,552,169,227,1394,2376
E01005197,15,183,82,124,1162,1566
E01005198,43,240,104,270,913,1570
E01005201,60,502,129,364,961,2016
E01005240,176,1058,232,405,784,2655
E01005243,163,1233,220,266,581,2463
E01005245,152,1352,223,252,431,2410
E01005246,167,1212,164,263,333,2139
E01005241,158,303,166,478,1323,2428
E01005242,204,722,181,700,796,2603
E01005244,230,641,177,709,1181,2938
E01005285,132,280,53,466,368,1299
E01005288,116,204,96,568,744,1728
E01005280,73,172,47,1067,560,1919
E01005281,51,54,88,248,1798,2239
E01005284,181,159,124,1188,1784,3436
E01005286,116,77,87,556,1334,2170
E01005287,50,187,72,1200,622,2131
E01005194,91,236,83,1404,775,2589
E01005199,37,219,86,947,984,2273
E01005200,30,128,129,416,1128,1831
E01005233,71,238,106,1419,569,2403
E01005234,54,191,93,1401,307,2046
E01005238,56,230,65,1475,283,2109
E01005297,136,270,167,801,1075,2449
E01005298,68,167,95,757,748,1835
E01005302,80,229,88,265,1184,1846
E01033680,84,149,68,125,785,1211
E01033686,95,167,94,191,718,1265
E01005150,35,36,93,127,1579,1870
E01005151,6,32,47,151,1249,1485
E01005152,13,25,55,89,1271,1453
E01005159,22,40,42,176,1305,1585
E01005296,90,102,56,429,1027,1704
E01005299,72,120,43,748,608,1591
E01005178,148,214,123,351,1132,1968
E01005179,140,163,129,698,1105,2235
E01005180,105,141,174,351,1076,1847
E01005181,146,96,99,926,873,2140
E01005182,110,275,143,431,651,1610
E01005183,115,248,147,326,943,1779
E01005219,79,121,108,624,1141,2073
E01005220,51,137,94,549,1018,1849
E01005221,88,187,110,917,946,2248
E01005222,56,195,197,431,1223,2102
E01005184,167,74,91,363,1426,2121
E01005185,70,84,165,329,3376,4024
E01005271,98,44,67,170,1722,2101
E01005282,91,76,80,848,757,1852
E01005283,20,41,69,110,1241,1481
E01005154,41,50,80,84,1326,1581
E01005156,3,26,72,76,1319,1496
E01005158,32,64,90,167,1158,1511
E01005300,94,44,56,809,558,1561
E01005301,51,51,58,450,991,1601
E01005118,53,35,28,595,796,1507
E01005120,43,72,86,562,1086,1849
E01005215,141,150,88,654,971,2004
E01005216,44,83,54,347,998,1526
E01005217,58,71,85,647,1044,1905
E01005218,24,48,63,559,989,1683
E01005270,98,125,132,214,1178,1747
E01005272,70,186,155,197,1194,1802
E01005273,43,44,102,132,1237,1558
E01005278,67,74,69,524,1105,1839
E01005279,140,151,148,422,1175,2036
E01005305,88,35,58,477,1137,1795
E01005309,71,73,107,210,1836,2297
E01005310,31,49,110,129,1541,1860
E01005311,69,50,76,350,1224,1769
E01005312,38,45,88,142,1498,1811
E01005082,29,75,150,162,1132,1548
E01005153,15,28,60,62,1498,1663
E01005155,7,12,43,30,1319,1411
E01005157,8,23,50,60,1450,1591
E01005274,90,81,106,151,1338,1766
E01005275,41,32,50,125,1447,1695
E01005276,38,52,54,116,1342,1602
E01005277,37,30,62,174,1426,1729
E01005076,22,18,54,84,1305,1483
E01005081,70,242,202,129,1127,1770
E01005083,48,28,73,147,1414,1710
E01033670,68,19,41,131,993,1252
E01033671,42,29,65,103,1470,1709
E01005125,35,67,104,246,1144,1596
E01005304,40,40,77,159,1494,1810
E01005306,34,13,56,144,1299,1546
E01005307,57,40,82,204,1588,1971
E01005308,83,60,118,220,1216,1697
E01005119,55,58,73,240,1105,1531
E01005121,65,54,81,343,1051,1594
E01005122,33,102,70,297,1179,1681
E01005123,85,86,120,283,1127,1701
E01005124,47,94,125,249,1219,1734
E01005077,87,160,135,148,1028,1558
E01005078,38,24,46,159,1186,1453
E01005079,41,53,56,178,1237,1565
E01005084,54,83,115,172,1594,2018
E01005172,59,21,53,116,1351,1600
E01005173,27,14,55,127,1324,1547
E01005174,12,23,49,122,1364,1570
E01005175,29,35,44,121,1376,1605
E01005176,41,28,63,87,1587,1806
E01005177,30,19,34,67,1189,1339
E01005115,37,62,79,157,1539,1874
E01005262,41,103,69,136,1492,1841
E01005264,11,61,51,87,1325,1535
E01005265,64,69,61,71,1419,1684
E01005266,14,69,87,114,1673,1957
E01005126,44,54,92,478,1366,2034
E01005168,9,28,53,187,1111,1388
E01005169,17,37,39,153,1121,1367
E01005170,83,39,78,314,1017,1531
E01005171,95,54,61,378,1109,1697
E01005263,35,31,66,68,1433,1633
E01005267,17,27,33,92,1382,1551
E01005268,25,44,55,109,1785,2018
E01005269,17,32,38,130,1267,1484
E01005069,22,20,32,75,1298,1447
E01005111,16,32,48,28,1281,1405
E01005113,11,55,54,48,1405,1573
E01005114,23,27,38,149,1531,1768
E01005116,15,53,53,111,1732,1964
E01005071,12,62,43,71,1404,1592
E01005072,12,47,94,103,1447,1703
E01005073,19,39,55,103,1276,1492
E01005112,16,97,75,96,1376,1660
E01005117,43,94,127,112,1683,2059
E01005085,22,107,63,84,1291,1567
E01005086,30,91,68,137,1485,1811
E01005089,38,85,86,181,1530,1920
E01005289,10,29,82,63,1266,1450
E01005295,64,52,82,302,1959,2459
E01005087,22,147,93,50,1771,2083
E01005088,13,118,79,65,1433,1708
E01005090,32,85,78,45,1357,1597
E01005091,17,127,78,209,1728,2159
E01005291,12,36,37,47,1322,1454
E01005068,12,53,59,55,1399,1578
E01005070,40,98,49,111,1384,1682
E01005074,7,65,77,81,1292,1522
E01005075,15,48,64,57,1206,1390
E01005319,45,81,67,87,1851,2131
E01005290,14,17,74,62,1377,1544
E01005292,13,57,51,59,1299,1479
E01005293,15,9,23,50,1132,1229
E01005294,15,13,50,93,1325,1496
E01005317,7,53,64,73,1450,1647
E01005313,14,45,60,55,1322,1496
E01005314,7,30,70,80,1388,1575
E01005315,10,71,44,68,1310,1503
E01005316,12,78,93,59,1364,1606
E01005318,13,51,58,100,1652,1874
E01005130,49,171,79,140,1042,1481
E01033651,56,29,38,169,860,1152
E01033658,51,29,61,161,1001,1303
E01033664,22,31,34,104,928,1119
E01033667,30,22,28,73,853,1006
E01005128,108,38,36,654,874,1710
E01033653,40,24,55,438,1113,1670
E01033654,88,102,86,624,2056,2956
E01033659,35,16,27,108,1150,1336
E01033661,32,25,33,104,961,1155
E01005143,118,260,70,1857,297,2602
E01033655,31,28,32,215,891,1197
E01033665,27,49,44,128,964,1212
E01033676,92,188,63,418,907,1668
E01005212,79,239,146,270,1376,2110
E01033656,164,118,161,976,2071,3490
E01033662,132,24,49,211,919,1335
E01005142,132,297,153,762,568,1912
E01005147,183,504,210,813,828,2538
E01033674,98,175,130,356,1447,2206
E01033675,68,463,147,447,939,2064
E01005213,118,483,176,207,1205,2189
E01033660,12,21,26,61,1048,1168
E01033672,64,233,118,137,739,1291
E01033673,18,21,29,74,959,1101
E01033677,127,30,44,261,708,1170
E01033681,65,8,29,140,1131,1373
E01033682,20,9,37,98,1097,1261
E01033683,76,28,41,233,881,1259
E01005357,0,2,14,2,1406,1424
E01005358,2,2,23,16,1600,1643
E01005359,1,2,10,10,1571,1594
E01005360,1,2,25,14,1360,1402
E01005441,4,3,15,11,1559,1592
E01005442,3,1,10,4,1390,1408
E01005444,2,8,10,65,1419,1504
E01005445,1,13,27,71,1425,1537
E01005361,4,5,16,68,1603,1696
E01005443,0,3,22,32,1339,1396
E01005446,0,11,10,31,1341,1393
E01005447,1,10,33,224,1362,1630
E01005390,1,8,14,8,1484,1515
E01005394,1,3,10,18,1508,1540
E01005395,0,3,6,19,1411,1439
E01005396,4,6,20,34,1418,1482
E01005355,3,12,24,86,1386,1511
E01005356,1,6,15,54,1259,1335
E01005399,0,8,8,45,1528,1589
E01005403,3,8,35,48,1585,1679
E01005410,0,2,8,11,1529,1550
E01005411,2,6,12,19,1509,1548
E01005414,4,3,12,6,1270,1295
E01005415,1,5,22,19,1101,1148
E01005452,0,6,9,2,1355,1372
E01005453,1,3,15,12,1289,1320
E01032558,6,52,46,17,1326,1447
E01032559,2,23,56,41,2678,2800
E01005391,4,8,12,21,1548,1593
E01005392,2,7,16,6,1450,1481
E01005393,0,6,20,14,1231,1271
E01005401,3,12,26,67,1544,1652
E01005397,1,5,20,16,1417,1459
E01005398,2,10,14,58,1464,1548
E01005400,3,7,23,24,1446,1503
E01005402,9,9,27,222,1266,1533
E01005335,0,6,14,60,1209,1289
E01005337,4,21,52,1022,864,1963
E01005339,1,8,15,40,1399,1463
E01005340,2,9,38,221,1165,1435
E01005421,3,30,57,9,1610,1709
E01005422,1,44,66,10,1382,1503
E01032920,0,30,42,66,1732,1870
E01005448,5,24,54,111,1278,1472
E01005449,2,22,21,56,1117,1218
E01005454,1,8,15,5,1420,1449
E01005455,0,5,38,50,1493,1586
E01005456,3,24,43,29,1490,1589
E01005407,2,6,18,11,1669,1706
E01005412,3,4,18,17,1648,1690
E01005416,1,5,19,42,1318,1385
E01005417,0,2,15,16,1430,1463
E01005348,19,80,69,645,841,1654
E01005350,36,167,81,766,961,2011
E01005432,3,83,87,102,1224,1499
E01005433,10,86,56,135,1228,1515
E01005329,1,15,11,81,1418,1526
E01005330,0,8,23,45,1486,1562
E01005333,0,6,7,81,1180,1274
E01005336,0,3,16,75,1482,1576
E01005349,10,16,23,2308,67,2424
E01005351,1,38,13,1681,253,1986
E01005352,2,29,16,1035,367,1449
E01005353,13,111,37,1314,438,1913
E01005354,6,32,32,1052,642,1764
E01005327,0,11,33,176,1712,1932
E01005328,0,23,29,236,1081,1369
E01005331,8,31,23,136,1346,1544
E01005334,1,6,27,64,1416,1514
E01005338,0,15,45,614,1117,1791
E01005387,1,11,10,2,1407,1431
E01005388,1,6,18,10,1319,1354
E01005389,1,43,57,27,1533,1661
E01005418,1,8,16,16,1469,1510
E01005428,4,38,43,1245,406,1736
E01005431,2,28,50,244,1396,1720
E01005450,12,38,48,732,840,1670
E01005451,8,19,33,466,810,1336
E01005408,2,4,20,22,1723,1771
E01005409,3,0,9,29,1617,1658
E01032922,1,4,22,28,2422,2477
E01005406,1,6,12,16,1379,1414
E01005413,5,2,31,21,1606,1665
E01005419,0,7,14,19,1462,1502
E01005420,1,5,18,18,1636,1678
E01005321,7,67,35,824,676,1609
E01005326,16,31,22,2655,284,3008
E01005427,2,37,20,1903,59,2021
E01005429,7,19,36,1616,140,1818
E01005430,21,28,36,1840,469,2394
E01005320,10,35,74,893,901,1913
E01005434,17,40,46,508,729,1340
E01005437,8,26,21,1416,437,1908
E01005459,4,16,11,1121,206,1358
E01005383,9,52,65,639,1203,1968
E01005386,6,45,63,36,1238,1388
E01032556,2,1,23,23,1390,1439
E01032557,3,71,53,51,1476,1654
E01005342,5,14,31,148,1138,1336
E01005343,6,15,51,54,1267,1393
E01005344,2,20,48,137,1292,1499
E01005381,1,22,39,438,1011,1511
E01005332,6,64,64,255,1906,2295
E01005341,2,16,30,33,1378,1459
E01005345,2,9,36,66,1393,1506
E01005346,1,10,7,15,1400,1433
E01005347,2,10,14,52,1267,1345
E01005322,14,24,53,200,976,1267
E01005323,0,24,32,20,1321,1397
E01005324,2,13,39,24,1391,1469
E01005325,2,12,21,17,949,1001
E01005438,7,41,33,626,1624,2331
E01005377,3,18,30,35,1241,1327
E01005379,1,14,32,14,1211,1272
E01005380,0,12,16,31,1450,1509
E01005382,0,10,40,72,1331,1453
E01005439,3,12,19,116,1369,1519
E01005362,1,1,22,32,1406,1462
E01005364,0,2,17,7,1648,1674
E01005368,3,12,22,28,1477,1542
E01005376,1,44,25,71,1147,1288
E01005378,3,23,32,120,1316,1494
E01005363,1,12,33,54,1439,1539
E01005369,4,45,53,56,1336,1494
E01005370,2,32,38,25,1340,1437
E01005371,2,13,28,28,1260,1331
E01005365,4,5,16,32,1399,1456
E01005366,5,17,29,12,1451,1514
E01005367,1,2,14,31,1426,1474
E01005440,1,16,20,14,1283,1334
E01005372,4,7,30,26,1124,1191
E01005373,1,9,8,5,1178,1201
E01005374,7,6,22,19,1389,1443
E01005375,0,1,11,10,1447,1469
E01005435,16,11,32,1636,218,1913
E01005436,7,5,23,953,711,1699
E01005460,23,40,80,1420,793,2356
E01005461,10,4,22,2148,201,2385
E01005462,9,24,29,1215,579,1856
E01005463,6,47,15,787,267,1122
E01032921,17,84,57,1937,483,2578
E01005518,0,1,19,12,1393,1425
E01005520,6,7,18,12,1715,1758
E01005522,2,3,14,10,1315,1344
E01005523,2,11,18,19,1886,1936
E01005519,1,1,12,12,1532,1558
E01005594,1,2,8,62,1382,1455
E01005597,1,6,10,20,1563,1600
E01005598,0,10,13,31,1508,1562
E01005516,0,3,11,22,1377,1413
E01005517,2,2,10,12,1480,1506
E01005521,3,1,16,9,1398,1427
E01005596,0,5,14,207,1699,1925
E01005578,7,16,42,686,693,1444
E01005579,5,29,37,754,849,1674
E01005586,2,13,20,280,1208,1523
E01005593,0,43,57,104,1342,1546
E01005595,3,10,38,90,1279,1420
E01005489,2,5,11,93,1078,1189
E01005490,2,36,52,134,1289,1513
E01005491,0,1,29,128,1311,1469
E01005493,1,4,25,214,1364,1608
E01005494,7,14,33,328,1368,1750
E01005495,4,5,25,396,1230,1660
E01005488,3,0,39,153,1398,1593
E01005492,4,11,25,209,1308,1557
E01005499,6,4,17,24,1432,1483
E01005571,7,1,14,51,1492,1565
E01005570,8,4,6,33,1224,1275
E01005572,0,1,15,190,1441,1647
E01005573,7,4,21,117,1353,1502
E01005574,9,3,15,295,1355,1677
E01005587,2,4,28,137,1296,1467
E01005588,7,5,16,61,1288,1377
E01005580,2,15,35,608,920,1580
E01005581,6,6,19,912,645,1588
E01005583,9,7,18,1468,187,1689
E01005585,6,7,30,814,562,1419
E01033258,21,16,31,2468,445,2981
E01005496,2,25,21,105,1201,1354
E01005589,4,6,38,140,1334,1522
E01005590,23,40,41,796,752,1652
E01005591,0,6,20,97,1303,1426
E01005592,4,26,44,293,1243,1610
E01005472,8,17,23,276,1223,1547
E01005473,12,24,50,887,540,1513
E01005482,51,150,52,429,1374,2056
E01005483,62,83,52,746,939,1882
E01005484,68,225,95,1009,722,2119
E01005486,19,15,66,827,679,1606
E01005487,17,19,38,1011,632,1717
E01005474,0,18,26,192,1054,1290
E01005575,5,10,16,267,1338,1636
E01005576,14,11,20,424,1048,1517
E01005577,2,3,6,90,1381,1482
E01005469,4,26,34,204,1536,1804
E01005563,23,25,44,796,923,1811
E01005565,12,18,29,266,1239,1564
E01005566,9,21,39,592,1487,2148
E01005568,13,102,49,760,750,1674
E01005569,2,63,55,515,1000,1635
E01005556,0,1,20,27,1491,1539
E01005559,1,2,14,21,1548,1586
E01005560,3,1,15,13,1519,1551
E01005567,6,1,23,87,1342,1459
E01005555,4,8,27,10,1317,1366
E01005557,0,0,13,26,1173,1212
E01005558,3,10,27,12,1592,1644
E01005561,1,3,20,8,1330,1362
E01005562,1,4,24,8,1488,1525
E01005470,12,26,36,1398,300,1772
E01005471,10,17,44,913,622,1606
E01005475,11,11,30,993,620,1665
E01005485,13,25,29,1781,303,2151
E01005564,10,39,55,1327,507,1938
E01005464,9,34,48,190,1471,1752
E01005465,5,14,25,74,1598,1716
E01005466,3,124,48,132,2006,2313
E01005467,2,56,39,91,1534,1722
E01005468,4,25,19,96,1400,1544
E01005476,2,3,16,76,1540,1637
E01005477,27,17,36,115,1481,1676
E01005478,8,10,12,116,1445,1591
E01005479,6,12,28,90,1625,1761
E01005480,1,15,34,182,1392,1624
E01005481,7,23,15,462,1220,1727
E01005497,8,41,28,50,1450,1577
E01005501,2,14,21,39,1491,1567
E01005502,7,2,11,28,1486,1534
E01005504,0,20,21,38,1429,1508
E01005505,1,12,21,10,1663,1707
E01005509,17,49,22,26,1676,1790
E01005510,1,0,7,19,1121,1148
E01005511,1,8,10,21,1206,1246
E01005512,2,22,18,16,1487,1545
E01005513,4,10,17,16,1289,1336
E01005514,2,26,27,14,1441,1510
E01005515,5,10,36,16,1638,1705
E01005498,0,18,24,62,1360,1464
E01005500,4,4,21,23,1556,1608
E01005503,0,0,8,41,1261,1310
E01005506,8,7,12,31,1534,1592
E01005507,1,3,25,27,1518,1574
E01005508,8,19,22,86,1731,1866
E01005524,2,18,30,30,1409,1489
E01005525,10,69,38,29,1456,1602
E01005526,1,42,28,89,1424,1584
E01005528,6,26,16,13,1438,1499
E01005536,10,38,41,12,1502,1603
E01005543,1,10,28,13,1269,1321
E01005527,5,45,30,22,1396,1498
E01005529,0,47,32,15,1516,1610
E01005551,16,34,37,66,1573,1726
E01005552,8,67,48,54,1813,1990
E01005553,9,37,50,37,1698,1831
E01005554,4,10,22,37,1270,1343
E01005534,3,14,24,25,1427,1493
E01005535,2,12,20,26,1520,1580
E01005537,0,6,13,3,1341,1363
E01005538,4,11,28,26,1440,1509
E01005540,0,12,31,12,1279,1334
E01005541,2,14,34,28,1543,1621
E01005542,0,20,14,29,1263,1326
E01005533,4,15,22,21,1578,1640
E01005539,2,35,16,21,1280,1354
E01005546,6,23,22,14,1172,1237
E01005547,11,26,30,26,1357,1450
E01005548,4,32,18,15,1215,1284
E01005530,5,4,22,36,1370,1437
E01005531,1,6,22,35,1101,1165
E01005532,1,46,33,43,1312,1435
E01005544,1,10,11,17,1431,1470
E01005545,6,31,9,47,1134,1227
E01005549,3,9,25,51,1474,1562
E01005550,7,6,8,30,1369,1420
E01005659,1,21,22,13,1387,1444
E01005660,1,25,14,19,1411,1470
E01005663,2,31,18,20,1305,1376
E01005664,0,77,41,17,1352,1487
E01005665,1,33,17,12,1407,1470
E01005703,0,28,33,22,1461,1544
E01005704,3,4,18,18,1362,1405
E01005706,10,28,20,15,1421,1494
E01005708,5,34,36,41,1375,1491
E01005702,4,27,32,58,2006,2127
E01005705,13,11,28,32,1784,1868
E01005707,6,36,40,25,1611,1718
E01005661,4,41,36,66,1642,1789
E01005662,18,72,32,13,1384,1519
E01005709,5,47,26,28,1285,1391
E01005710,0,17,20,21,1451,1509
E01005670,3,61,47,63,1489,1663
E01005672,1,27,12,80,1249,1369
E01005676,1,6,9,9,1251,1276
E01005677,4,19,22,40,1455,1540
E01005686,12,43,16,49,1319,1439
E01005688,9,53,26,53,1450,1591
E01005691,4,7,11,16,1434,1472
E01005692,6,24,18,24,1234,1306
E01005711,8,1,17,51,1428,1505
E01005712,8,20,20,30,1542,1620
E01005713,5,9,14,16,1371,1415
E01005714,1,14,11,21,1391,1438
E01005715,6,9,23,34,1580,1652
E01005718,3,7,26,26,1618,1680
E01005673,1,29,24,33,1350,1437
E01005675,16,82,81,131,2254,2564
E01005678,6,45,46,42,1380,1519
E01005679,4,60,33,28,1469,1594
E01005687,1,7,26,44,1674,1752
E01005689,2,72,35,84,1245,1438
E01005690,1,9,9,21,1515,1555
E01005693,1,6,17,13,1365,1402
E01005646,51,9,18,68,1431,1577
E01005649,57,22,18,59,1561,1717
E01005650,22,52,46,50,1412,1582
E01005651,100,80,64,59,1818,2121
E01005647,107,23,10,49,1432,1621
E01005648,53,54,42,123,1545,1817
E01005652,8,54,38,30,1268,1398
E01005653,7,115,46,75,1275,1518
E01005671,7,20,28,37,1411,1503
E01005674,2,3,16,26,1399,1446
E01005694,9,7,13,46,1666,1741
E01005696,11,35,32,14,1429,1521
E01005698,11,72,34,25,1515,1657
E01005700,11,15,18,74,1420,1538
E01005716,16,16,37,69,1632,1770
E01005717,12,4,26,152,1374,1568
E01005734,1,10,21,30,1295,1357
E01005735,5,6,34,21,1327,1393
E01005736,1,5,19,12,1383,1420
E01005737,5,5,25,77,1395,1507
E01005739,4,4,24,88,1411,1531
E01005695,2,2,23,66,1485,1578
E01005697,0,6,12,22,1523,1563
E01005738,8,0,24,54,1680,1766
E01005740,9,1,31,35,1480,1556
E01005741,3,9,28,56,1546,1642
E01005742,3,5,20,21,1538,1587
E01005625,0,8,14,42,1265,1329
E01005627,0,10,21,47,1100,1178
E01005699,3,8,16,11,1456,1494
E01005701,9,11,26,32,1515,1593
E01005609,26,172,55,103,1431,1787
E01005611,27,112,72,123,1608,1942
E01005612,21,226,31,109,1651,2038
E01005613,84,303,123,250,1520,2280
E01005614,47,101,31,119,1642,1940
E01005615,37,147,59,185,1530,1958
E01005624,8,82,27,49,1503,1669
E01005680,14,48,32,46,1285,1425
E01005683,20,90,44,29,1417,1600
E01032919,85,278,125,265,2915,3668
E01005622,4,25,35,33,1355,1452
E01005623,4,11,12,38,1196,1261
E01005626,2,9,14,52,1234,1311
E01005628,8,43,40,172,1353,1616
E01005725,18,41,36,39,1244,1378
E01005726,6,10,29,15,1440,1500
E01005727,13,19,31,33,1241,1337
E01005728,1,3,11,17,1321,1353
E01005733,4,4,12,31,1319,1370
E01005631,41,32,29,46,1361,1509
E01005632,231,43,54,273,1511,2112
E01005633,15,13,26,63,1276,1393
E01005634,3,4,23,31,1411,1472
E01005635,11,22,32,124,1388,1577
E01005636,18,15,20,79,1421,1553
E01005637,11,4,26,58,1215,1314
E01005629,13,6,16,40,1236,1311
E01005630,6,20,17,88,1364,1495
E01005719,25,82,38,168,1428,1741
E01005720,23,136,64,121,2040,2384
E01005722,21,69,46,128,1514,1778
E01005723,3,61,34,56,1315,1469
E01005724,16,6,13,75,1369,1479
E01005610,26,36,25,37,1137,1261
E01032684,35,172,52,291,1259,1809
E01032687,31,48,44,125,1037,1285
E01032906,43,88,46,65,1001,1243
E01032907,37,46,26,121,955,1185
E01032909,54,12,35,172,1052,1325
E01032911,25,53,47,113,916,1154
E01033330,16,121,50,49,1160,1396
E01005654,5,52,50,54,1259,1420
E01005656,12,58,29,39,1359,1497
E01005657,6,37,16,29,1358,1446
E01005721,4,37,17,35,1343,1436
E01005655,45,225,55,119,924,1368
E01005658,13,107,37,24,1234,1415
E01005681,27,70,39,172,1272,1580
E01005682,30,164,67,61,1193,1515
E01005729,8,55,43,37,1165,1308
E01005730,2,18,26,32,1568,1646
E01005731,2,60,37,29,1466,1594
E01005732,4,13,11,19,1095,1142
E01005599,66,53,41,127,1323,1610
E01005600,19,43,24,76,1305,1467
E01005601,46,25,14,81,1408,1574
E01005602,43,23,23,37,1226,1352
E01005603,5,48,46,92,1389,1580
E01005604,5,22,24,22,1450,1523
E01005605,15,28,14,37,1289,1383
E01005638,20,30,35,101,1372,1558
E01005667,25,152,59,61,1531,1828
E01032685,59,73,44,231,1087,1494
E01032686,32,48,38,153,1125,1396
E01032912,10,74,36,84,1277,1481
E01032914,28,82,48,160,1284,1602
E01032915,21,103,54,109,1260,1547
E01032917,17,64,24,82,869,1056
E01005639,2,31,30,12,1491,1566
E01005640,10,18,41,21,1366,1456
E01005641,0,12,15,22,1374,1423
E01005642,3,2,20,40,1162,1227
E01005643,4,16,19,12,1353,1404
E01005644,5,3,16,40,1519,1583
E01005645,1,3,7,14,1420,1445
E01005616,0,13,17,11,1420,1461
E01005617,0,2,8,14,1512,1536
E01005618,0,3,20,24,1438,1485
E01005619,7,9,9,19,1254,1298
E01005620,30,22,46,119,2314,2531
E01005621,8,17,35,49,1543,1652
E01005886,1,25,47,47,1376,1496
E01005888,3,16,31,30,1442,1522
E01005889,2,14,28,21,1407,1472
E01005891,1,10,28,9,1245,1293
E01005894,1,14,30,26,1334,1405
E01005887,14,33,41,58,1352,1498
E01005890,14,48,52,76,1288,1478
E01005893,5,8,43,21,1620,1697
E01005896,9,26,56,29,1546,1666
E01005919,10,10,52,75,1455,1602
E01005862,9,18,49,56,1429,1561
E01005892,8,15,21,15,1252,1311
E01005895,0,3,23,13,1111,1150
E01005920,9,26,41,59,1427,1562
E01005921,4,7,32,37,1312,1392
E01005922,1,9,24,59,1313,1406
E01005753,3,19,52,35,1562,1671
E01005754,2,30,22,37,1700,1791
E01005755,8,25,36,20,1546,1635
E01005756,5,21,29,34,1500,1589
E01005745,4,6,19,8,1396,1433
E01005746,5,9,16,8,1380,1418
E01005747,2,1,8,11,1432,1454
E01005748,0,2,8,7,1519,1536
E01005863,4,19,31,56,1634,1744
E01005864,13,10,38,44,1376,1481
E01005866,12,30,40,164,1467,1713
E01005869,10,30,23,153,1292,1508
E01005914,7,11,28,37,1343,1426
E01005915,1,8,30,12,1438,1489
E01005916,10,9,42,70,1434,1565
E01005917,11,43,46,105,1414,1619
E01005859,1,11,30,47,1370,1459
E01005865,29,7,32,124,1279,1471
E01005867,9,2,26,62,1359,1458
E01005868,20,10,46,249,1173,1498
E01005743,1,1,13,11,1327,1353
E01005744,0,6,17,24,1391,1438
E01005749,1,10,24,24,1588,1647
E01005750,0,0,21,19,1657,1697
E01005751,0,2,8,16,1288,1314
E01005897,3,6,21,20,1445,1495
E01005898,2,3,31,14,1553,1603
E01005900,0,2,25,22,1500,1549
E01005903,0,4,7,13,1414,1438
E01005904,1,3,19,8,1431,1462
E01005853,14,25,51,188,1292,1570
E01005856,14,22,62,192,1329,1619
E01005860,11,12,36,62,1367,1488
E01005861,4,13,24,30,1477,1548
E01005752,1,13,47,14,1402,1477
E01005899,1,0,19,26,1570,1616
E01005901,1,2,3,14,1378,1398
E01005902,1,6,37,16,1558,1618
E01005905,2,5,47,10,1372,1436
E01005852,40,13,39,329,1131,1552
E01005854,6,13,56,40,1511,1626
E01005855,12,5,29,189,1269,1504
E01005857,61,21,58,607,802,1549
E01005858,19,8,33,70,1445,1575
E01005757,3,20,30,61,1493,1607
E01005758,7,22,43,56,1723,1851
E01005766,10,20,24,200,1198,1452
E01005918,8,37,45,43,1378,1511
E01005870,0,6,24,17,1352,1399
E01005871,3,0,23,7,1304,1337
E01005873,4,4,17,5,1459,1489
E01005875,2,4,14,13,1526,1559
E01005764,2,4,27,25,1584,1642
E01005816,3,12,47,69,1469,1600
E01005817,2,17,24,88,1214,1345
E01005822,1,20,33,72,1381,1507
E01005880,2,2,17,5,1462,1488
E01005881,1,2,18,21,1236,1278
E01005883,2,6,15,4,1509,1536
E01005908,1,1,6,3,1483,1494
E01005765,2,3,19,19,1350,1393
E01005818,0,12,26,75,1309,1422
E01005819,14,14,31,75,1413,1547
E01005820,2,7,18,42,1386,1455
E01005821,4,4,20,64,1397,1489
E01005823,8,15,25,48,1536,1632
E01005825,3,5,32,44,1432,1516
E01005872,9,12,27,27,1637,1712
E01005874,2,18,45,35,1572,1672
E01005876,2,0,17,42,1420,1481
E01005877,5,9,15,42,1331,1402
E01005878,3,1,17,26,1388,1435
E01005879,2,6,27,26,1247,1308
E01005882,3,8,17,21,1331,1380
E01005884,4,2,9,26,1453,1494
E01005885,1,4,13,20,1348,1386
E01005832,12,1,23,31,1405,1472
E01005833,5,2,8,54,977,1046
E01005835,13,2,7,23,1352,1397
E01005837,19,3,22,44,1500,1588
E01005843,6,4,5,28,1467,1510
E01005769,16,9,41,51,1218,1335
E01005778,7,12,37,33,1380,1469
E01005779,11,15,36,39,1318,1419
E01005780,10,16,24,109,1307,1466
E01005781,7,20,49,63,1394,1533
E01005759,2,23,50,64,1540,1679
E01005760,12,24,65,166,1590,1857
E01005797,1,13,23,26,1307,1370
E01005800,4,11,26,52,1534,1627
E01005804,4,5,23,26,1143,1201
E01005824,2,10,19,15,1428,1474
E01005826,5,13,22,26,1384,1450
E01005827,8,4,11,29,1354,1406
E01005828,3,14,19,15,1237,1288
E01005829,2,17,21,20,1223,1283
E01005768,31,14,34,261,1292,1632
E01005770,23,6,27,132,1241,1429
E01005771,32,19,33,115,1184,1383
E01005775,22,12,36,144,1352,1566
E01005761,5,19,37,110,1233,1404
E01005762,2,16,24,52,1494,1588
E01005763,4,20,55,122,1495,1696
E01005799,4,25,57,111,1607,1804
E01005798,9,19,45,55,1459,1587
E01005801,12,11,22,75,1377,1497
E01005802,14,8,27,12,1474,1535
E01005803,1,2,27,32,1426,1488
E01005830,5,8,29,60,1374,1476
E01005831,5,3,25,93,1420,1546
E01005767,39,13,38,302,1100,1492
E01005772,50,4,38,303,1071,1466
E01005773,22,4,32,178,1287,1523
E01005774,9,6,16,89,1280,1400
E01005776,65,15,37,382,1072,1571
E01005909,2,3,16,6,1525,1552
E01005910,1,6,16,23,1487,1533
E01005911,5,11,7,3,1327,1353
E01005912,0,2,11,8,1345,1366
E01005782,4,16,21,54,1123,1218
E01005783,21,0,26,80,1414,1541
E01005784,27,21,21,180,1178,1427
E01005785,11,5,22,56,1441,1535
E01005786,15,6,15,84,1469,1589
E01005834,17,13,16,50,1409,1505
E01005836,2,1,20,51,1763,1837
E01005838,6,18,30,52,1601,1707
E01005840,10,15,25,48,1434,1532
E01005927,11,9,36,87,1209,1352
E01005928,18,19,45,66,1424,1572
E01005929,15,14,19,88,1240,1376
E01005930,8,4,19,81,1448,1560
E01005806,0,2,18,23,1172,1215
E01005813,15,6,14,69,1337,1441
E01005814,7,2,15,33,1272,1329
E01005815,4,6,13,23,1424,1470
E01005777,5,17,36,98,1330,1486
E01005787,8,4,18,78,1191,1299
E01005788,18,10,25,88,1387,1528
E01005790,17,14,21,133,1038,1223
E01005805,1,7,17,15,1533,1573
E01005807,9,2,15,46,1504,1576
E01005839,8,0,6,30,1272,1316
E01005841,1,7,37,59,1434,1538
E01005844,14,11,29,409,1027,1490
E01005845,10,13,32,303,1263,1621
E01005849,5,2,23,170,1371,1571
E01005851,16,6,13,332,1157,1524
E01005808,9,11,23,78,1245,1366
E01005809,9,6,31,112,1105,1263
E01005810,16,4,33,102,1418,1573
E01005811,11,4,14,52,1321,1402
E01005812,16,10,14,115,1134,1289
E01005842,6,8,15,18,1573,1620
E01005906,1,3,14,13,1431,1462
E01005907,3,6,12,18,1254,1293
E01005913,0,2,8,12,1419,1441
E01005789,13,8,28,64,1447,1560
E01005791,6,2,18,38,1479,1543
E01005793,15,6,14,76,1312,1423
E01005795,7,1,8,36,1240,1292
E01005796,21,10,24,64,1141,1260
E01005846,38,12,33,312,1264,1659
E01005847,19,14,20,175,1325,1553
E01005848,30,22,29,288,1470,1839
E01005850,5,7,45,169,1533,1759
E01005792,15,5,17,39,1388,1464
E01005794,1,4,39,59,1138,1241
E01005923,2,3,17,49,1478,1549
E01005931,8,5,13,27,1392,1445
E01005924,2,1,26,32,1282,1343
E01005925,3,2,12,54,1347,1418
E01005926,4,0,7,29,1225,1265
E01005932,1,11,31,70,1272,1385
E01006053,0,6,18,5,1835,1864
E01006054,1,3,27,53,1539,1623
E01006055,0,6,18,4,1359,1387
E01006057,1,8,16,25,1483,1533
E01006058,4,6,26,40,1835,1911
E01006059,1,9,15,20,1368,1413
E01005938,7,16,18,160,1437,1638
E01005939,9,7,17,412,860,1305
E01005940,3,11,21,354,1105,1494
E01005955,7,11,50,271,1371,1710
E01006056,0,6,21,14,1149,1190
E01006061,3,12,41,66,2261,2383
E01006062,3,3,13,28,2067,2114
E01006063,1,1,20,21,1420,1463
E01005936,0,23,22,100,1342,1487
E01005937,1,6,31,88,1390,1516
E01005945,14,34,46,239,1641,1974
E01005946,0,19,26,251,1357,1653
E01005947,4,37,28,347,1165,1581
E01005954,0,7,16,105,1371,1499
E01005956,1,7,17,181,1216,1422
E01005957,12,5,16,262,1164,1459
E01005958,1,9,28,63,1355,1456
E01005959,0,18,32,287,1368,1705
E01005933,5,22,22,114,1304,1467
E01005934,18,7,17,50,1387,1479
E01005935,1,20,14,96,1344,1475
E01005949,9,5,27,258,1258,1557
E01005960,15,25,34,190,1373,1637
E01005941,9,19,33,517,1072,1650
E01005942,4,15,26,110,1494,1649
E01005943,0,3,24,125,1641,1793
E01005944,11,18,28,250,1160,1467
E01006060,1,9,19,60,1307,1396
E01006064,1,5,23,49,1500,1578
E01006065,2,39,14,44,1258,1357
E01006066,0,10,15,59,1319,1403
E01006067,5,7,18,69,1743,1842
E01006068,0,2,4,39,1549,1594
E01006069,1,3,32,27,1604,1667
E01006073,0,1,23,30,1698,1752
E01005993,1,15,18,41,1336,1411
E01005995,1,5,16,72,1327,1421
E01005996,3,15,45,73,1803,1939
E01005997,0,8,13,14,1424,1459
E01006000,2,21,28,46,1446,1543
E01005994,1,17,36,17,1378,1449
E01005999,9,66,44,83,1655,1857
E01006002,2,3,18,14,1331,1368
E01006004,1,14,22,22,1485,1544
E01006005,3,20,21,4,1303,1351
E01006007,1,5,15,16,1471,1508
E01005998,3,43,41,47,1569,1703
E01006001,7,25,33,28,1466,1559
E01006003,1,19,17,60,1353,1450
E01006006,1,14,13,25,1419,1472
E01005948,2,29,48,554,1136,1769
E01005950,11,36,33,1207,636,1923
E01005951,2,31,33,157,1362,1585
E01005952,8,83,51,351,1670,2163
E01005953,6,37,32,587,1381,2043
E01005961,10,16,19,63,1315,1423
E01005962,1,8,15,111,1322,1457
E01005968,1,5,13,30,1397,1446
E01005969,0,0,7,102,1272,1381
E01006022,0,4,19,104,1492,1619
E01006023,3,6,16,34,1486,1545
E01006070,0,3,13,20,1401,1437
E01006071,3,5,11,95,1472,1586
E01006072,0,3,13,81,1588,1685
E01006009,2,3,2,100,1257,1364
E01006017,0,3,32,21,1360,1416
E01006018,2,6,10,27,1321,1366
E01006021,4,1,12,14,1334,1365
E01006008,0,1,18,29,1407,1455
E01006010,0,6,21,25,1329,1381
E01006012,8,6,20,106,1699,1839
E01006015,4,8,15,80,1312,1419
E01006016,7,49,32,45,1621,1754
E01006011,6,6,18,40,1564,1634
E01006013,1,10,5,48,1217,1281
E01006014,2,4,17,33,1246,1302
E01006019,2,12,9,13,1473,1509
E01006020,8,6,19,17,1513,1563
E01005963,0,6,16,30,1170,1222
E01005964,3,11,31,24,1469,1538
E01005965,1,14,21,18,1376,1430
E01005966,0,13,32,36,1274,1355
E01005967,0,37,29,42,1273,1381
E01006031,0,10,25,180,1281,1496
E01006032,0,11,4,47,1268,1330
E01006033,0,1,20,41,1298,1360
E01006034,3,4,36,51,2049,2143
E01006035,4,25,45,66,1836,1976
E01006036,3,25,36,154,1735,1953
E01005970,0,7,14,53,1390,1464
E01005972,8,17,43,44,1568,1680
E01005974,1,15,18,38,1491,1563
E01005975,0,15,17,67,1463,1562
E01006024,2,4,16,35,1752,1809
E01006026,6,6,23,24,1510,1569
E01006037,1,2,14,16,1465,1498
E01006038,4,3,11,37,1583,1638
E01006047,0,4,12,15,1310,1341
E01006048,0,4,9,11,1474,1498
E01006049,1,11,9,10,1506,1537
E01006051,2,2,18,14,1609,1645
E01005985,0,8,32,17,1476,1533
E01005987,2,7,13,30,1495,1547
E01005988,4,6,20,45,1526,1601
E01005990,4,10,25,13,1292,1344
E01005991,5,13,34,35,1379,1466
E01005971,2,14,20,41,1329,1406
E01005986,0,9,16,19,1202,1246
E01005989,0,6,14,4,1196,1220
E01005992,0,11,40,38,1228,1317
E01005973,5,9,10,10,1392,1426
E01005976,5,6,20,27,1465,1523
E01005977,2,8,28,16,1443,1497
E01005978,0,4,16,8,1349,1377
E01006025,2,18,14,11,1373,1418
E01006027,4,3,20,9,1373,1409
E01006050,3,17,26,31,1630,1707
E01006052,2,29,22,10,1474,1537
E01006028,1,8,31,180,1542,1762
E01006029,7,23,39,564,1204,1837
E01006030,2,15,18,56,1745,1836
E01006039,5,16,16,672,697,1406
E01006040,1,23,25,819,831,1699
E01006041,8,1,25,372,1191,1597
E01005979,0,6,24,6,1576,1612
E01005980,1,10,22,36,1416,1485
E01005981,0,25,29,38,1437,1529
E01005982,3,22,30,15,1277,1347
E01005983,0,20,11,27,1558,1616
E01005984,2,22,52,18,1423,1517
E01006042,0,3,29,12,1594,1638
E01006043,1,1,12,100,1352,1466
E01006044,0,1,9,29,1344,1383
E01006045,5,1,12,16,1230,1264
E01006046,0,5,17,37,1422,1481
E01006109,69,427,115,291,546,1448
E01006110,66,313,104,668,624,1775
E01006111,84,340,118,659,519,1720
E01006112,35,343,95,789,451,1713
E01006185,60,384,103,370,1051,1968
E01006188,76,150,80,652,595,1553
E01006116,0,12,15,25,1298,1350
E01006117,5,22,35,46,1564,1672
E01006118,0,11,32,39,1371,1453
E01006119,14,51,32,63,1448,1608
E01006121,4,25,34,46,1440,1549
E01006141,32,150,76,346,1000,1604
E01006186,29,196,130,253,1295,1903
E01006187,34,195,164,192,1950,2535
E01006189,23,127,147,238,1700,2235
E01006113,44,169,72,855,384,1524
E01006114,43,171,99,703,646,1662
E01006115,59,259,87,536,643,1584
E01006145,48,167,89,464,1029,1797
E01006146,31,207,104,551,1001,1894
E01006122,5,22,16,24,1486,1553
E01006123,8,18,26,67,1576,1695
E01006124,2,4,18,22,1427,1473
E01006128,5,18,24,39,1681,1767
E01006131,1,4,35,27,1499,1566
E01006155,3,33,38,40,1492,1606
E01006157,22,93,56,205,1181,1557
E01006159,13,71,68,169,1483,1804
E01006182,11,93,48,184,1196,1532
E01006183,28,77,57,234,1254,1650
E01006125,5,26,19,20,1414,1484
E01006126,1,18,32,19,1595,1665
E01006127,0,6,26,30,1554,1616
E01006130,0,11,18,27,1721,1777
E01006132,13,8,21,18,1506,1566
E01006156,12,106,61,68,1346,1593
E01006158,6,81,51,159,1351,1648
E01006179,11,80,58,90,1493,1732
E01006184,21,56,51,123,1425,1676
E01006198,2,22,22,44,1464,1554
E01006199,1,22,35,24,1488,1570
E01006200,8,16,30,33,1358,1445
E01006201,3,18,59,47,1368,1495
E01006202,6,32,37,39,1244,1358
E01006120,7,2,16,23,1382,1430
E01006129,0,27,22,26,1292,1367
E01006133,0,1,7,11,1435,1454
E01006197,0,19,49,81,1381,1530
E01006203,4,5,23,12,1371,1415
E01006142,33,98,61,220,1247,1659
E01006143,8,49,34,254,1314,1659
E01006144,10,89,61,75,1209,1444
E01006180,14,69,73,148,1534,1838
E01006181,16,81,76,272,1221,1666
E01006147,4,11,19,34,1347,1415
E01006149,3,6,26,37,1413,1485
E01006150,3,21,31,41,1446,1542
E01006154,8,9,41,67,1376,1501
E01006165,7,9,60,125,1717,1918
E01006166,42,18,31,56,1420,1567
E01006169,13,13,18,24,1566,1634
E01006170,5,20,25,16,1484,1550
E01006171,19,8,64,73,1632,1796
E01006098,4,5,18,77,1185,1289
E01006099,34,6,25,51,1236,1352
E01006164,0,9,19,55,1567,1650
E01006174,5,10,26,91,1606,1738
E01006178,33,20,40,83,1645,1821
E01006097,15,36,54,156,1507,1768
E01006160,17,28,42,177,1489,1753
E01006161,3,26,47,178,1704,1958
E01006162,12,11,16,85,1491,1615
E01006163,9,9,54,70,1646,1788
E01006148,29,22,22,67,1492,1632
E01006151,19,7,16,136,1330,1508
E01006152,44,29,23,205,1335,1636
E01006153,45,37,37,129,1320,1568
E01006172,5,18,16,55,1436,1530
E01006104,3,14,25,17,1630,1689
E01006105,1,34,59,25,1814,1933
E01006106,1,21,35,12,1416,1485
E01006107,8,22,29,25,1534,1618
E01006108,3,80,54,16,1517,1670
E01006102,16,25,34,62,1231,1368
E01006173,7,24,9,62,1414,1516
E01006175,27,18,35,53,1480,1613
E01006176,44,29,32,61,1623,1789
E01006177,8,28,56,64,1489,1645
E01006091,16,23,71,319,1858,2287
E01006092,5,13,53,50,1234,1355
E01006095,14,36,43,127,1409,1629
E01006167,19,60,88,84,1382,1633
E01006168,15,99,110,56,1639,1919
E01006090,6,14,37,49,1858,1964
E01006094,13,19,25,111,1318,1486
E01006096,10,14,6,75,1427,1532
E01006100,12,11,28,85,1381,1517
E01006103,22,11,38,103,1444,1618
E01006101,10,14,20,113,1365,1522
E01006190,2,3,20,54,1614,1693
E01006195,13,15,20,57,1666,1771
E01006196,6,8,14,46,1710,1784
E01006210,18,15,38,140,1445,1656
E01006204,24,14,24,100,1448,1610
E01006206,13,35,52,133,1651,1884
E01006207,21,31,36,47,1482,1617
E01006208,18,29,61,62,1457,1627
E01006211,6,2,21,23,1478,1530
E01006093,5,3,24,68,1496,1596
E01006191,1,16,21,48,1572,1658
E01006192,8,4,19,40,1463,1534
E01006205,1,4,26,71,1286,1388
E01006209,15,14,13,54,1481,1577
E01006078,20,20,50,46,1715,1851
E01006080,1,15,40,62,1690,1808
E01006089,9,16,44,77,1351,1497
E01006193,3,9,33,51,1423,1519
E01006194,15,18,70,199,2031,2333
E01006074,6,5,27,69,1467,1574
E01006075,9,16,31,109,1775,1940
E01006076,17,15,29,82,1480,1623
E01006079,23,11,43,154,1764,1995
E01006087,22,6,37,105,1343,1513
E01006083,5,0,35,40,1317,1397
E01006084,6,11,24,41,1626,1708
E01006088,6,6,34,18,1511,1575
E01006139,4,13,30,79,1591,1717
E01006140,5,4,61,114,1501,1685
E01006077,10,14,35,40,1492,1591
E01006081,24,4,35,107,1221,1391
E01006082,6,9,38,89,1465,1607
E01006085,7,7,27,61,1472,1574
E01006086,7,10,27,79,1545,1668
E01006134,18,3,23,168,1315,1527
E01006135,27,15,39,163,1392,1636
E01006136,16,11,35,218,1271,1551
E01006137,51,11,39,354,978,1433
E01006138,59,7,40,188,1453,1747
E01006315,4,6,2,6,1219,1237
E01006316,2,1,10,10,1463,1486
E01006317,0,1,7,4,1511,1523
E01006319,5,9,21,30,1374,1439
E01006229,13,6,12,33,1463,1527
E01006230,11,3,1,34,1368,1417
E01006233,5,5,21,29,1437,1497
E01006237,1,6,17,15,1537,1576
E01006238,2,12,10,13,1493,1530
E01006259,0,1,2,18,1300,1321
E01006312,2,2,9,6,1462,1481
E01006313,1,8,5,0,1053,1067
E01006314,1,1,7,9,1661,1679
E01006318,0,0,10,5,1431,1446
E01006320,0,2,11,22,1343,1378
E01006321,2,2,10,9,1687,1710
E01006231,7,0,8,29,1433,1477
E01006232,0,3,10,12,1830,1855
E01006234,0,2,5,12,1211,1230
E01006235,3,1,11,13,1496,1524
E01006253,1,10,4,20,1509,1544
E01006254,4,11,22,23,1597,1657
E01006255,6,2,15,8,1474,1505
E01006256,2,10,19,13,1395,1439
E01006260,0,2,17,12,1499,1530
E01006370,10,25,39,120,1404,1598
E01006372,2,11,18,51,1593,1675
E01006373,3,1,14,24,1461,1503
E01006374,3,3,12,12,1519,1549
E01006390,0,1,13,12,1513,1539
E01006236,1,6,9,5,1459,1480
E01006388,3,2,15,1,1670,1691
E01006389,1,2,13,4,1380,1400
E01006391,0,3,4,13,1567,1587
E01006257,2,3,18,25,1259,1307
E01006258,5,16,18,11,1634,1684
E01006369,21,23,18,41,1593,1696
E01006371,4,6,13,47,1473,1543
E01006375,11,27,18,49,1497,1602
E01006306,14,21,32,21,1458,1546
E01006307,1,8,10,7,1406,1432
E01006386,18,16,17,17,1466,1534
E01006387,5,1,10,2,1301,1319
E01006392,6,35,14,31,1413,1499
E01006350,5,21,37,27,1733,1823
E01006351,8,49,35,39,1961,2092
E01006357,3,6,14,17,1687,1727
E01006360,25,12,30,10,1598,1675
E01006361,8,18,17,14,1559,1616
E01006356,0,4,12,10,1446,1472
E01006396,5,1,4,0,1462,1472
E01006397,0,1,9,5,1120,1135
E01006398,0,3,5,4,1074,1086
E01006399,1,4,12,22,1499,1538
E01006305,0,21,23,19,1720,1783
E01006308,0,3,10,22,1605,1640
E01006309,7,9,14,11,1561,1602
E01006310,0,9,14,12,1478,1513
E01006311,1,18,18,27,1529,1593
E01006269,0,18,10,14,1563,1605
E01006271,0,11,11,13,1750,1785
E01006272,2,1,12,25,1613,1653
E01006273,6,3,14,11,1499,1533
E01006276,13,10,12,15,2224,2274
E01006353,1,5,8,10,1519,1543
E01006354,1,7,11,32,1533,1584
E01006355,1,0,20,10,1500,1531
E01006358,4,8,14,13,1711,1750
E01006359,1,13,10,15,1475,1514
E01006349,9,5,24,44,1680,1762
E01006352,9,2,9,16,1630,1666
E01006404,1,7,11,27,1614,1660
E01006405,2,2,12,12,1353,1381
E01006411,16,32,24,27,1531,1630
E01006270,0,9,1,3,1482,1495
E01006274,2,7,20,16,1466,1511
E01006275,1,4,27,4,1493,1529
E01006277,2,3,16,8,1773,1802
E01006286,2,2,6,1,1498,1509
E01006239,3,33,10,32,1887,1965
E01006240,6,27,17,13,1538,1601
E01006241,6,32,33,32,1898,2001
E01006287,0,6,9,14,1188,1217
E01006289,8,26,22,10,1680,1746
E01006362,0,1,3,13,1765,1782
E01006363,0,1,3,2,1536,1542
E01006364,10,6,9,19,1767,1811
E01006365,2,14,11,29,2150,2206
E01006366,1,1,13,3,1663,1681
E01006367,0,0,8,6,1563,1577
E01006368,0,1,12,7,1621,1641
E01006278,3,3,18,11,1539,1574
E01006279,3,4,6,11,1569,1593
E01006280,1,3,8,3,1413,1428
E01006281,2,21,9,13,1719,1764
E01006285,2,1,15,5,1815,1838
E01006406,12,9,6,8,1425,1460
E01006407,0,0,16,16,1475,1507
E01006408,7,3,14,7,1513,1544
E01006409,1,1,8,11,1367,1388
E01006410,1,0,10,5,1387,1403
E01006393,1,6,16,6,1461,1490
E01006394,0,2,0,2,1557,1561
E01006395,1,1,15,20,2465,2502
E01006400,1,8,8,15,1313,1345
E01006401,0,2,13,6,1442,1463
E01006402,3,5,2,1,1187,1198
E01006403,0,2,13,17,1673,1705
E01006290,1,6,6,22,1340,1375
E01006291,1,2,8,23,1436,1470
E01006292,0,13,11,9,1535,1568
E01006293,5,22,10,3,1539,1579
E01006242,0,2,14,9,1618,1643
E01006243,2,5,19,37,1982,2045
E01006244,1,7,8,15,1533,1564
E01006245,9,10,43,53,2302,2417
E01006213,8,22,22,32,1543,1627
E01006215,3,10,13,9,1640,1675
E01006217,4,11,15,31,2273,2334
E01006218,5,12,23,45,1970,2055
E01006219,2,0,4,4,1287,1297
E01006288,6,32,16,39,1710,1803
E01006294,3,8,27,28,1897,1963
E01006295,5,19,7,2,1560,1593
E01006377,2,12,9,17,1584,1624
E01006378,3,13,15,3,1300,1334
E01006212,1,0,8,2,1384,1395
E01006214,2,29,7,10,1327,1375
E01006216,9,22,24,21,2115,2191
E01006322,1,4,14,11,1509,1539
E01006329,3,12,30,17,1228,1290
E01006282,2,12,23,23,1641,1701
E01006283,9,9,19,27,1471,1535
E01006284,0,14,20,6,1480,1520
E01006336,6,12,26,10,1576,1630
E01006337,2,6,15,9,1475,1507
E01006376,4,27,22,11,1578,1642
E01006381,6,22,25,41,1826,1920
E01006382,1,3,10,17,1379,1410
E01006383,9,3,17,17,1614,1660
E01006384,0,1,6,8,1379,1394
E01006250,2,4,15,15,1496,1532
E01006251,8,2,20,13,1419,1462
E01006379,4,10,35,15,1487,1551
E01006380,4,5,20,20,1606,1655
E01006385,2,8,34,23,1422,1489
E01006328,12,18,14,93,1295,1432
E01006333,6,26,37,124,1617,1810
E01006334,22,25,19,58,1592,1716
E01006338,5,18,20,31,1514,1588
E01006248,4,31,14,27,1488,1564
E01006249,4,20,22,21,1511,1578
E01006330,5,11,17,44,1552,1629
E01006331,6,0,7,20,1563,1596
E01006332,6,13,18,24,2016,2077
E01006262,3,0,6,19,1503,1531
E01006263,1,1,6,2,1537,1547
E01006266,2,1,9,2,1378,1392
E01006267,5,3,9,3,1617,1637
E01006268,1,2,16,7,1736,1762
E01006323,5,1,6,14,1476,1502
E01006324,1,3,4,4,1313,1325
E01006325,1,5,21,37,1544,1608
E01006326,6,5,26,17,1385,1439
E01006327,0,32,18,8,1424,1482
E01006246,7,4,21,17,1517,1566
E01006247,0,6,10,10,1304,1330
E01006252,2,0,11,6,1445,1464
E01006297,1,23,18,10,1579,1631
E01006335,1,15,8,45,1603,1672
E01006220,0,5,10,4,1826,1845
E01006221,0,5,13,4,1623,1645
E01006222,2,6,10,5,1554,1577
E01006224,3,2,5,11,1556,1577
E01006226,2,2,3,12,1735,1754
E01006223,4,4,11,11,1580,1610
E01006225,1,0,9,1,1503,1514
E01006261,1,1,5,4,1525,1536
E01006264,0,1,5,4,1346,1356
E01006265,0,1,7,14,1410,1432
E01006296,4,6,14,23,1486,1533
E01006298,7,16,18,39,1325,1405
E01006299,4,9,15,20,1840,1888
E01006300,2,4,12,12,1317,1347
E01006301,1,0,2,1,1358,1362
E01006227,1,5,9,6,1533,1554
E01006228,2,15,8,30,1676,1731
E01006342,2,10,8,4,1543,1567
E01006344,0,10,13,19,1445,1487
E01006346,1,8,14,18,2093,2134
E01006339,0,2,12,4,1352,1370
E01006340,1,8,9,5,1434,1457
E01006343,11,7,22,45,1673,1758
E01006345,0,3,8,13,1559,1583
E01006348,2,2,4,12,1587,1607
E01006302,2,5,22,24,1550,1603
E01006303,5,2,8,10,1369,1394
E01006304,1,1,13,27,1439,1481
E01006341,7,1,19,14,1603,1644
E01006347,4,0,7,13,1556,1580
E01024859,1,1,13,11,1503,1529
E01024861,1,6,17,50,1235,1309
E01024862,0,4,7,30,1532,1573
E01024891,10,11,28,301,1267,1617
E01024892,12,6,31,130,1249,1428
E01024894,0,1,24,36,1315,1376
E01024893,10,3,28,441,1001,1483
E01024896,18,4,19,161,1124,1326
E01024897,2,1,18,422,983,1426
E01024898,16,1,38,387,1120,1562
E01024856,7,13,39,710,844,1613
E01024875,25,3,30,1123,224,1405
E01024876,11,4,27,987,338,1367
E01024877,4,10,34,1186,340,1574
E01024878,12,9,18,1423,147,1609
E01024895,13,4,38,539,783,1377
E01024883,0,2,11,22,1471,1506
E01024884,3,1,7,7,1567,1585
E01024885,0,1,7,16,1641,1665
E01024886,1,2,9,42,1338,1392
E01024889,2,3,10,13,1261,1289
E01024890,1,4,8,8,1449,1470
E01024879,0,1,20,17,1280,1318
E01024880,1,1,4,11,1418,1435
E01024912,5,2,4,44,1342,1397
E01024913,3,5,12,55,1297,1372
E01024914,0,2,6,33,1443,1484
E01024881,0,4,12,19,1390,1425
E01024882,1,7,16,13,1436,1473
E01024902,1,1,3,15,1503,1523
E01024911,7,1,24,34,1694,1760
E01024855,3,0,17,33,1375,1428
E01024857,8,2,25,301,1186,1522
E01024858,20,14,28,397,879,1338
E01024864,1,0,11,21,1554,1587
E01024863,0,6,22,38,1405,1471
E01024865,1,9,8,27,1389,1434
E01024866,0,1,8,22,1730,1761
E01024867,1,1,5,3,1410,1420
E01024860,2,0,5,7,1229,1243
E01024868,0,0,4,9,1208,1221
E01024869,1,0,4,9,1400,1414
E01024870,1,0,2,5,1138,1146
E01024872,1,8,20,28,1300,1357
E01024899,20,12,23,35,1554,1644
E01024900,4,10,24,19,1546,1603
E01024907,0,2,22,26,1177,1227
E01024908,0,0,14,12,1013,1039
E01024909,0,8,32,79,1419,1538
E01024874,0,1,7,9,1035,1052
E01024887,0,2,6,12,1480,1500
E01024888,1,1,9,17,1642,1670
E01024901,3,3,9,13,1787,1815
E01024871,0,3,4,11,1315,1333
E01024873,0,1,9,7,1363,1380
E01024903,1,1,14,19,1225,1260
E01024904,0,2,30,54,1660,1746
E01024905,1,0,10,14,1221,1246
E01024906,2,5,22,26,1475,1530
E01024910,2,1,20,39,1404,1466
E01024951,3,7,24,10,1161,1205
E01024952,5,13,18,17,1247,1300
E01024953,2,30,23,14,1327,1396
E01024954,3,19,19,12,1346,1399
E01024921,3,4,14,6,2096,2123
E01024978,1,5,12,8,1315,1341
E01024979,0,0,10,15,1357,1382
E01024980,4,0,3,11,1370,1388
E01024946,8,1,23,18,1191,1241
E01024947,4,8,17,10,1309,1348
E01024955,0,4,11,24,1436,1475
E01024956,1,1,10,12,1420,1444
E01024957,1,1,11,13,1415,1441
E01024958,0,5,4,10,1352,1371
E01024948,0,4,12,2,1438,1456
E01024949,5,12,27,29,2222,2295
E01024950,0,1,19,20,1317,1357
E01024977,3,4,17,33,2182,2239
E01024967,2,2,20,9,1269,1302
E01024968,8,4,12,15,1852,1891
E01024969,1,10,12,11,1330,1364
E01024970,6,3,7,13,1341,1370
E01024971,3,1,17,17,1258,1296
E01024972,2,2,11,4,1245,1264
E01024929,0,1,13,41,1290,1345
E01024930,0,9,9,30,1390,1438
E01024931,7,12,17,60,1391,1487
E01024932,1,0,2,20,1002,1025
E01024933,2,6,16,28,1304,1356
E01024937,3,7,16,45,1417,1488
E01024964,1,0,15,4,1442,1462
E01024974,2,1,12,6,1526,1547
E01024975,15,76,73,120,2872,3156
E01024976,1,4,15,10,1525,1555
E01024919,19,14,29,65,2445,2572
E01024920,4,7,16,28,1884,1939
E01024934,4,3,21,19,1462,1509
E01024935,6,6,4,6,1396,1418
E01024925,18,8,18,238,1426,1708
E01024926,14,12,30,117,1748,1921
E01024927,0,7,8,44,1608,1667
E01024928,0,2,20,63,1442,1527
E01024936,3,5,18,29,1491,1546
E01024938,1,4,10,9,1600,1624
E01024939,0,3,14,16,1711,1744
E01024940,1,8,15,78,1597,1699
E01024941,0,3,12,33,1520,1568
E01024923,0,5,5,5,1219,1234
E01024924,0,0,3,8,1401,1412
E01024963,0,1,6,4,1504,1515
E01024965,1,3,9,1,1386,1400
E01024966,1,1,15,12,1559,1588
E01024942,6,1,11,10,1601,1629
E01024943,0,20,28,11,2234,2293
E01024944,2,4,19,13,1748,1786
E01024945,8,9,40,54,2778,2889
E01024922,0,3,8,12,1427,1450
E01024959,1,0,20,24,1695,1740
E01024960,5,2,12,7,1597,1623
E01024961,0,2,6,0,1594,1602
E01024962,1,3,15,7,1518,1544
E01024915,2,3,12,16,2148,2181
E01024916,0,0,13,11,1649,1673
E01024917,1,1,7,37,1677,1723
E01024918,0,4,15,12,1718,1749
E01024973,0,0,16,24,2095,2135
E01024993,0,1,3,4,1471,1479
E01025026,3,11,20,8,1286,1328
E01025027,2,20,36,45,1675,1778
E01025028,2,5,21,4,1336,1368
E01025031,3,1,10,16,1175,1205
E01025007,0,1,9,19,1259,1288
E01025008,1,4,5,0,1141,1151
E01025009,5,3,9,6,1428,1451
E01025011,2,6,10,15,1438,1471
E01025012,2,2,21,25,1925,1975
E01025013,5,1,13,38,1552,1609
E01025019,1,1,9,14,1348,1373
E01024998,2,3,12,12,1770,1799
E01025010,4,20,47,66,1696,1833
E01025014,0,1,7,4,1671,1683
E01025015,0,0,5,6,1533,1544
E01025004,1,2,11,14,1298,1326
E01025006,0,1,11,27,1274,1313
E01025023,4,1,3,3,1321,1332
E01025024,6,4,9,7,1286,1312
E01025025,2,0,19,11,1501,1533
E01025001,4,0,4,15,1537,1560
E01025002,6,1,17,9,1432,1465
E01025005,1,2,13,5,1413,1434
E01025016,11,1,31,57,2266,2366
E01025018,10,0,8,23,1191,1232
E01024984,0,5,14,6,1413,1438
E01024985,2,3,12,21,1353,1391
E01024986,9,3,15,35,1468,1530
E01024987,7,10,30,34,1192,1273
E01024988,4,3,14,23,1554,1598
E01024989,2,3,17,4,1465,1491
E01024996,3,4,14,15,1198,1234
E01024997,3,1,7,3,1410,1424
E01024999,0,0,9,4,1501,1514
E01025000,1,0,6,2,1273,1282
E01025029,3,2,10,8,1926,1949
E01025030,2,3,32,26,1584,1647
E01024981,4,5,19,15,1289,1332
E01024982,5,5,13,13,1343,1379
E01024983,5,5,10,10,1429,1459
E01024994,6,2,15,12,1552,1587
E01024995,2,1,17,15,1384,1419
E01025003,0,1,8,24,1605,1638
E01025017,1,2,12,16,1387,1418
E01024990,7,3,18,21,1537,1586
E01024991,2,2,7,20,983,1014
E01024992,7,1,11,10,1317,1346
E01025020,2,2,18,14,1257,1293
E01025021,7,2,28,21,1378,1436
E01025022,2,3,23,20,1823,1871
E01025060,1,2,13,318,1132,1466
E01025061,2,1,9,159,1278,1449
E01025062,1,1,20,306,1243,1571
E01025063,4,0,10,44,1448,1506
E01025064,1,4,10,32,1532,1579
E01025065,0,2,15,41,1579,1637
E01025066,3,2,22,61,1504,1592
E01025032,3,0,7,26,1419,1455
E01025033,6,1,7,72,2213,2299
E01025034,5,0,2,61,1615,1683
E01025048,2,3,17,36,1525,1583
E01025049,0,0,14,35,1563,1612
E01025050,4,2,8,30,1486,1530
E01025053,0,1,18,30,1503,1552
E01025070,0,8,9,24,1121,1162
E01025071,5,2,4,8,1362,1381
E01025072,1,1,11,45,1323,1381
E01025073,1,0,5,13,1270,1289
E01025074,0,3,9,12,1388,1412
E01025051,0,2,9,34,1339,1384
E01025052,0,1,7,48,1426,1482
E01025057,1,4,16,143,1427,1591
E01025058,3,3,16,91,1268,1381
E01025059,0,1,15,54,1410,1480
E01025067,3,2,20,87,1413,1525
E01025068,1,6,25,175,1305,1512
E01025069,0,4,11,56,1410,1481
E01025044,3,1,19,240,973,1236
E01025045,2,0,13,19,1247,1281
E01025046,1,3,10,61,1155,1230
E01025081,0,2,9,27,1613,1651
E01025041,10,0,18,823,857,1708
E01025042,8,2,21,1698,468,2197
E01025082,1,3,28,326,1357,1715
E01025083,14,4,34,394,1557,2003
E01025084,2,0,20,834,778,1634
E01033231,11,5,30,1779,1044,2869
E01025055,1,2,11,26,1466,1506
E01025075,7,3,10,67,1590,1677
E01025076,6,2,24,23,1312,1367
E01025077,0,5,8,25,1334,1372
E01025078,7,2,4,28,1487,1528
E01025035,5,0,3,130,1345,1483
E01025036,7,3,19,196,1280,1505
E01025037,3,5,17,85,1326,1436
E01025038,0,2,8,19,1329,1358
E01025039,2,0,10,17,1183,1212
E01025040,2,1,8,45,1416,1472
E01025054,2,0,11,16,1685,1714
E01025056,0,1,5,12,1323,1341
E01025079,5,2,21,28,1610,1666
E01025080,1,2,6,48,1541,1598
E01025088,0,0,5,15,1101,1121
E01025096,0,12,5,12,1569,1598
E01025097,3,15,3,15,1452,1488
E01025098,1,15,8,16,1313,1353
E01025148,0,8,6,3,2018,2035
E01025168,1,0,8,1,1084,1094
E01025169,0,0,3,9,1254,1266
E01025130,4,2,5,4,2108,2123
E01025132,1,0,2,3,1482,1488
E01025166,0,0,8,2,1170,1180
E01025167,1,1,9,3,1204,1218
E01025089,0,1,7,11,1376,1395
E01025090,0,1,9,4,1725,1739
E01025158,2,0,13,8,1410,1433
E01025159,0,0,10,22,1399,1431
E01025160,5,0,8,16,1226,1255
E01025085,1,0,14,4,1373,1392
E01025086,1,1,2,1,1365,1370
E01025087,1,2,16,9,1277,1305
E01025161,0,1,6,4,1112,1123
E01025108,0,3,14,3,1212,1232
E01025109,0,0,15,2,1028,1045
E01025131,2,0,11,18,1502,1533
E01025133,0,1,10,8,1402,1421
E01025112,8,14,24,25,1583,1654
E01025136,4,3,18,13,1527,1565
E01025138,1,6,5,26,1425,1463
E01025139,5,28,24,61,1518,1636
E01025140,2,9,23,11,1450,1495
E01025111,1,5,14,12,1775,1807
E01025113,1,0,9,19,1490,1519
E01025118,3,6,13,14,1079,1115
E01025119,5,1,12,7,1323,1348
E01025110,5,5,16,28,1365,1419
E01025116,0,1,10,5,1385,1401
E01025117,5,14,11,39,1337,1406
E01025120,0,3,12,26,1364,1405
E01025170,1,0,11,8,1659,1679
E01025171,2,9,22,11,1666,1710
E01025172,0,1,12,10,1513,1536
E01025173,0,2,16,2,1620,1640
E01025149,2,0,26,12,2094,2134
E01025150,0,3,24,27,1431,1485
E01025151,11,18,34,24,1451,1538
E01025152,0,2,7,10,1492,1511
E01025154,1,1,16,11,1310,1339
E01025091,7,0,19,22,1425,1473
E01025092,1,2,4,7,1198,1212
E01025095,5,9,34,37,1376,1461
E01025126,3,10,29,50,1831,1923
E01025093,5,17,27,107,1549,1705
E01025094,4,12,21,51,1330,1418
E01025099,3,26,16,43,1409,1497
E01033071,14,25,19,86,1063,1207
E01033073,14,24,28,149,1504,1719
E01025125,6,15,30,57,1248,1356
E01025128,1,13,22,48,1230,1314
E01025129,9,21,12,149,1053,1244
E01025147,16,12,26,62,1337,1453
E01025114,1,2,8,1,1495,1507
E01025115,2,1,20,14,1533,1570
E01025121,4,4,18,8,1691,1725
E01025122,2,0,16,11,1687,1716
E01025123,4,9,12,16,2272,2313
E01025124,2,8,16,14,1470,1510
E01033072,0,3,10,9,2392,2414
E01025100,4,13,22,23,1480,1542
E01025101,1,11,10,17,1374,1413
E01025102,5,7,27,246,1176,1461
E01025103,2,5,9,33,1288,1337
E01025144,19,27,24,374,1601,2045
E01025146,6,13,26,70,1926,2041
E01025127,5,1,4,39,1327,1376
E01025141,8,5,16,41,1373,1443
E01025143,12,12,12,27,1385,1448
E01025145,7,6,21,35,1403,1472
E01025105,39,68,94,1042,4894,6137
E01025106,7,14,36,105,2296,2458
E01025107,8,6,15,21,1593,1643
E01025142,1,10,16,25,1400,1452
E01025137,4,2,14,7,1437,1464
E01025153,1,3,6,13,1222,1245
E01025155,3,3,4,11,1237,1258
E01025156,0,0,8,22,1145,1175
E01025157,0,8,11,12,1122,1153
E01025162,0,1,13,7,1327,1348
E01025163,0,1,6,2,1375,1384
E01025164,1,1,10,7,1381,1400
E01025165,1,4,9,18,1468,1500
E01025191,1,0,7,41,1205,1254
E01025192,0,1,13,44,1380,1438
E01025193,0,1,7,5,1345,1358
E01025194,2,1,8,52,1332,1395
E01025195,0,1,9,14,1186,1210
E01025196,7,0,11,33,1548,1599
E01025197,0,0,2,11,1328,1341
E01025198,2,2,10,71,1316,1401
E01025199,0,3,12,33,1630,1678
E01025200,0,0,13,32,1479,1524
E01025201,0,1,9,12,1577,1599
E01025202,1,1,14,11,1355,1382
E01025205,0,1,8,17,1355,1381
E01025206,1,0,2,16,1154,1173
E01025207,1,0,4,37,1223,1265
E01025208,1,2,19,8,1240,1270
E01025220,0,2,13,20,1559,1594
E01025221,0,0,10,19,1322,1351
E01025222,2,0,13,15,1438,1468
E01025223,1,3,21,35,1354,1414
E01025178,4,1,2,7,1801,1815
E01025179,0,0,10,8,1552,1570
E01025180,0,4,17,16,1840,1877
E01025203,1,2,7,11,1662,1683
E01025226,7,4,25,72,1471,1579
E01025227,3,5,18,231,1754,2011
E01025228,3,4,27,50,1506,1590
E01025174,6,2,6,180,1267,1461
E01025175,0,4,8,13,1555,1580
E01025176,1,0,14,16,1971,2002
E01025177,4,2,12,34,1748,1800
E01025204,0,0,11,18,1613,1642
E01025211,2,1,10,15,1431,1459
E01025181,1,1,24,387,1152,1565
E01025182,6,1,25,936,662,1630
E01025183,4,5,19,654,964,1646
E01025184,4,0,35,1231,378,1648
E01025188,8,13,26,852,1114,2013
E01025189,2,3,32,430,1212,1679
E01025210,0,0,25,125,1653,1803
E01025217,5,0,33,548,950,1536
E01025218,4,1,31,639,586,1261
E01025219,1,5,13,292,849,1160
E01025224,0,0,37,1411,717,2165
E01025225,2,0,26,555,1100,1683
E01025229,1,1,37,1667,516,2222
E01025230,3,3,15,1140,471,1632
E01025187,5,4,11,375,1029,1424
E01025190,5,4,13,362,1305,1689
E01025209,1,1,19,86,1579,1686
E01025216,11,1,35,441,1629,2117
E01025185,2,2,19,910,996,1929
E01025186,8,17,31,686,767,1509
E01025212,8,1,16,469,908,1402
E01025213,1,8,21,492,600,1122
E01025214,3,2,5,157,1212,1379
E01025215,1,5,26,765,591,1388
E01025278,1,10,27,20,2485,2543
E01025279,0,3,10,9,1923,1945
E01025282,0,5,7,17,1369,1398
E01025257,0,4,15,86,1241,1346
E01025277,6,1,29,56,1630,1722
E01025280,4,3,13,42,1742,1804
E01025281,9,4,10,32,1445,1500
E01025256,5,14,26,234,1224,1503
E01025258,8,7,8,153,1314,1490
E01025259,1,7,20,140,1897,2065
E01025299,7,4,13,209,1208,1441
E01025301,5,4,16,104,999,1128
E01025302,2,20,15,161,1040,1238
E01025253,1,26,43,253,1450,1773
E01025254,3,8,6,153,1046,1216
E01025255,12,14,31,205,1335,1597
E01025300,21,8,9,136,959,1133
E01025303,5,12,15,146,1161,1339
E01025260,5,27,50,24,1384,1490
E01025262,0,15,33,42,1420,1510
E01025263,3,17,45,34,1401,1500
E01025264,3,12,73,32,1331,1451
E01025239,2,10,21,92,1268,1393
E01025241,6,10,24,284,1281,1605
E01025242,14,9,34,317,1238,1612
E01025243,20,28,47,485,1386,1966
E01025251,18,26,20,505,925,1494
E01025234,2,9,31,69,1350,1461
E01025235,4,25,26,208,1384,1647
E01025237,8,16,43,131,1290,1488
E01025238,1,10,38,47,1466,1562
E01025245,19,35,101,761,1747,2663
E01025252,5,11,24,163,1220,1423
E01025233,2,15,31,60,1298,1406
E01025240,22,6,14,53,1496,1591
E01025261,2,14,25,50,1327,1418
E01025266,0,9,8,54,1191,1262
E01025309,12,5,30,87,1026,1160
E01025236,9,21,50,85,1290,1455
E01025283,3,21,42,20,1599,1685
E01025284,1,11,47,125,1577,1761
E01025285,0,12,70,210,1136,1428
E01025286,1,37,53,34,1581,1706
E01025287,7,37,82,51,1791,1968
E01025270,0,7,20,30,1536,1593
E01025272,17,4,20,54,1490,1585
E01025273,2,8,15,50,1345,1420
E01025288,18,24,58,111,1388,1599
E01025246,14,18,29,1411,278,1750
E01025274,8,15,61,225,1598,1907
E01025275,5,32,52,178,1342,1609
E01025294,16,56,52,839,864,1827
E01025276,4,18,41,420,1212,1695
E01025308,4,24,36,213,1440,1717
E01025310,1,31,40,114,1330,1516
E01025311,9,10,34,52,1241,1346
E01025312,4,15,39,43,1540,1641
E01025313,5,51,51,188,1653,1948
E01025314,16,48,88,359,2159,2670
E01025231,0,4,17,93,1334,1448
E01025232,7,7,55,86,1450,1605
E01025265,1,9,32,19,1429,1490
E01025267,1,7,20,73,1345,1446
E01025268,5,9,32,29,1589,1664
E01025269,4,10,39,42,1543,1638
E01025271,4,8,26,48,1473,1559
E01025295,32,46,76,544,1861,2559
E01025296,9,43,95,571,1232,1950
E01025297,24,27,77,631,1298,2057
E01025298,30,18,56,623,894,1621
E01025244,34,29,39,1330,258,1690
E01025292,71,77,102,402,2520,3172
E01025293,64,38,81,838,1009,2030
E01025247,35,28,29,909,727,1728
E01025248,13,29,38,108,1140,1328
E01025249,5,12,20,44,935,1016
E01025250,1,44,71,705,891,1712
E01025304,20,23,64,978,760,1845
E01025305,8,41,43,838,711,1641
E01025289,77,35,48,414,1106,1680
E01025290,22,36,42,563,1044,1707
E01025291,5,22,34,264,1040,1365
E01025306,55,25,64,479,1172,1795
E01033223,72,18,42,164,939,1235
E01033224,48,30,29,175,747,1029
E01033226,24,38,44,296,681,1083
E01025315,2,61,21,44,1609,1737
E01025320,0,0,7,4,1314,1325
E01025331,0,0,4,10,1391,1405
E01025348,0,0,5,0,1512,1517
E01025349,0,0,9,7,1400,1416
E01025334,0,2,10,35,1512,1559
E01025344,2,0,6,6,1383,1397
E01025345,2,1,3,6,1437,1449
E01025346,2,2,9,35,1454,1502
E01025347,0,7,15,54,1557,1633
E01025329,0,0,1,28,1402,1431
E01025330,0,0,10,17,1315,1342
E01025335,1,1,11,59,1305,1377
E01025338,0,2,7,22,1561,1592
E01025339,0,0,12,27,1444,1483
E01025322,0,0,12,4,1340,1356
E01025326,0,0,15,3,1459,1477
E01025327,0,0,7,3,1310,1320
E01025342,2,0,14,4,1578,1598
E01025321,0,0,2,2,1312,1316
E01025340,1,0,12,16,1373,1402
E01025341,3,1,6,13,1148,1171
E01025343,0,0,12,3,1407,1422
E01025354,5,2,5,2,1302,1316
E01025316,0,0,2,6,1472,1480
E01025317,0,1,9,17,1136,1163
E01025325,1,0,15,15,1487,1518
E01025328,0,0,3,6,1222,1231
E01025318,0,1,7,1,1051,1060
E01025319,6,2,18,25,2043,2094
E01025333,0,1,15,16,1180,1212
E01025350,0,0,5,4,1280,1289
E01025351,0,2,21,59,2524,2606
E01025323,7,1,3,25,1096,1132
E01025324,5,1,8,13,1474,1501
E01025332,3,1,2,37,1006,1049
E01025336,0,0,3,18,1100,1121
E01025337,5,0,12,22,1512,1551
E01025352,0,2,11,50,1429,1492
E01025353,0,1,11,11,1067,1090
E01025355,2,2,14,117,2113,2248
E01025361,4,6,15,48,1989,2062
E01025362,0,0,11,16,1944,1971
E01025393,0,1,13,3,1413,1430
E01025363,5,1,10,55,1292,1363
E01025364,0,5,24,51,1230,1310
E01025366,2,7,24,435,1089,1557
E01025395,3,0,4,43,1515,1565
E01025396,1,1,21,251,1101,1375
E01025397,16,9,13,516,1134,1688
E01025398,14,6,27,237,1122,1406
E01025367,1,2,10,14,1749,1776
E01025368,0,6,10,11,1569,1596
E01025369,0,5,10,25,1190,1230
E01025381,1,0,16,23,1433,1473
E01025382,1,5,9,14,1693,1722
E01025383,0,2,18,39,2251,2310
E01025356,0,1,23,262,1222,1508
E01025373,1,2,19,141,1398,1561
E01025385,0,0,6,39,1205,1250
E01025387,0,0,23,120,1177,1320
E01033281,5,2,42,431,2132,2612
E01025377,5,10,9,16,1373,1413
E01025378,2,11,11,32,1444,1500
E01025379,2,0,6,43,1355,1406
E01025380,1,2,6,22,1455,1486
E01025357,0,4,9,26,1281,1320
E01025358,0,3,10,23,2164,2200
E01025365,0,1,22,39,1434,1496
E01025384,2,4,7,44,1190,1247
E01025359,3,1,12,20,1598,1634
E01025360,1,5,15,12,1919,1952
E01025375,0,1,7,18,1646,1672
E01025376,1,3,24,28,2186,2242
E01025370,1,2,9,14,1177,1203
E01025371,2,1,13,36,1348,1400
E01025374,0,5,18,22,1432,1477
E01025388,1,1,8,30,1425,1465
E01025389,0,1,21,16,1194,1232
E01025390,1,1,8,12,1070,1092
E01025391,2,0,7,7,1475,1491
E01025392,0,0,6,10,1187,1203
E01025394,3,4,12,35,1464,1518
E01025424,2,1,7,27,1224,1261
E01025425,0,2,13,10,1332,1357
E01025426,0,1,9,43,1192,1245
E01025466,7,4,11,54,1415,1491
E01025413,0,1,22,12,1766,1801
E01025414,0,0,15,4,1552,1571
E01025456,0,0,23,19,1164,1206
E01025458,2,0,14,27,1433,1476
E01025408,1,5,13,42,1386,1447
E01025409,5,10,16,28,1263,1322
E01025410,5,2,5,82,1300,1394
E01025467,3,10,24,62,1914,2013
E01025403,3,11,17,85,1905,2021
E01025457,6,4,8,50,1329,1397
E01025463,2,3,12,8,1352,1377
E01025464,1,5,7,16,1268,1297
E01025465,4,3,15,12,1084,1118
E01025411,4,8,37,72,1933,2054
E01025448,11,7,28,40,1522,1608
E01025449,1,5,12,40,944,1002
E01025450,2,1,19,17,997,1036
E01025412,0,6,15,26,1431,1478
E01025427,0,8,20,21,1389,1438
E01025428,1,3,39,41,1470,1554
E01025429,0,6,29,15,1297,1347
E01025404,3,4,4,4,1194,1209
E01025405,2,8,14,12,1175,1211
E01025406,1,2,7,11,1202,1223
E01025407,0,2,13,45,1890,1950
E01025399,0,4,23,23,1529,1579
E01025400,4,7,19,11,1804,1845
E01025401,6,7,14,22,1423,1472
E01025402,0,9,19,22,1385,1435
E01025442,1,3,27,9,1035,1075
E01025443,0,2,11,13,1345,1371
E01025444,1,2,10,11,1292,1316
E01025461,2,3,36,47,1853,1941
E01025462,0,8,28,19,1674,1729
E01025439,3,1,12,9,1363,1388
E01025453,0,5,31,31,1598,1665
E01025454,1,7,14,8,1249,1279
E01025455,2,2,11,21,1422,1458
E01025436,2,8,12,15,2240,2277
E01025437,0,3,13,12,1762,1790
E01025438,1,2,5,2,1309,1319
E01025440,4,2,3,4,1399,1412
E01025441,0,1,8,6,1393,1408
E01025417,0,1,18,17,1388,1424
E01025418,0,3,10,7,1379,1399
E01025419,0,4,20,14,1560,1598
E01025420,0,4,29,35,2688,2756
E01025421,11,7,44,43,2202,2307
E01025422,6,5,17,10,1302,1340
E01025431,2,8,20,39,1675,1744
E01025433,4,0,19,27,1770,1820
E01025416,0,3,4,2,1540,1549
E01025451,0,0,15,6,1955,1976
E01025452,5,1,17,17,1663,1703
E01025415,6,2,21,10,2012,2051
E01025423,3,1,13,18,1318,1353
E01025435,3,2,15,16,1481,1517
E01025446,0,0,9,7,1501,1517
E01025430,3,3,21,16,1953,1996
E01025434,2,5,7,9,1939,1962
E01032928,8,4,27,44,1846,1929
E01032929,2,1,12,11,1058,1084
E01025445,4,3,28,10,1398,1443
E01025447,1,3,19,17,1156,1196
E01025459,1,6,4,5,1662,1678
E01025460,2,4,21,22,2003,2052
E01025496,9,1,8,4,1182,1204
E01025497,1,0,11,2,1534,1548
E01025498,0,0,8,7,1274,1289
E01025530,5,1,4,2,1425,1437
E01025532,0,1,7,13,1513,1534
E01025533,4,0,14,16,1537,1571
E01025507,3,3,17,19,1483,1525
E01025508,3,2,10,5,1403,1423
E01025509,1,0,6,5,1186,1198
E01025513,1,3,12,9,2024,2049
E01025531,0,0,9,7,1094,1110
E01025474,0,0,10,6,1110,1126
E01025495,0,2,15,10,2030,2057
E01025514,2,0,33,22,2206,2263
E01025515,1,0,7,5,1589,1602
E01025483,4,3,8,10,2183,2208
E01025484,1,6,7,25,1925,1964
E01025485,0,2,12,24,1662,1700
E01025486,7,5,11,9,1632,1664
E01025487,3,0,7,11,1625,1646
E01025510,1,0,10,29,1325,1365
E01025511,2,0,8,5,1132,1147
E01025512,1,1,9,2,1259,1272
E01025538,4,0,7,19,1501,1531
E01025539,2,2,5,1,1345,1355
E01025499,0,2,8,14,1335,1359
E01025501,1,2,5,6,1099,1113
E01025502,1,4,8,7,1600,1620
E01025516,4,1,11,22,1464,1502
E01025517,1,2,11,18,1506,1538
E01025519,1,1,11,15,1221,1249
E01025488,11,7,15,52,1876,1961
E01025489,8,5,7,13,1304,1337
E01025490,0,15,25,29,1735,1804
E01025500,0,6,18,13,1388,1425
E01025518,0,3,18,12,1401,1434
E01025479,3,5,8,14,1958,1988
E01025491,1,14,14,39,1550,1618
E01025506,0,0,12,22,1936,1970
E01025468,0,1,14,3,1696,1714
E01025469,1,2,13,18,1533,1567
E01025470,3,2,11,26,1460,1502
E01025522,0,1,4,15,1124,1144
E01025471,1,3,17,4,1502,1527
E01025480,0,2,20,5,1416,1443
E01025481,0,4,9,17,1421,1451
E01025482,0,2,18,6,1430,1456
E01025520,0,5,11,4,1210,1230
E01025521,0,8,12,5,1662,1687
E01025523,4,0,9,6,1634,1653
E01025524,0,0,20,21,1443,1484
E01025525,3,0,19,7,1596,1625
E01025526,1,1,16,8,1670,1696
E01025472,0,3,17,28,1376,1424
E01025473,0,5,5,5,1439,1454
E01025475,1,0,10,15,1441,1467
E01025476,1,1,8,7,1301,1318
E01025477,1,2,6,5,1200,1214
E01025478,0,5,1,28,1157,1191
E01025492,0,0,14,11,1261,1286
E01025527,2,0,13,15,1360,1390
E01025528,5,2,23,7,1730,1767
E01025529,5,2,11,19,1786,1823
E01025493,0,9,23,14,1589,1635
E01025494,3,5,19,8,1511,1546
E01025503,1,4,28,15,1321,1369
E01025504,1,1,16,13,1084,1115
E01025505,2,2,12,5,1404,1425
E01025534,2,0,8,4,1736,1750
E01025535,3,0,10,7,1397,1417
E01025536,3,0,11,14,1496,1524
E01025537,0,0,5,1,1478,1484
E01025540,0,3,7,4,1187,1201
E01025573,0,1,11,3,1374,1389
E01025574,0,0,9,23,1501,1533
E01025581,1,2,8,16,1364,1391
E01025582,2,0,10,21,1222,1255
E01025583,2,1,12,18,1256,1289
E01025584,8,6,22,95,1352,1483
E01025605,1,0,8,4,1419,1432
E01025606,0,0,2,5,1251,1258
E01025607,0,2,7,6,1558,1573
E01025608,1,0,9,10,1623,1643
E01025590,0,2,7,6,1561,1576
E01025591,0,0,11,12,1529,1552
E01025592,0,0,4,13,1477,1494
E01025593,4,5,9,209,1532,1759
E01025563,1,1,4,1,1127,1134
E01025564,2,0,8,13,1587,1610
E01025565,1,0,3,6,1476,1486
E01025586,0,1,6,3,1558,1568
E01025587,0,1,6,3,1500,1510
E01025588,3,0,6,15,1348,1372
E01025589,4,0,7,16,1214,1241
E01025557,2,1,4,8,1536,1551
E01025575,1,0,8,0,1080,1089
E01025578,1,1,4,2,1525,1533
E01025579,0,0,9,6,1379,1394
E01025580,3,4,5,13,1271,1296
E01025547,0,1,21,17,1895,1934
E01025549,0,6,22,17,2103,2148
E01025609,3,2,13,12,2005,2035
E01025548,1,0,8,2,1511,1522
E01025553,1,6,9,12,2566,2594
E01025558,3,0,10,14,1680,1707
E01025559,7,0,12,25,1790,1834
E01025560,1,5,11,7,1287,1311
E01025554,0,0,6,6,1502,1514
E01025556,3,5,10,15,1483,1516
E01025570,0,6,13,15,1228,1262
E01025571,2,2,13,23,1373,1413
E01025572,0,2,7,10,1331,1350
E01025604,0,1,15,12,1476,1504
E01025561,3,1,9,12,1446,1471
E01025562,2,5,11,9,2083,2110
E01025585,4,4,9,1,2275,2293
E01025542,0,3,14,13,1648,1678
E01025555,1,1,3,6,1348,1359
E01025601,0,0,3,9,1383,1395
E01025602,2,3,8,15,1522,1550
E01025603,0,1,5,8,1488,1502
E01025541,4,0,8,5,1678,1695
E01025543,0,1,12,9,1741,1763
E01025544,0,1,8,9,1522,1540
E01025576,1,6,26,17,2277,2327
E01025577,1,2,17,6,1406,1432
E01025550,1,1,18,7,1459,1486
E01025552,3,2,6,9,1263,1283
E01025594,0,0,7,7,1503,1517
E01025595,2,1,3,1,1435,1442
E01025596,1,4,9,3,2040,2057
E01025597,4,2,12,4,1074,1096
E01025545,8,5,17,12,1836,1878
E01025546,3,2,12,14,1454,1485
E01025551,1,4,10,7,1270,1292
E01025567,1,5,8,14,1492,1520
E01025598,6,2,12,3,1429,1452
E01025566,1,1,13,26,1945,1986
E01025568,0,2,8,16,1691,1717
E01025569,2,4,11,10,1819,1846
E01025599,0,2,8,11,970,991
E01025600,1,1,8,16,1505,1531
E01006448,1,2,30,2,1642,1677
E01006492,0,3,22,5,1328,1358
E01006493,0,3,17,1,1094,1115
E01006494,0,3,20,12,1394,1429
E01006495,0,3,30,14,1825,1872
E01006454,1,1,9,3,1208,1222
E01006456,0,1,12,3,1579,1595
E01006457,0,0,8,5,1175,1188
E01006458,1,6,17,8,1381,1413
E01006490,5,15,47,16,2674,2757
E01006491,0,7,23,4,1936,1970
E01006415,3,10,30,20,2038,2101
E01006417,0,0,14,3,1293,1310
E01006436,0,0,20,6,1440,1466
E01006437,0,4,26,1,1338,1369
E01006447,1,3,18,9,1326,1357
E01006455,1,18,16,5,1654,1694
E01006506,1,1,15,19,1315,1351
E01006507,1,7,25,4,1391,1428
E01006508,1,2,12,2,1377,1394
E01006509,5,6,10,10,1609,1640
E01006510,6,14,16,15,1148,1199
E01006416,2,0,27,1,1421,1451
E01006418,0,0,17,1,1339,1357
E01006434,0,6,14,0,1501,1521
E01006435,0,1,17,1,1537,1556
E01006438,5,3,11,25,1156,1200
E01006439,1,5,16,4,1587,1613
E01006446,2,1,6,7,1348,1364
E01006412,8,9,25,9,1406,1457
E01006413,1,12,21,6,1379,1419
E01006414,5,6,18,8,1329,1366
E01006441,2,28,52,15,2305,2402
E01006460,5,0,29,24,1518,1576
E01006461,0,5,23,40,1522,1590
E01006463,1,6,22,29,1810,1868
E01006464,2,2,11,9,1593,1617
E01006466,3,4,12,14,1516,1549
E01006453,0,5,17,9,1192,1223
E01006467,0,4,11,14,1246,1275
E01006470,0,6,12,5,1352,1375
E01033228,2,1,22,6,1876,1907
E01006459,2,14,20,64,1512,1612
E01006462,2,3,23,12,1474,1514
E01006496,0,4,8,26,1339,1377
E01006498,2,5,25,45,1497,1574
E01006499,15,9,12,109,1446,1591
E01006440,1,2,23,4,1424,1454
E01006442,0,8,3,1,1260,1272
E01006443,4,3,24,3,1361,1395
E01006444,2,6,23,17,1335,1383
E01006445,0,2,20,8,1299,1329
E01006465,5,13,31,80,1557,1686
E01006482,5,0,17,10,1498,1530
E01006483,0,1,11,8,1321,1341
E01006484,1,3,18,21,1333,1376
E01006449,12,1,30,5,1456,1504
E01006450,4,0,14,7,1397,1422
E01006451,0,0,23,9,1449,1481
E01006452,1,8,18,13,1488,1528
E01006497,0,3,1,18,1051,1073
E01006500,0,3,8,4,1094,1109
E01006501,0,3,22,19,1387,1431
E01006504,2,4,37,15,1318,1376
E01006505,0,2,32,19,1697,1750
E01006472,2,2,14,2,1545,1565
E01006485,1,8,23,15,1497,1544
E01006486,0,1,7,7,1157,1172
E01006487,6,6,21,14,1482,1529
E01006488,3,1,37,13,1699,1753
E01006489,2,1,12,5,1414,1434
E01006477,0,2,19,5,1360,1386
E01006478,0,2,9,3,1347,1361
E01006479,2,7,13,5,1368,1395
E01006480,1,5,11,14,1338,1369
E01006481,0,0,14,2,1330,1346
E01006471,0,2,10,5,1470,1487
E01006473,0,10,7,3,1228,1248
E01006474,0,7,20,2,1454,1483
E01006475,7,1,7,3,1508,1526
E01006476,1,1,12,17,1397,1428
E01006420,3,4,26,59,1974,2066
E01006424,5,11,12,26,2016,2070
E01006502,0,3,15,20,1701,1739
E01006503,3,8,13,1,1218,1243
E01006421,2,8,12,34,1154,1210
E01006425,2,5,26,51,1278,1362
E01006430,0,5,20,13,1294,1332
E01006433,9,6,29,20,1375,1439
E01006419,5,14,19,24,1430,1492
E01006422,9,2,20,3,1235,1269
E01006423,3,4,16,14,1389,1426
E01006427,9,13,15,18,1395,1450
E01006426,1,4,38,11,1176,1230
E01006428,10,9,38,30,1424,1511
E01006429,0,7,44,6,1074,1131
E01006431,3,15,36,22,1596,1672
E01006432,1,21,35,25,1444,1526
E01006651,5,12,22,39,1564,1642
E01006653,0,1,12,53,1454,1520
E01006655,28,23,19,115,1573,1758
E01006658,10,6,13,23,1248,1300
E01006660,10,13,11,121,1278,1433
E01006652,10,0,6,51,1438,1505
E01006656,3,2,4,5,1479,1493
E01006657,4,3,14,21,1169,1211
E01006780,3,5,16,11,1430,1465
E01006783,1,4,14,26,1503,1548
E01006781,1,0,5,13,1451,1470
E01006782,10,6,20,30,1494,1560
E01006784,10,5,18,10,1304,1347
E01006785,7,29,19,18,1696,1769
E01006786,10,2,9,6,1793,1820
E01006661,1,47,15,23,1577,1663
E01006662,2,29,16,68,1660,1775
E01006663,3,9,6,27,1108,1153
E01006664,4,37,26,60,1668,1795
E01006669,22,26,19,74,1329,1470
E01006654,0,2,11,53,1447,1513
E01006659,5,41,27,62,1630,1765
E01006734,14,21,20,15,1342,1412
E01006735,0,19,14,34,1242,1309
E01006736,2,27,18,13,1400,1460
E01006737,3,22,19,6,1385,1435
E01006787,43,71,41,80,2095,2330
E01006788,6,10,16,31,1762,1825
E01006790,13,21,22,6,1525,1587
E01006791,23,40,12,20,1579,1674
E01006665,1,7,22,36,1489,1555
E01006666,15,21,21,80,1367,1504
E01006667,8,7,28,30,1380,1453
E01006668,13,6,25,40,1450,1534
E01006670,2,6,17,70,1431,1526
E01006607,4,2,12,1,1512,1531
E01006612,5,13,15,4,1458,1495
E01006729,2,29,10,6,1353,1400
E01032510,13,14,24,40,1718,1809
E01032511,2,13,19,10,1334,1378
E01006608,0,5,1,6,1203,1215
E01006609,12,5,11,19,1236,1283
E01006610,6,12,20,16,1343,1397
E01006613,2,1,13,6,1338,1360
E01006705,9,24,10,18,1348,1409
E01006598,4,12,5,14,1326,1361
E01006599,1,18,8,15,1079,1121
E01006672,11,22,31,36,1855,1955
E01033759,9,41,15,16,1066,1147
E01006600,5,0,15,3,1384,1407
E01006603,1,11,18,14,1366,1410
E01006730,4,13,22,14,1273,1326
E01006731,3,16,6,23,1148,1196
E01006732,12,17,18,20,1576,1643
E01006611,0,19,9,12,1251,1291
E01006614,5,6,10,21,1280,1322
E01006615,1,3,15,23,1260,1302
E01006698,4,7,16,17,1672,1716
E01006700,12,17,11,37,1361,1438
E01006623,7,6,12,82,1355,1462
E01006624,1,32,14,56,1453,1556
E01006627,4,14,15,16,1329,1378
E01006671,0,24,24,95,1212,1355
E01006699,5,23,7,5,1554,1594
E01006701,17,10,18,24,1311,1380
E01006702,18,27,22,45,1506,1618
E01006703,7,34,18,22,1480,1561
E01006778,9,72,46,50,2028,2205
E01006541,6,2,15,11,1559,1593
E01006543,0,4,11,2,1230,1247
E01006544,1,7,24,21,1605,1658
E01006616,12,6,12,5,1393,1428
E01006762,18,4,15,30,1625,1692
E01006604,1,9,6,9,1342,1367
E01006605,1,7,14,18,1491,1531
E01006618,7,2,20,1,1609,1639
E01006625,0,2,7,19,1388,1416
E01006626,6,6,12,23,1401,1448
E01006637,12,69,20,71,1424,1596
E01006638,7,30,24,45,1113,1219
E01006639,1,11,17,44,1436,1509
E01006644,4,29,39,40,1928,2040
E01006645,0,20,17,12,1375,1424
E01006542,7,10,16,6,1358,1397
E01006558,4,12,24,35,1282,1357
E01006562,11,40,34,38,1391,1514
E01033747,49,37,22,28,907,1043
E01006545,4,5,22,26,1455,1512
E01006546,8,28,10,18,1255,1319
E01006547,31,39,24,47,1349,1490
E01006548,22,65,23,49,1516,1675
E01006766,14,62,30,42,1118,1266
E01006767,17,77,34,40,1619,1787
E01006606,2,13,12,13,1481,1521
E01006761,12,14,37,80,1501,1644
E01006763,6,12,16,16,1421,1471
E01006764,24,43,38,50,1367,1522
E01006765,5,6,19,15,1423,1468
E01006768,32,26,31,47,1223,1359
E01006617,10,3,11,22,1375,1421
E01006619,17,9,7,10,1556,1599
E01006620,7,10,7,13,1380,1417
E01006621,20,9,6,50,1383,1468
E01006622,0,0,10,8,1501,1519
E01006640,22,10,23,59,1766,1880
E01006776,3,21,17,24,1612,1677
E01006779,26,9,34,8,1891,1968
E01033764,28,55,19,37,2063,2202
E01006560,15,52,30,32,1731,1860
E01006564,6,16,24,52,1623,1721
E01006646,43,42,47,84,1683,1899
E01006648,49,33,59,94,1940,2175
E01006540,64,68,52,43,1282,1509
E01006563,22,51,51,41,1579,1744
E01006647,9,30,35,13,1335,1422
E01006693,29,34,27,85,1336,1511
E01006572,1,15,20,17,1154,1207
E01006574,6,14,37,22,1309,1388
E01006641,12,23,20,257,1428,1740
E01006642,1,14,16,31,1228,1290
E01006643,7,31,42,48,1694,1822
E01006567,11,13,18,42,1571,1655
E01006568,4,22,25,19,1547,1617
E01006570,2,7,19,29,1422,1479
E01006571,1,26,6,10,1427,1470
E01006711,37,39,39,54,1369,1538
E01006717,25,17,31,23,1340,1436
E01006718,23,17,33,26,1488,1587
E01006719,6,1,23,15,1490,1535
E01032508,23,35,54,86,1525,1723
E01032509,4,18,36,31,1345,1434
E01006690,35,126,63,77,1191,1492
E01006692,60,140,70,94,1816,2180
E01006695,70,240,71,73,1367,1821
E01006759,27,41,30,21,976,1095
E01006760,71,66,41,44,1389,1611
E01006565,5,0,25,55,1464,1549
E01006569,5,12,24,4,1384,1429
E01006573,4,14,20,52,1411,1501
E01006712,8,1,32,58,1240,1339
E01006713,3,7,19,49,1299,1377
E01006691,82,219,66,133,1003,1503
E01006694,26,388,66,96,1288,1864
E01006696,25,180,54,199,1286,1744
E01006697,87,212,80,145,1321,1845
E01006746,14,66,43,158,1232,1513
E01006512,283,120,92,661,724,1880
E01006747,77,182,90,982,2221,3552
E01006748,50,71,52,285,1478,1936
E01006751,157,188,155,536,1536,2572
E01033763,51,86,53,120,1217,1527
E01006566,4,32,30,35,1405,1506
E01006585,10,25,23,45,1251,1354
E01006586,19,31,89,78,1682,1899
E01006587,41,10,73,67,1433,1624
E01006716,36,25,58,83,1387,1589
E01006575,10,11,33,32,1208,1294
E01006576,10,5,18,27,1633,1693
E01006577,3,17,31,32,1420,1503
E01006579,22,2,53,44,1522,1643
E01006584,2,10,9,13,1359,1393
E01006720,169,226,156,223,1334,2108
E01006725,23,50,70,68,1326,1537
E01006726,39,109,86,131,1200,1565
E01006727,11,45,57,52,1276,1441
E01006728,35,60,86,91,1351,1623
E01006752,56,96,56,150,654,1012
E01006578,1,8,12,44,1315,1380
E01006580,3,5,11,69,1247,1335
E01006581,1,15,18,38,1487,1559
E01006773,6,7,23,21,1322,1379
E01006774,4,22,26,136,1257,1445
E01006514,51,98,124,196,1639,2108
E01006515,70,48,106,177,807,1208
E01006673,249,382,271,238,797,1937
E01033757,33,75,86,213,618,1025
E01033768,71,122,139,69,822,1223
E01006550,19,43,76,92,1365,1595
E01006557,37,83,86,172,1676,2054
E01006721,73,79,103,92,1308,1655
E01006722,76,101,71,221,1324,1793
E01006723,38,104,100,164,1469,1875
E01006724,24,72,71,121,1502,1790
E01006552,520,306,201,174,828,2029
E01006556,307,360,183,235,926,2011
E01006674,450,476,199,143,617,1885
E01006679,487,760,265,197,523,2232
E01006709,0,3,32,13,1390,1438
E01006769,18,10,29,5,1208,1270
E01006770,3,6,30,15,948,1002
E01006771,3,11,25,16,1370,1425
E01006772,1,14,13,29,1034,1091
E01006775,2,9,34,23,1251,1319
E01006582,6,14,21,50,1551,1642
E01006589,6,15,62,57,1378,1518
E01006591,21,34,55,53,1470,1633
E01006592,4,17,39,30,1475,1565
E01006597,14,11,42,43,1557,1667
E01006553,24,44,100,96,1616,1880
E01006588,24,22,44,42,1437,1569
E01006590,10,19,42,48,1523,1642
E01006593,11,26,68,40,1396,1541
E01033749,35,37,35,72,974,1153
E01033766,19,20,45,22,969,1075
E01006520,40,48,69,45,1504,1706
E01006549,97,139,103,86,1237,1662
E01006675,114,171,122,132,1285,1824
E01006677,132,173,144,85,506,1040
E01006518,57,109,94,69,1367,1696
E01006630,48,73,59,41,1117,1338
E01006632,74,53,45,45,1625,1842
E01006676,205,320,186,210,832,1753
E01006678,136,144,160,62,1625,2127
E01006706,1,16,20,18,1291,1346
E01006707,2,16,31,12,1262,1323
E01006708,2,19,33,6,1745,1805
E01006710,0,15,20,8,1453,1496
E01006792,19,8,22,22,1297,1368
E01006794,12,13,28,67,1473,1593
E01006800,6,12,22,77,1284,1401
E01006801,1,2,16,37,1299,1355
E01006532,17,7,21,102,1410,1557
E01006539,13,15,25,61,1323,1437
E01006583,15,17,15,35,1676,1758
E01006594,30,5,28,94,1253,1410
E01006796,44,6,21,113,1407,1591
E01006522,35,47,122,56,1471,1731
E01006524,19,33,48,168,2163,2431
E01006526,17,18,39,22,1308,1404
E01006529,22,8,24,24,1226,1304
E01006551,14,65,73,83,1346,1581
E01006554,35,28,74,90,1465,1692
E01006525,10,8,27,35,1129,1209
E01006595,6,25,39,50,1625,1745
E01006596,24,9,43,85,1290,1451
E01006689,8,25,36,25,1557,1651
E01006633,11,8,26,11,1376,1432
E01032505,23,10,37,70,1177,1317
E01032506,17,13,58,39,1276,1403
E01032507,10,20,54,18,1437,1539
E01033748,28,40,28,82,1099,1277
E01033767,27,18,34,25,963,1067
E01006793,19,6,34,47,1388,1494
E01006795,4,1,27,33,1342,1407
E01006797,7,12,27,8,1445,1499
E01006798,1,7,19,43,1340,1410
E01006799,13,5,27,25,1751,1821
E01006521,40,47,52,52,1469,1660
E01006523,28,47,63,36,1334,1508
E01006528,18,53,44,58,1288,1461
E01006628,12,60,90,101,1611,1874
E01006629,7,29,37,38,1144,1255
E01006527,16,9,52,19,1358,1454
E01006680,2,3,20,67,1477,1569
E01006682,0,7,16,23,1264,1310
E01006683,16,9,37,27,1421,1510
E01006686,4,10,31,26,1362,1433
E01006534,20,24,42,105,1351,1542
E01006535,4,13,47,23,1552,1639
E01006536,15,17,50,34,1732,1848
E01006681,7,10,37,85,1446,1585
E01006530,4,3,18,22,1384,1431
E01006531,0,22,13,11,1412,1458
E01006533,4,1,18,65,1320,1408
E01006537,7,13,51,85,2101,2257
E01006538,1,3,18,13,1283,1318
E01006519,8,6,15,24,1233,1286
E01006684,3,6,46,70,2013,2138
E01006685,1,11,29,26,1417,1484
E01006687,7,68,52,93,1732,1952
E01006688,4,15,31,21,1453,1524
E01006740,34,11,11,35,1189,1280
E01006742,10,7,26,7,1344,1394
E01006744,8,4,37,15,1418,1482
E01006745,1,16,72,48,1742,1879
E01006738,1,14,10,5,1471,1501
E01006739,7,36,47,24,1655,1769
E01006741,1,17,28,5,1764,1815
E01006743,12,38,40,65,2020,2175
E01006753,0,19,34,8,1496,1557
E01006754,1,21,32,0,1573,1627
E01006755,10,42,45,18,1472,1587
E01006756,4,47,42,30,1697,1820
E01006757,6,12,34,11,1428,1491
E01006758,5,32,39,16,1435,1527
E01006513,114,64,77,546,2140,2941
E01033758,88,40,38,581,983,1730
E01033760,45,66,52,342,1610,2115
E01033761,76,30,46,123,1097,1372
E01033762,65,48,31,158,1489,1791
E01033750,57,48,46,115,1182,1448
E01033754,41,48,81,99,1183,1452
E01033756,91,38,26,153,877,1185
E01033765,30,27,54,42,1198,1351
E01033751,36,59,41,183,1554,1873
E01033752,72,24,28,92,980,1196
E01033753,82,29,30,81,829,1051
E01033755,42,24,29,90,897,1082
E01006946,2,1,9,3,1382,1397
E01007028,3,4,10,6,1332,1355
E01007029,0,0,8,6,1234,1248
E01007030,0,8,14,4,1513,1539
E01007036,2,0,8,11,1191,1212
E01006947,6,0,16,22,1383,1427
E01007031,0,2,20,8,1416,1446
E01007032,3,6,22,9,1284,1324
E01007033,5,1,11,3,1471,1491
E01007035,4,0,12,9,1429,1454
E01006944,8,5,22,14,1623,1672
E01006948,0,10,27,15,1263,1315
E01006949,0,3,8,5,1440,1456
E01006951,6,8,17,39,1419,1489
E01007034,5,0,7,11,1333,1356
E01006945,7,10,38,26,1524,1605
E01006950,9,13,34,29,1431,1516
E01006968,34,19,56,68,1595,1772
E01006969,3,13,21,48,1382,1467
E01033094,29,15,23,25,896,988
E01033097,16,13,28,34,959,1050
E01007055,0,15,24,21,1424,1484
E01007056,7,9,18,21,1561,1616
E01007057,2,0,17,12,1497,1528
E01007062,0,8,10,22,1394,1434
E01007063,0,0,15,11,1554,1580
E01007058,0,1,7,33,1396,1437
E01007059,5,2,15,26,1468,1516
E01007060,12,5,19,14,1425,1475
E01007061,0,6,20,8,1460,1494
E01007064,3,3,24,5,1253,1288
E01006934,4,0,14,25,1486,1529
E01006970,7,5,34,66,1518,1630
E01006994,28,13,21,35,1523,1620
E01006996,9,7,25,51,1523,1615
E01006998,5,10,36,34,1579,1664
E01006995,6,11,24,31,1262,1334
E01006997,9,0,18,29,1455,1511
E01006999,6,7,31,86,1491,1621
E01007000,1,6,23,24,1236,1290
E01007001,24,21,19,5,1549,1618
E01007002,7,19,19,40,1245,1330
E01006928,3,6,9,17,1431,1466
E01006935,10,6,19,12,1647,1694
E01006971,9,2,8,25,1553,1597
E01006972,7,11,17,2,1588,1625
E01006973,3,4,31,56,1522,1616
E01006974,2,0,16,13,1557,1588
E01006929,3,4,16,11,1518,1552
E01006930,0,2,30,10,1418,1460
E01006931,5,4,22,8,1494,1533
E01006932,3,4,12,9,1477,1505
E01006933,11,5,12,9,1413,1450
E01006920,0,0,20,18,1586,1624
E01006924,3,3,15,14,1423,1458
E01006925,1,2,27,14,1488,1532
E01006927,1,3,13,11,1649,1677
E01006921,0,0,9,10,1286,1305
E01006922,0,3,7,11,1398,1419
E01006923,1,0,7,13,1451,1472
E01006926,4,6,3,18,1584,1615
E01006985,3,2,9,11,1432,1457
E01006986,2,3,11,9,1256,1281
E01006987,2,7,16,24,1204,1253
E01006989,1,3,4,4,1325,1337
E01006990,1,4,9,1,1221,1236
E01006988,1,0,4,3,1364,1372
E01007079,0,1,17,13,1555,1586
E01007080,4,4,13,10,1407,1438
E01007081,1,1,5,5,1479,1491
E01006991,1,1,10,4,1480,1496
E01006992,2,1,9,6,1107,1125
E01006993,1,6,19,14,1458,1498
E01007078,0,2,14,18,1511,1545
E01007075,0,6,6,9,1349,1370
E01007076,1,5,8,6,1394,1414
E01007077,5,4,20,31,1452,1512
E01007082,0,1,20,4,1409,1434
E01007067,1,11,17,12,1352,1393
E01007068,0,1,11,12,1248,1272
E01007069,1,1,5,1,1437,1445
E01007070,1,0,16,9,1445,1471
E01007101,1,0,4,18,1417,1440
E01007095,0,0,7,2,1574,1583
E01007096,0,1,1,5,1325,1332
E01007100,2,5,4,11,1369,1391
E01033096,1,8,24,13,2485,2531
E01007074,3,3,13,19,1468,1506
E01007097,1,0,8,14,1506,1529
E01007098,0,4,14,6,1394,1418
E01007099,1,4,19,8,1479,1511
E01007065,0,1,6,4,1327,1338
E01007066,1,1,6,17,1535,1560
E01007071,0,0,2,3,1251,1256
E01007072,3,3,5,9,1420,1440
E01007073,0,1,1,1,1333,1336
E01007020,1,1,18,7,1392,1419
E01007022,0,1,15,13,1391,1420
E01007023,3,3,4,13,1322,1345
E01007027,3,1,16,15,2028,2063
E01007037,0,0,6,5,1495,1506
E01007038,2,2,13,17,1454,1488
E01006936,13,5,25,56,1403,1502
E01006937,0,2,7,8,1289,1306
E01006938,8,13,17,53,1146,1237
E01006939,3,0,8,13,1455,1479
E01006940,2,5,27,35,1365,1434
E01006943,5,2,2,9,1211,1229
E01007083,0,1,12,5,1169,1187
E01007085,1,4,15,2,1331,1353
E01007086,0,3,9,1,1261,1274
E01007091,0,1,3,1,1280,1285
E01007092,1,0,5,6,1094,1106
E01006979,4,15,19,6,1409,1453
E01006980,4,4,24,13,1428,1473
E01007024,1,0,11,5,1157,1174
E01007026,5,3,11,5,1121,1145
E01007089,2,7,8,6,1355,1378
E01007021,0,1,7,5,1291,1304
E01007025,1,2,10,15,1311,1339
E01007105,1,6,21,2,1598,1628
E01007106,2,1,10,6,1458,1477
E01007107,1,0,7,3,1346,1357
E01007108,1,9,19,16,1526,1571
E01007039,0,0,13,12,1243,1268
E01007040,3,10,28,9,2175,2225
E01007042,1,5,6,0,1263,1275
E01007044,0,1,3,1,1362,1367
E01007045,0,1,7,5,1223,1236
E01007041,0,4,6,6,1387,1403
E01007043,0,1,14,2,1391,1408
E01007046,1,1,5,17,1569,1593
E01007053,0,7,9,8,1384,1408
E01007084,2,2,5,3,1373,1385
E01006941,4,0,27,20,1581,1632
E01006942,2,2,13,3,1441,1461
E01006954,4,0,17,14,1466,1501
E01007104,4,3,19,11,1359,1396
E01007109,2,4,31,14,1480,1531
E01007048,5,10,12,12,1581,1620
E01007054,0,6,21,5,1364,1396
E01007087,0,1,15,0,1303,1319
E01007088,0,2,7,12,1272,1293
E01007090,1,1,7,2,1132,1143
E01006955,1,19,25,22,1583,1650
E01006956,5,6,22,19,1516,1568
E01006958,10,5,44,21,1380,1460
E01007102,3,4,18,22,1466,1513
E01007103,2,0,13,8,1454,1477
E01006978,0,4,18,15,1360,1397
E01006981,5,0,7,7,1467,1486
E01006982,0,3,7,14,1358,1382
E01006983,1,1,21,3,1625,1651
E01006984,6,5,31,8,1301,1351
E01006952,24,7,8,13,1318,1370
E01006953,26,5,19,24,1364,1438
E01006957,3,5,24,27,1470,1529
E01006959,3,9,19,23,1498,1552
E01006977,14,3,19,7,1596,1639
E01006976,0,0,9,11,1434,1454
E01007014,0,0,8,5,1575,1588
E01007047,0,2,9,6,1422,1439
E01033095,0,0,9,6,1830,1845
E01007004,1,8,18,15,1373,1415
E01007005,5,5,31,10,1266,1317
E01007011,1,4,30,4,1415,1454
E01007016,0,8,24,9,1761,1802
E01007017,1,7,19,3,1511,1541
E01007019,6,0,16,22,1332,1376
E01007049,0,4,11,7,1504,1526
E01007050,0,0,4,3,1342,1349
E01007051,5,0,13,10,1185,1213
E01007052,2,0,10,5,1369,1386
E01006964,5,3,20,37,1404,1469
E01007003,0,1,16,6,1199,1222
E01007006,2,7,14,11,1393,1427
E01007012,2,3,11,10,1292,1318
E01007013,17,4,15,12,1383,1431
E01006967,2,8,11,10,1480,1511
E01007007,13,1,10,22,1186,1232
E01007008,47,7,10,32,1165,1261
E01007009,7,1,28,13,1251,1300
E01007010,7,10,9,18,1047,1091
E01006960,0,0,10,6,1145,1161
E01006961,2,15,14,19,1512,1562
E01006962,1,1,7,16,1381,1406
E01006963,7,27,12,37,1413,1496
E01006965,1,0,12,5,1460,1478
E01006966,0,2,7,8,1470,1487
E01006882,1,2,2,6,1177,1188
E01006883,0,0,11,12,1282,1305
E01006884,1,1,6,7,1338,1353
E01006885,7,3,7,6,1255,1278
E01006886,2,1,5,2,1301,1311
E01006887,1,1,3,10,1329,1344
E01006802,3,1,8,12,1629,1653
E01006804,0,0,18,1,1594,1613
E01006806,1,2,9,6,1526,1544
E01006807,2,1,4,8,1354,1369
E01006803,4,1,6,10,1425,1446
E01006805,2,2,9,10,1516,1539
E01006808,1,0,5,1,1293,1300
E01006809,0,2,10,0,1456,1468
E01006849,1,0,3,9,1431,1444
E01006850,2,0,8,9,1500,1519
E01006851,1,0,5,7,1261,1274
E01006852,0,0,5,0,1314,1319
E01006853,2,1,1,5,1333,1342
E01006854,5,2,9,1,1441,1458
E01006855,2,2,13,14,1428,1459
E01006836,0,4,2,12,1399,1417
E01006839,1,3,4,11,1322,1341
E01006840,0,4,1,20,1477,1502
E01006842,4,5,2,12,1554,1577
E01006837,1,4,6,9,1531,1551
E01006838,6,0,4,17,1417,1444
E01006841,2,4,10,0,1665,1681
E01006843,1,0,2,1,1191,1195
E01006914,0,2,5,9,1208,1224
E01006915,3,2,5,4,1562,1576
E01006916,1,1,12,14,1530,1558
E01006917,0,0,2,15,1649,1666
E01006918,0,0,5,5,1244,1254
E01006919,0,1,7,6,1531,1545
E01006810,1,0,1,5,1272,1279
E01006811,3,0,4,9,1345,1361
E01006812,10,0,6,31,1369,1416
E01006813,1,3,12,17,1457,1490
E01006814,1,0,3,14,1536,1554
E01006815,2,0,10,10,1277,1299
E01006818,0,0,3,3,1277,1283
E01006822,2,1,7,8,1364,1382
E01006823,1,4,6,1,1252,1264
E01006824,1,0,2,5,1238,1246
E01006825,1,2,3,5,1452,1463
E01006866,5,1,13,10,1517,1546
E01006867,13,5,17,39,2001,2075
E01006868,0,0,25,35,1437,1497
E01006869,1,8,13,13,1439,1474
E01006819,1,1,9,4,1492,1507
E01006820,0,3,9,3,1440,1455
E01006821,0,1,7,6,1403,1417
E01006871,1,8,14,14,1510,1547
E01006832,2,7,9,7,1621,1646
E01006834,1,2,10,6,1217,1236
E01006877,1,0,12,4,1407,1424
E01006880,6,3,8,10,1413,1440
E01006881,6,2,11,16,1406,1441
E01006863,1,2,10,30,1588,1631
E01006864,2,2,19,23,1820,1866
E01006865,1,3,12,13,1709,1738
E01006845,0,3,5,13,1487,1508
E01006870,2,2,14,52,1300,1370
E01006872,3,4,14,41,1381,1443
E01006873,0,2,4,33,1254,1293
E01006874,3,1,10,9,1181,1204
E01006856,2,9,15,18,1302,1346
E01006857,1,0,16,6,1401,1424
E01006858,4,4,13,16,1449,1486
E01006859,1,6,18,23,1596,1644
E01006860,1,0,10,13,1367,1391
E01006861,1,3,35,23,1533,1595
E01006862,2,1,15,13,1289,1320
E01006831,1,5,13,9,1436,1464
E01006833,4,3,13,13,1582,1615
E01006835,1,1,5,8,1394,1409
E01006876,0,1,10,13,1453,1477
E01006878,2,0,5,3,1336,1346
E01006879,1,6,10,17,1478,1512
E01006904,4,2,13,17,1650,1686
E01006816,0,7,15,11,1661,1694
E01006817,1,1,20,17,1291,1330
E01006875,1,0,10,12,1269,1292
E01006899,5,1,13,30,1997,2046
E01006826,0,1,12,11,1314,1338
E01006827,3,0,25,40,1526,1594
E01006828,2,7,14,35,2088,2146
E01006829,2,3,10,27,1204,1246
E01006830,0,1,9,9,1325,1344
E01006903,1,3,12,7,1498,1521
E01006905,0,0,5,8,1325,1338
E01006906,9,7,22,15,1428,1481
E01006907,7,2,13,18,1530,1570
E01006912,5,1,11,36,1455,1508
E01006913,0,1,9,16,1291,1317
E01032904,10,14,30,119,1707,1880
E01032905,2,2,13,59,1494,1570
E01006844,1,1,19,1,1581,1603
E01006846,0,0,6,4,1418,1428
E01006847,1,3,20,23,1678,1725
E01006848,2,1,8,7,1385,1403
E01006896,1,0,7,2,1513,1523
E01006897,0,1,11,8,1449,1469
E01006901,0,1,7,6,1295,1309
E01006890,2,1,11,13,1432,1459
E01006892,1,0,11,7,1189,1208
E01006893,7,4,7,31,1333,1382
E01006894,2,0,6,16,1327,1351
E01006898,2,1,10,4,1601,1618
E01006900,2,10,17,22,2661,2712
E01006908,1,2,6,9,1321,1339
E01006909,3,2,19,3,1298,1325
E01006910,0,5,11,12,1683,1711
E01006911,0,0,5,1,1502,1508
E01006888,1,0,9,28,1179,1217
E01006889,2,2,15,50,1375,1444
E01006891,7,0,8,37,1339,1391
E01006895,3,0,16,58,1324,1401
E01007229,3,5,31,18,1608,1665
E01007230,3,2,20,9,1205,1239
E01007231,0,4,23,12,1539,1578
E01007237,1,2,13,32,1468,1516
E01007238,0,4,26,21,1498,1549
E01007218,0,4,14,21,1453,1492
E01007232,4,10,26,20,1462,1522
E01007233,3,4,24,22,1795,1848
E01007234,6,10,45,28,1488,1577
E01007236,7,0,12,13,1370,1402
E01007307,1,6,25,25,1696,1753
E01007308,1,3,19,7,1459,1489
E01007312,0,6,12,21,1452,1491
E01007313,0,0,10,35,1508,1553
E01007315,3,0,16,9,1515,1543
E01007211,0,3,7,14,1159,1183
E01007235,0,0,12,4,1509,1525
E01007310,0,7,22,10,1349,1388
E01007311,3,1,16,8,1445,1473
E01007314,1,10,12,12,1454,1489
E01007316,0,1,8,8,1518,1535
E01007215,7,9,28,13,1539,1596
E01007216,1,7,21,9,1512,1550
E01007219,2,5,10,22,1519,1558
E01007220,1,8,17,42,1191,1259
E01007275,0,2,32,18,1510,1562
E01007203,3,10,24,14,1971,2022
E01007205,0,5,15,3,1518,1541
E01007210,0,7,16,32,1900,1955
E01007309,3,0,9,12,1522,1546
E01007212,3,3,17,17,1428,1468
E01007213,0,0,9,25,1519,1553
E01007214,0,3,10,37,1457,1507
E01007217,0,7,25,18,1532,1582
E01007276,0,6,23,22,1499,1550
E01007272,1,3,17,17,1449,1487
E01007273,13,8,11,11,1267,1310
E01007274,0,1,13,15,1339,1368
E01007277,2,0,25,37,1395,1459
E01007278,5,12,21,35,1403,1476
E01007204,1,1,24,18,1612,1656
E01007206,6,2,17,65,1778,1868
E01007207,3,2,18,20,1308,1351
E01007209,0,2,17,25,1249,1293
E01007269,3,13,37,23,1740,1816
E01007270,9,1,16,35,1628,1689
E01007271,6,8,28,24,1604,1670
E01032903,1,7,41,23,2379,2451
E01007120,1,6,37,22,1328,1394
E01007121,1,4,13,15,1442,1475
E01007122,1,6,20,14,1340,1381
E01007123,1,2,31,40,1674,1748
E01007124,1,1,11,2,1497,1512
E01007208,0,0,9,14,1704,1727
E01007221,0,1,9,19,1443,1472
E01007225,1,1,12,25,1765,1804
E01007227,0,1,13,9,1484,1507
E01007228,2,4,9,21,1363,1399
E01007195,3,0,10,5,1606,1624
E01007199,1,0,1,7,1538,1547
E01007222,5,2,13,19,1569,1608
E01007223,7,7,7,27,1346,1394
E01007193,0,2,23,32,1611,1668
E01007194,6,1,13,41,1434,1495
E01007200,0,3,16,9,1704,1732
E01007201,0,2,14,13,1431,1460
E01007202,12,6,12,5,1348,1383
E01007125,2,5,16,37,1623,1683
E01007156,3,2,14,24,1482,1525
E01007157,2,8,9,6,1513,1538
E01007158,0,5,12,29,1471,1517
E01007159,7,3,53,107,1676,1846
E01007126,7,6,29,33,1783,1858
E01007127,1,3,19,41,1501,1565
E01007128,3,13,28,182,1425,1651
E01007129,3,3,29,25,1503,1563
E01007133,2,1,15,7,1061,1086
E01007224,3,4,3,20,1446,1476
E01007226,0,0,13,10,1576,1599
E01007265,1,2,9,11,1342,1365
E01007299,0,1,6,2,1335,1344
E01007306,2,5,12,7,1586,1612
E01007297,2,1,4,21,1408,1436
E01007298,1,0,11,22,1495,1529
E01007301,1,9,8,37,1577,1632
E01007302,2,0,7,58,1368,1435
E01007305,4,1,10,25,1591,1631
E01007119,1,3,23,42,1358,1427
E01007161,0,1,20,28,1489,1538
E01007162,1,0,23,26,1453,1503
E01007300,10,2,19,58,1825,1914
E01007155,15,3,17,43,1752,1830
E01007160,4,2,18,28,1652,1704
E01007240,6,3,20,20,1531,1580
E01007241,0,0,19,65,1388,1472
E01007242,2,2,22,35,1601,1662
E01007130,5,3,16,341,1409,1774
E01007131,4,1,19,36,1535,1595
E01007179,0,6,9,24,1253,1292
E01007291,3,8,20,82,1557,1670
E01007292,6,9,25,36,1396,1472
E01007294,2,4,13,33,1429,1481
E01007180,7,4,18,23,1500,1552
E01007181,0,5,19,28,1441,1493
E01007239,6,1,25,31,1691,1754
E01007243,1,3,16,6,1578,1604
E01007244,3,20,27,32,1995,2077
E01007259,1,1,19,11,1176,1208
E01007261,0,5,2,10,1347,1364
E01007264,3,0,13,47,1349,1412
E01007266,7,1,19,12,1499,1538
E01007267,9,0,11,17,1417,1454
E01007268,3,1,8,10,1295,1317
E01007163,1,0,21,115,2210,2347
E01007245,2,1,14,23,1499,1539
E01007246,0,4,21,45,1483,1553
E01007247,1,1,14,43,1697,1756
E01007252,0,5,5,18,1520,1548
E01007249,2,6,18,37,1295,1358
E01007251,3,12,16,45,1093,1169
E01007257,5,2,14,20,1258,1299
E01007303,2,2,5,15,1414,1438
E01007304,0,5,18,19,1527,1569
E01007196,7,4,34,10,1562,1617
E01007197,5,2,16,19,1651,1693
E01007198,4,5,29,23,1642,1703
E01007263,6,1,11,4,1393,1415
E01007282,10,3,29,14,1362,1418
E01007175,2,3,28,34,1779,1846
E01007290,1,7,12,40,1683,1743
E01007293,1,6,17,33,1426,1483
E01007295,1,9,16,28,1131,1185
E01007296,4,1,21,33,1654,1713
E01007258,4,1,16,19,1414,1454
E01007260,15,0,14,15,1517,1561
E01007262,3,1,15,41,1439,1499
E01007281,5,1,19,31,1277,1333
E01007283,4,2,36,19,1205,1266
E01007173,2,4,12,22,1512,1552
E01007174,1,0,9,28,1524,1562
E01007176,2,7,14,31,1558,1612
E01007177,0,0,22,35,1450,1507
E01007178,3,2,31,29,1491,1556
E01007248,2,3,22,46,1462,1535
E01007250,3,3,13,4,1392,1415
E01007253,6,1,13,42,1490,1552
E01007254,10,0,13,30,1471,1524
E01007115,2,0,13,20,1559,1594
E01007138,0,3,21,8,1601,1633
E01007139,6,0,17,23,1506,1552
E01007141,3,1,15,19,1555,1593
E01007289,2,0,11,26,1560,1599
E01007111,0,2,9,12,1552,1575
E01007112,1,5,19,13,1497,1535
E01007113,0,3,10,22,1341,1376
E01007114,8,5,23,37,1457,1530
E01007116,1,2,12,28,1509,1552
E01007280,1,2,7,12,1720,1742
E01007284,2,5,8,7,1601,1623
E01007285,1,7,13,8,1460,1489
E01007287,1,1,10,6,1819,1837
E01007183,2,1,20,10,1252,1285
E01007255,0,2,11,11,1478,1502
E01007256,2,1,7,28,1543,1581
E01007279,1,0,15,25,1639,1680
E01007286,1,1,9,16,1410,1437
E01007110,0,2,10,18,1571,1601
E01007117,0,6,9,8,1674,1697
E01007118,3,5,11,22,1517,1558
E01007151,2,2,17,11,1538,1570
E01007154,1,11,14,30,1489,1545
E01007140,1,4,16,26,1645,1692
E01007142,5,6,22,26,1753,1812
E01007143,2,3,9,16,1642,1672
E01007152,1,2,16,19,1615,1653
E01007153,1,5,6,9,1492,1513
E01007182,2,5,7,9,1499,1522
E01007184,0,0,16,11,1482,1509
E01007185,2,2,23,24,1543,1594
E01007192,2,2,8,24,1270,1306
E01007288,1,1,18,14,1553,1587
E01007144,3,2,15,12,1351,1383
E01007145,3,0,3,28,1284,1318
E01007146,19,1,13,11,1522,1566
E01007147,3,18,13,17,1351,1402
E01007148,3,0,2,7,1648,1660
E01007135,3,0,12,12,1545,1572
E01007136,0,6,5,4,1666,1681
E01007137,0,5,13,14,1611,1643
E01007170,0,3,9,19,1501,1532
E01007186,0,6,13,38,1533,1590
E01007187,1,1,12,7,1443,1464
E01007188,6,0,11,38,1436,1491
E01007189,2,3,14,15,1580,1614
E01007190,4,4,7,24,1446,1485
E01007191,7,3,16,18,1292,1336
E01007149,0,1,6,8,1474,1489
E01007150,0,1,7,11,1461,1480
E01007165,0,2,13,9,1314,1338
E01007171,1,4,5,5,1536,1551
E01007172,0,0,4,14,1420,1438
E01007164,1,1,10,15,1703,1730
E01007166,1,0,10,7,1428,1446
E01007167,5,3,11,6,1467,1492
E01007168,1,4,15,9,1611,1640
E01007169,0,3,13,12,1687,1715
E01012933,0,0,3,1,1036,1040
E01012934,2,1,11,1,1521,1536
E01012938,2,1,7,6,2257,2273
E01012939,1,2,10,7,1800,1820
E01012940,4,1,7,7,1636,1655
E01012941,1,0,2,3,1358,1364
E01012929,0,0,16,16,1920,1952
E01012930,4,0,3,7,1410,1424
E01012935,0,0,14,1,1293,1308
E01012937,0,1,8,14,2138,2161
E01012942,0,0,2,3,1221,1226
E01012928,0,1,18,12,1649,1680
E01012931,0,2,10,10,1558,1580
E01012932,2,0,13,13,1609,1637
E01012946,1,5,23,12,1576,1617
E01012949,1,2,8,25,1354,1390
E01012936,1,4,3,3,1348,1359
E01012943,0,8,11,5,1604,1628
E01012945,0,8,18,13,1562,1601
E01012952,2,7,8,2,1425,1444
E01012944,0,6,26,12,1404,1448
E01012947,1,2,11,14,1396,1424
E01012948,0,2,12,17,1378,1409
E01012951,0,2,8,9,1362,1381
E01012950,1,1,4,12,1424,1442
E01012990,0,0,4,5,1370,1379
E01012991,1,0,6,6,1567,1580
E01012992,0,0,10,1,1479,1490
E01012978,0,0,4,2,1412,1418
E01012981,1,0,3,1,1401,1406
E01012983,1,2,19,8,1765,1795
E01012989,0,0,5,1,1725,1731
E01013125,1,1,9,1,1712,1724
E01013057,0,2,15,7,1479,1503
E01013059,2,3,13,4,1598,1620
E01013060,6,3,16,15,1874,1914
E01013061,3,1,19,11,1580,1614
E01013126,8,65,46,65,1970,2154
E01012986,0,0,6,3,1554,1563
E01012987,1,0,9,2,1686,1698
E01012988,0,2,4,8,1508,1522
E01013048,0,2,3,2,2052,2059
E01013052,0,1,3,14,1522,1540
E01013053,2,3,4,3,1367,1379
E01013054,0,8,23,48,1978,2057
E01013055,0,0,9,16,1498,1523
E01013056,2,2,18,7,1595,1624
E01013058,6,3,5,1,1313,1328
E01013119,2,0,4,7,1479,1492
E01013046,4,0,10,1,1625,1640
E01013047,2,4,10,8,1577,1601
E01013049,3,4,5,14,1577,1603
E01013050,1,1,4,4,1666,1676
E01013051,2,0,14,2,1561,1579
E01012922,0,1,6,12,1471,1490
E01012923,1,11,6,48,1552,1618
E01012925,0,1,1,8,1319,1329
E01012927,1,1,5,18,1546,1571
E01012924,4,0,13,12,1702,1731
E01012926,1,3,5,20,2404,2433
E01013027,0,1,20,8,1599,1628
E01013034,0,1,6,4,1790,1801
E01013120,1,3,6,12,1935,1957
E01013121,1,6,14,7,1998,2026
E01013123,4,7,4,7,1530,1552
E01013124,4,2,14,14,2017,2051
E01013064,2,0,18,18,1454,1492
E01013065,1,1,10,10,1622,1644
E01013066,3,0,6,11,1601,1621
E01013067,6,1,13,34,1678,1732
E01013068,3,0,9,6,1401,1419
E01013070,1,0,10,18,1505,1534
E01013038,0,2,11,9,1532,1554
E01013045,2,1,14,14,1541,1572
E01013069,0,1,9,18,1535,1563
E01013071,2,6,26,14,1571,1619
E01013022,2,1,13,1,1867,1884
E01013023,2,2,5,4,1825,1838
E01013024,1,0,11,1,1819,1832
E01013122,0,1,3,2,1481,1487
E01013127,3,0,7,6,1484,1500
E01013036,3,8,28,27,1464,1530
E01013037,0,1,7,9,1464,1481
E01013040,3,6,20,33,1960,2022
E01013041,1,7,12,4,1535,1559
E01013062,2,1,17,36,1634,1690
E01013063,0,0,5,4,1505,1514
E01012919,2,1,11,12,1501,1527
E01012921,3,1,11,4,1130,1149
E01013039,1,2,15,18,1699,1735
E01013042,8,10,16,32,1632,1698
E01013043,8,7,17,28,1408,1468
E01013044,1,1,16,19,1584,1621
E01013029,1,0,1,6,1460,1468
E01013030,0,0,2,5,1486,1493
E01013031,4,1,10,4,1493,1512
E01013032,1,2,7,3,1431,1444
E01013035,2,0,5,0,1317,1324
E01012954,19,4,11,48,1159,1241
E01012956,4,10,11,14,1203,1242
E01012958,0,1,3,27,1016,1047
E01012961,2,2,22,29,1461,1516
E01012966,1,3,7,14,1259,1284
E01012953,5,2,15,24,1030,1076
E01012955,11,3,12,13,1499,1538
E01012959,0,11,5,8,1439,1463
E01012962,11,1,10,13,1115,1150
E01012964,3,3,14,16,1644,1680
E01012920,0,0,4,9,1459,1472
E01012965,0,2,7,19,987,1015
E01012967,0,1,16,31,1521,1569
E01012968,0,4,17,28,1668,1717
E01012969,4,24,41,53,1722,1844
E01012957,13,30,52,61,2430,2586
E01012960,17,6,14,16,1600,1653
E01012963,1,0,11,26,1419,1457
E01013112,8,4,8,18,1386,1424
E01013018,0,0,10,4,1841,1855
E01013019,1,4,10,7,1152,1174
E01013021,4,0,7,11,1474,1496
E01013025,0,0,8,6,1334,1348
E01013026,0,1,6,4,1650,1661
E01013105,1,12,12,11,1403,1439
E01013110,20,1,10,17,1526,1574
E01013111,4,1,16,10,1433,1464
E01013115,4,2,23,20,1484,1533
E01013117,1,9,26,27,1477,1540
E01013108,8,2,16,31,1484,1541
E01013113,0,3,9,18,1492,1522
E01013114,4,5,7,29,1457,1502
E01013116,0,0,11,43,1489,1543
E01013118,2,2,10,32,1430,1476
E01013094,0,1,6,2,1403,1412
E01013095,0,2,8,6,1547,1563
E01013096,1,2,10,11,1650,1674
E01013097,0,1,7,3,1426,1437
E01013102,1,0,4,7,1413,1425
E01013028,0,2,5,10,1541,1558
E01013078,0,0,3,1,1419,1423
E01013081,8,0,8,6,1463,1485
E01013082,0,3,3,7,1574,1587
E01013085,2,4,9,8,1631,1654
E01012970,6,5,12,22,1415,1460
E01012972,2,6,5,15,1516,1544
E01012973,18,15,17,75,2670,2795
E01012974,9,4,5,31,1483,1532
E01013092,8,1,15,47,1956,2027
E01033495,6,18,15,54,1299,1392
E01033496,2,3,20,29,1668,1722
E01013033,1,4,2,8,1593,1608
E01013098,1,5,15,9,2199,2229
E01013099,0,0,6,1,1334,1341
E01013100,0,0,5,1,1691,1697
E01013101,1,1,5,5,1683,1695
E01013008,1,0,11,7,1482,1501
E01013009,10,3,6,15,1488,1522
E01013013,0,1,12,17,1498,1528
E01013014,4,2,19,17,1479,1521
E01013107,5,1,16,8,1504,1534
E01013088,4,10,21,42,1580,1657
E01013089,4,6,16,40,1608,1674
E01013090,0,3,11,19,1381,1414
E01013091,2,6,19,46,1539,1612
E01013093,12,1,9,53,1412,1487
E01013005,7,2,9,30,1424,1472
E01013007,5,0,14,35,1514,1568
E01013011,4,0,6,21,1481,1512
E01013012,10,8,11,84,1260,1373
E01012996,0,1,2,13,1563,1579
E01012998,5,2,16,14,2152,2189
E01013015,3,0,12,15,1540,1570
E01013016,0,0,1,11,1644,1656
E01013003,1,2,14,5,1425,1447
E01013017,0,2,5,6,1626,1639
E01013020,1,0,12,5,1782,1800
E01013076,0,1,9,1,1482,1493
E01013079,2,1,6,5,1502,1516
E01013080,1,2,11,5,1346,1365
E01013083,0,2,7,19,1455,1483
E01013084,1,2,4,0,1432,1439
E01013086,2,1,12,6,1555,1576
E01013087,0,1,8,6,1350,1365
E01012993,1,2,13,9,1385,1410
E01012997,15,1,16,19,1804,1855
E01012999,15,9,34,45,1637,1740
E01013001,1,0,6,4,1790,1801
E01013074,1,0,7,5,1620,1633
E01012994,0,2,14,10,1729,1755
E01012995,0,0,12,8,1903,1923
E01013000,8,3,20,16,1773,1820
E01013002,2,2,17,9,1589,1619
E01013004,1,3,17,5,1646,1672
E01013072,0,0,9,4,1685,1698
E01013073,2,0,4,6,1580,1592
E01013075,0,1,9,1,1311,1322
E01013077,0,0,7,1,1979,1987
E01013006,4,2,14,15,1497,1532
E01013010,1,2,21,11,1436,1471
E01013103,0,0,3,3,1413,1419
E01013104,0,0,12,0,1231,1243
E01013106,3,0,11,11,1173,1198
E01032596,2,3,19,6,1390,1420
E01012975,0,2,2,5,1500,1509
E01012977,1,0,17,13,2566,2597
E01012984,0,1,3,8,1667,1679
E01012985,2,1,4,3,1682,1692
E01012976,1,3,6,7,1440,1457
E01012979,5,0,8,7,1488,1508
E01012980,5,6,20,11,1813,1855
E01012982,6,1,10,7,1630,1654
E01012779,0,14,7,2,1260,1283
E01012780,3,5,12,3,1537,1560
E01012781,0,7,8,2,1224,1241
E01012832,11,10,6,10,1356,1393
E01033105,16,9,23,19,1381,1448
E01033106,6,23,13,11,1102,1155
E01033107,17,20,26,52,1200,1315
E01033108,20,14,16,10,1391,1451
E01012782,8,8,12,2,1411,1441
E01012785,0,7,9,2,1310,1328
E01012786,1,3,8,5,1205,1222
E01012787,4,4,15,1,1493,1517
E01012788,0,2,25,3,1442,1472
E01012789,2,5,4,4,1328,1343
E01012875,8,25,28,15,1419,1495
E01012876,11,55,37,10,1593,1706
E01012877,6,29,28,11,1360,1434
E01012878,12,20,11,11,1520,1574
E01012879,7,5,31,13,1375,1431
E01012778,1,2,18,0,1459,1480
E01012783,0,1,6,6,1204,1217
E01012784,6,5,12,8,2077,2108
E01012790,5,3,4,2,1307,1321
E01012906,2,2,10,3,1594,1611
E01012908,0,0,9,0,1180,1189
E01012764,3,3,4,18,1137,1165
E01012765,4,1,16,14,1468,1503
E01012768,8,9,13,10,1319,1359
E01012769,4,11,14,11,1294,1334
E01012829,0,8,8,8,1569,1593
E01012830,2,13,18,9,1428,1470
E01012905,0,2,10,2,1325,1339
E01012910,0,7,1,3,1287,1298
E01012912,0,10,15,12,1800,1837
E01012822,2,2,8,7,1487,1506
E01012904,0,3,4,11,1442,1460
E01012907,1,7,3,2,1385,1398
E01012909,1,3,3,4,1292,1303
E01012911,1,4,7,6,1196,1214
E01012873,9,16,25,22,1470,1542
E01012874,3,31,16,20,1510,1580
E01012880,7,42,22,9,1640,1720
E01012881,2,43,14,15,1446,1520
E01012915,18,40,40,21,1364,1483
E01012917,22,37,28,37,1497,1621
E01012918,11,26,14,47,1454,1552
E01012833,5,7,20,3,1459,1494
E01012835,0,1,3,4,1146,1154
E01012836,1,4,8,6,1488,1507
E01012839,2,6,6,27,1256,1297
E01012840,0,6,8,11,1465,1490
E01012824,3,8,10,11,1653,1685
E01012825,6,2,25,10,1456,1499
E01012834,8,7,13,6,1579,1613
E01012837,2,7,12,10,1625,1656
E01012838,0,6,23,6,1475,1510
E01012821,0,6,8,8,1197,1219
E01012823,1,9,13,6,1427,1456
E01012826,1,4,10,5,1490,1510
E01012827,3,4,5,14,1465,1491
E01012828,7,1,8,14,1509,1539
E01012766,5,5,12,28,1383,1433
E01012767,19,29,34,70,1557,1709
E01012914,55,168,63,431,1433,2150
E01012916,47,42,24,158,1287,1558
E01012812,0,1,9,10,1429,1449
E01012813,8,0,6,9,1754,1777
E01012814,0,1,9,9,1521,1540
E01012815,4,4,3,7,1580,1598
E01012818,5,1,7,0,1237,1250
E01012791,13,2,15,25,1617,1672
E01012792,4,3,25,23,1535,1590
E01012793,18,30,15,57,1363,1483
E01012794,11,15,12,22,1528,1588
E01012913,84,57,44,77,1717,1979
E01012761,40,79,33,155,1450,1757
E01012868,29,64,37,204,1415,1749
E01012869,29,47,37,191,1470,1774
E01012871,37,51,30,115,1596,1829
E01012872,31,79,44,205,1493,1852
E01012804,3,2,16,11,1435,1467
E01012806,2,14,17,18,1410,1461
E01012807,0,3,10,15,1349,1377
E01012817,1,6,13,21,1329,1370
E01012819,2,0,6,14,1413,1435
E01012841,4,11,23,10,1555,1603
E01012844,3,0,9,7,1314,1333
E01012849,1,6,13,4,1472,1496
E01012895,1,4,14,9,1473,1501
E01012897,7,8,22,5,1509,1551
E01012898,11,1,4,6,1358,1380
E01012758,10,21,40,62,1455,1588
E01012762,7,11,37,69,1451,1575
E01012763,51,46,83,227,1657,2064
E01012866,30,34,26,133,1353,1576
E01012870,35,60,44,234,1310,1683
E01012774,1,7,22,21,1498,1549
E01012795,7,22,17,24,1867,1937
E01012797,6,9,9,4,1358,1386
E01012798,0,16,6,6,1515,1543
E01012801,7,0,13,7,1429,1456
E01012816,0,7,22,9,1353,1391
E01012848,9,22,23,35,1739,1828
E01012894,0,10,8,7,1537,1562
E01012896,8,16,24,21,2033,2102
E01012901,9,3,12,7,1451,1482
E01012842,0,3,14,8,1498,1523
E01012843,2,7,20,9,1505,1543
E01012845,1,5,16,19,1531,1572
E01012846,0,3,12,7,1415,1437
E01012847,0,4,11,6,1277,1298
E01012820,2,7,15,5,1401,1430
E01012899,2,10,9,4,1505,1530
E01012900,16,15,17,21,1577,1646
E01012902,0,7,5,13,1561,1586
E01012903,1,30,22,23,1648,1724
E01012796,3,2,7,7,1291,1310
E01012799,0,4,8,4,1237,1253
E01012800,4,1,7,4,1483,1499
E01012802,1,0,16,8,1378,1403
E01012803,3,0,9,6,1422,1440
E01012850,81,113,78,145,1500,1917
E01012852,52,57,72,164,1348,1693
E01012856,21,46,45,75,1412,1599
E01012857,21,39,47,130,1370,1607
E01012867,51,70,59,70,1398,1648
E01012756,16,11,34,29,1442,1532
E01012757,21,21,37,107,1365,1551
E01012759,13,14,31,55,1536,1649
E01012760,18,17,35,96,1344,1510
E01012862,17,2,16,34,1270,1339
E01012805,5,15,10,29,1310,1369
E01012808,8,20,15,50,1586,1679
E01012809,25,28,34,75,1641,1803
E01012810,31,38,31,117,1676,1893
E01012811,55,15,40,159,1407,1676
E01012773,0,9,14,16,1664,1703
E01012776,1,2,7,11,1432,1453
E01012863,15,11,28,60,1335,1449
E01012864,14,32,33,62,1547,1688
E01012865,20,19,16,76,1268,1399
E01012770,2,0,6,10,1481,1499
E01012771,1,8,13,23,1491,1536
E01012772,1,5,10,36,1414,1466
E01012775,0,3,15,5,1429,1452
E01012777,2,1,13,19,1427,1462
E01012851,128,76,101,168,1860,2333
E01012854,146,117,101,190,1590,2144
E01012855,84,61,60,148,1421,1774
E01033104,61,36,30,60,1127,1314
E01033109,58,38,42,104,1064,1306
E01012859,27,13,26,80,1352,1498
E01012889,21,6,34,23,1307,1391
E01012891,56,81,71,175,1798,2181
E01012892,14,49,50,31,1784,1928
E01012893,13,23,25,48,1404,1513
E01012858,12,18,29,25,1672,1756
E01012860,10,16,17,34,1545,1622
E01012886,2,10,18,31,1523,1584
E01012888,13,23,18,37,1398,1489
E01033110,26,22,20,16,1418,1502
E01012882,4,4,5,2,1602,1617
E01012883,2,5,10,28,1442,1487
E01012884,3,7,20,22,1787,1839
E01012887,13,4,13,16,1414,1460
E01032595,8,2,12,20,1775,1817
E01013174,3,0,9,3,1447,1462
E01013175,6,4,9,7,1354,1380
E01013176,6,5,8,11,1373,1403
E01013177,5,1,16,16,1550,1588
E01013178,1,2,6,0,1463,1472
E01013179,0,2,4,2,1508,1516
E01013180,1,3,7,16,1425,1452
E01013136,13,12,22,25,1412,1484
E01013137,22,9,21,45,1379,1476
E01013139,3,6,9,5,1194,1217
E01013142,10,7,13,30,1657,1717
E01013218,6,4,21,25,1351,1407
E01013219,4,3,15,17,1368,1407
E01013220,1,9,22,22,1582,1636
E01013221,5,2,17,25,1695,1744
E01013222,4,6,27,54,1469,1560
E01013144,6,0,12,7,1438,1463
E01013145,1,1,11,5,1284,1302
E01013146,7,1,22,11,1701,1742
E01013148,2,0,1,3,1433,1439
E01013195,1,3,20,12,1412,1448
E01013196,7,2,9,3,1394,1415
E01013201,1,8,17,28,1486,1540
E01013202,6,1,25,7,1504,1543
E01013203,7,1,16,9,1620,1653
E01013138,10,3,11,24,1334,1382
E01013140,8,5,19,15,1508,1555
E01013141,0,3,16,7,1602,1628
E01013143,4,2,2,10,1358,1376
E01013173,1,5,5,3,1220,1234
E01013223,5,11,16,79,2829,2940
E01013224,0,2,16,26,1839,1883
E01013226,1,1,13,17,1499,1531
E01013187,4,5,9,56,1331,1405
E01013188,4,1,7,17,1539,1568
E01013231,5,7,12,7,1604,1635
E01013233,2,1,4,8,1429,1444
E01013147,0,6,13,7,1380,1406
E01013234,0,4,9,9,1421,1443
E01033414,5,3,16,22,2251,2297
E01013128,3,1,10,65,1370,1449
E01013198,6,1,13,12,1407,1439
E01013199,8,9,8,4,1158,1187
E01013200,3,1,12,1,1262,1279
E01013159,0,8,14,19,1448,1489
E01013161,4,5,6,12,1402,1429
E01013162,3,8,14,31,1552,1608
E01013165,7,6,11,34,1288,1346
E01013158,2,1,12,8,1442,1465
E01013160,1,2,6,9,1465,1483
E01013163,1,0,9,5,1309,1324
E01013164,6,0,15,26,1822,1869
E01013197,2,5,5,15,1258,1285
E01013149,1,5,4,8,1134,1152
E01013150,4,3,5,11,1301,1324
E01013227,2,8,14,5,1589,1618
E01013228,2,2,19,24,1526,1573
E01013229,3,5,15,9,1462,1494
E01013131,2,6,12,23,1486,1529
E01013132,3,3,8,11,1440,1465
E01013133,1,2,14,29,1484,1530
E01013134,5,1,4,10,1430,1450
E01013206,0,2,5,2,1342,1351
E01013207,1,1,6,20,1317,1345
E01013211,3,2,11,16,1480,1512
E01013212,5,1,8,10,1372,1396
E01013181,4,7,14,41,1475,1541
E01013182,4,0,10,70,1448,1532
E01013183,2,0,14,12,1532,1560
E01013184,9,18,36,34,1476,1573
E01013185,19,20,31,166,1380,1616
E01013186,6,2,8,31,1331,1378
E01013129,18,8,18,90,1399,1533
E01013151,4,0,4,5,1249,1262
E01013152,4,1,11,6,1483,1505
E01013155,3,0,11,9,1370,1393
E01013130,1,3,6,10,1355,1375
E01013135,2,1,7,5,1424,1439
E01013154,0,2,3,3,1388,1396
E01013156,0,0,3,6,1241,1250
E01013204,3,14,7,17,1374,1415
E01013205,3,5,17,8,1329,1362
E01013208,3,1,4,4,1406,1418
E01013209,2,1,8,5,1467,1483
E01013210,2,0,17,3,1424,1446
E01013153,3,0,8,12,1309,1332
E01013157,5,8,9,8,1834,1864
E01013166,2,1,9,9,1568,1589
E01013167,1,9,5,11,1761,1787
E01013169,0,0,5,6,1038,1049
E01013189,1,3,7,19,1450,1480
E01013190,27,17,29,130,2619,2822
E01013191,6,3,8,29,1538,1584
E01013192,4,1,7,18,1455,1485
E01013194,3,0,10,15,1433,1461
E01013168,16,8,8,57,1569,1658
E01013170,2,4,6,7,1489,1508
E01013171,15,13,13,58,1677,1776
E01013172,12,1,9,18,1441,1481
E01013193,0,0,1,8,1567,1576
E01013213,7,3,3,6,1206,1225
E01013214,4,3,4,14,1416,1441
E01013215,17,9,13,27,1542,1608
E01013216,0,0,2,12,1287,1301
E01013217,0,0,7,5,1430,1442
E01013225,0,6,7,21,1052,1086
E01013254,1,1,3,5,1696,1706
E01013255,3,1,10,13,1651,1678
E01013256,5,3,21,11,2439,2479
E01013257,0,1,11,11,1765,1788
E01013258,0,0,8,10,1681,1699
E01013259,0,5,15,11,1685,1716
E01013303,2,2,11,6,1271,1292
E01013304,0,4,17,3,1590,1614
E01013305,1,1,2,6,1626,1636
E01013307,1,5,12,7,1715,1740
E01013288,1,1,10,16,1551,1579
E01013291,2,2,14,1,1576,1595
E01013292,0,0,3,3,1719,1725
E01013294,0,1,8,5,1538,1552
E01013270,0,4,15,17,1893,1929
E01013306,1,0,5,8,1530,1544
E01013308,6,2,8,16,1710,1742
E01013309,2,1,4,28,1551,1586
E01013286,2,1,27,41,2258,2329
E01013287,1,0,12,16,1458,1487
E01013289,3,12,14,76,1559,1664
E01013290,2,0,14,16,1630,1662
E01013293,1,0,15,15,1518,1549
E01013245,1,6,5,17,1459,1488
E01013246,0,0,7,11,1512,1530
E01013247,0,1,11,7,1737,1756
E01013248,0,1,5,29,1744,1779
E01013249,1,3,9,5,1717,1735
E01013297,1,19,24,100,2049,2193
E01013300,13,23,39,404,1228,1707
E01013302,6,25,9,146,1279,1465
E01013331,7,20,14,91,1541,1673
E01013296,28,31,31,263,1302,1655
E01013298,25,47,20,88,1425,1605
E01013299,9,16,19,50,1546,1640
E01013330,40,34,33,291,1347,1745
E01013332,23,28,42,583,1201,1877
E01013295,4,1,3,47,1330,1385
E01013301,14,6,20,99,1477,1616
E01013333,24,13,17,545,1032,1631
E01013334,3,5,14,112,1422,1556
E01013310,0,0,6,46,1429,1481
E01013312,7,10,9,64,1708,1798
E01013313,10,0,20,42,1482,1554
E01013314,8,4,7,23,1474,1516
E01013267,0,0,11,8,1234,1253
E01013268,0,1,8,4,1249,1262
E01013269,1,2,10,15,1724,1752
E01013271,4,7,12,22,1878,1923
E01013272,5,1,8,45,1616,1675
E01013273,7,0,9,12,1717,1745
E01013279,3,1,16,22,1432,1474
E01013285,2,0,5,35,1220,1262
E01013316,1,7,8,56,1384,1456
E01013321,3,8,16,27,1630,1684
E01013274,11,7,13,35,2050,2116
E01013275,0,0,15,4,1544,1563
E01013276,4,0,13,7,1604,1628
E01013277,0,3,2,1,1480,1486
E01013315,2,1,5,6,1506,1520
E01013317,1,1,12,34,1359,1407
E01013318,15,3,15,32,1472,1537
E01013319,0,4,25,27,2187,2243
E01013238,2,2,5,36,1632,1677
E01013240,4,8,28,42,2274,2356
E01013311,6,7,24,15,1800,1852
E01013320,0,2,8,36,1448,1494
E01013278,1,2,16,11,1470,1500
E01013280,4,6,8,18,1426,1462
E01013281,0,3,10,12,1350,1375
E01013283,4,0,17,36,1426,1483
E01013236,1,0,10,8,1538,1557
E01013239,4,0,13,37,1569,1623
E01013282,7,4,15,17,1544,1587
E01013284,2,3,19,10,1572,1606
E01013237,0,4,12,28,1758,1802
E01013261,1,0,7,11,1439,1458
E01013262,6,0,7,13,1332,1358
E01013263,5,1,10,7,1411,1434
E01033296,6,11,12,48,1362,1439
E01033297,1,9,19,64,1576,1669
E01013260,1,1,7,16,1452,1477
E01013264,1,8,15,16,1689,1729
E01013265,2,1,9,15,1621,1648
E01013266,3,2,16,31,1882,1934
E01013241,4,1,2,10,1503,1520
E01013242,1,5,14,20,1730,1770
E01013243,8,2,8,24,2105,2147
E01013244,1,0,11,5,1793,1810
E01013324,0,0,7,33,1513,1553
E01013326,12,4,8,6,1556,1586
E01013327,0,1,1,12,1395,1409
E01013328,0,3,15,15,1260,1293
E01013322,0,0,14,11,1915,1940
E01013323,0,2,10,19,1660,1691
E01013325,3,5,9,20,1527,1564
E01013329,1,1,7,7,1803,1819
E01013250,1,2,4,6,1605,1618
E01013251,1,5,4,9,1797,1816
E01013252,1,0,7,22,1731,1761
E01013253,0,3,10,7,1947,1967
E01013436,4,24,18,68,1648,1762
E01013438,6,3,14,12,1755,1790
E01013439,1,8,8,24,1474,1515
E01013440,3,4,11,19,1819,1856
E01013370,0,7,3,29,1462,1501
E01013373,0,8,13,3,1456,1480
E01013375,2,5,6,15,1280,1308
E01013376,2,6,17,7,1435,1467
E01013371,1,1,12,35,1416,1465
E01013372,1,0,6,11,1590,1608
E01013374,1,0,11,10,1535,1557
E01013377,1,0,3,4,1644,1652
E01013404,1,5,10,15,1421,1452
E01013407,0,1,14,12,1414,1441
E01013408,0,0,14,20,1295,1329
E01013410,3,3,10,20,1395,1431
E01013405,8,1,10,14,1371,1404
E01013406,5,8,28,43,1875,1959
E01013409,1,1,3,19,1542,1566
E01013411,1,0,7,15,1503,1526
E01013428,9,9,18,38,1564,1638
E01013429,8,12,32,61,1952,2065
E01013430,1,1,14,11,1522,1549
E01013431,18,10,17,63,1448,1556
E01013435,1,0,10,30,1425,1466
E01013344,5,12,18,50,1512,1597
E01013346,6,8,12,54,1571,1651
E01013432,2,4,24,50,2029,2109
E01013433,2,10,7,38,1404,1461
E01013434,5,1,19,25,1412,1462
E01013379,5,1,16,28,1426,1476
E01013380,13,23,20,123,1592,1771
E01013385,7,5,17,27,1403,1459
E01013387,3,6,6,12,1450,1477
E01013388,0,5,4,7,1017,1033
E01013389,0,7,9,13,1129,1158
E01013437,1,7,8,4,1194,1214
E01013343,26,34,34,147,1764,2005
E01013345,9,19,28,76,1588,1720
E01013347,5,7,21,61,1543,1637
E01013349,4,19,4,37,1323,1387
E01013350,17,23,11,125,1462,1638
E01013348,26,19,31,106,1731,1913
E01013368,14,11,63,125,2033,2246
E01013382,15,7,22,85,1527,1656
E01013383,67,21,50,110,2050,2298
E01013386,2,26,28,115,1601,1772
E01013421,3,10,26,17,1492,1548
E01013422,0,0,13,50,1623,1686
E01013426,1,0,15,9,1644,1669
E01013427,0,3,10,6,1423,1442
E01013335,4,5,17,15,1541,1582
E01013336,4,1,8,6,1451,1470
E01013337,1,2,14,21,1612,1650
E01013338,6,7,22,12,2260,2307
E01013339,3,7,13,15,1557,1595
E01013392,1,4,18,18,1519,1560
E01013366,13,29,31,178,1741,1992
E01013369,19,7,27,87,1723,1863
E01013416,10,14,42,59,1439,1564
E01033067,20,31,32,80,1200,1363
E01033068,16,10,26,134,958,1144
E01033069,12,5,25,51,1065,1158
E01033070,27,23,24,142,1322,1538
E01013381,3,2,17,20,1502,1544
E01013402,13,8,32,136,1569,1758
E01013419,12,2,14,50,1454,1532
E01013420,20,4,22,46,1946,2038
E01013384,7,8,21,85,1628,1749
E01013398,18,15,26,80,1486,1625
E01013399,9,18,27,61,1659,1774
E01013400,31,39,39,200,1627,1936
E01013401,23,24,41,91,1518,1697
E01013403,14,20,33,143,1677,1887
E01013393,6,4,23,16,1550,1599
E01013394,1,2,15,13,1281,1312
E01013395,2,1,10,10,1427,1450
E01013396,3,11,10,33,1587,1644
E01013441,1,9,18,20,1484,1532
E01013445,3,6,18,15,1496,1538
E01013390,12,10,18,41,1492,1573
E01013391,10,53,27,68,2040,2198
E01013397,2,7,17,22,1448,1496
E01013413,17,10,23,40,1586,1676
E01013417,6,7,52,126,1787,1978
E01013442,0,2,11,7,1359,1379
E01013443,3,4,20,29,1480,1536
E01013444,7,4,16,9,1377,1413
E01013446,1,9,19,37,1594,1660
E01013447,3,8,13,22,1453,1499
E01013448,4,25,9,10,1327,1375
E01013360,70,31,39,297,1411,1848
E01013361,13,17,43,126,1695,1894
E01013362,11,17,33,132,1784,1977
E01013363,23,48,26,216,1781,2094
E01013364,24,28,46,149,1784,2031
E01013418,3,16,24,36,1476,1555
E01013351,1,1,4,12,1889,1907
E01013352,1,4,11,7,1697,1720
E01013451,0,0,6,7,1226,1239
E01013452,0,0,12,11,1651,1674
E01013357,3,3,19,17,1982,2024
E01013358,0,2,11,14,1547,1574
E01013412,3,5,25,42,1705,1780
E01013414,12,11,34,39,1565,1661
E01013353,2,15,23,25,1532,1597
E01013354,3,6,11,13,1381,1414
E01013355,6,3,10,22,1435,1476
E01013356,2,3,18,15,1414,1452
E01013359,4,6,13,26,1498,1547
E01013449,3,5,21,24,1626,1679
E01013365,12,7,49,145,2572,2785
E01013378,86,67,144,944,3551,4792
E01013450,4,4,12,15,1205,1240
E01013340,0,5,12,13,1244,1274
E01013341,1,1,15,15,1240,1272
E01013342,0,1,3,9,1347,1360
E01013423,3,4,10,8,1260,1285
E01013424,0,21,14,11,1289,1335
E01013425,0,1,10,4,1538,1553
E01027558,0,2,19,5,1855,1881
E01027559,1,0,10,4,1710,1725
E01027569,0,3,2,2,1327,1334
E01027570,1,0,11,9,2453,2474
E01027562,0,2,5,14,1620,1641
E01027567,1,3,6,2,1599,1611
E01027585,2,0,5,7,1860,1874
E01027568,0,0,6,1,2161,2168
E01027571,2,2,15,40,1870,1929
E01027572,1,3,10,25,1973,2012
E01027573,3,0,7,1,1558,1569
E01027557,1,1,5,6,1660,1673
E01027561,0,1,6,5,1867,1879
E01027576,10,0,7,37,1513,1567
E01027574,1,2,14,15,1426,1458
E01027575,0,0,2,12,1884,1898
E01027577,1,4,23,67,1823,1918
E01027579,0,2,9,27,1094,1132
E01027578,0,6,26,31,1454,1517
E01027580,0,3,13,14,1092,1122
E01027581,4,11,37,469,1979,2500
E01027582,6,7,16,44,1438,1511
E01027556,0,1,9,5,1675,1690
E01027560,1,0,14,13,2327,2355
E01027563,0,0,14,11,1371,1396
E01027586,1,3,13,6,1911,1934
E01027555,0,2,15,13,1917,1947
E01027564,1,0,10,20,1180,1211
E01027565,1,1,8,21,1499,1530
E01027566,0,1,12,21,1205,1239
E01027583,1,1,20,18,2058,2098
E01027584,0,0,6,5,1605,1616
E01027591,0,0,7,6,1656,1669
E01027597,1,4,8,7,1548,1568
E01027599,0,0,8,11,1634,1653
E01027623,0,4,4,7,1282,1297
E01027625,8,1,22,7,1613,1651
E01027598,0,2,6,6,1738,1752
E01027618,3,1,12,3,2402,2421
E01027624,3,0,3,5,1258,1269
E01027626,3,3,8,21,1285,1320
E01027627,6,6,26,6,1776,1820
E01027590,4,1,12,20,2018,2055
E01027592,0,0,6,10,1728,1744
E01027613,7,3,12,5,1737,1764
E01027617,0,0,3,2,1095,1100
E01027605,0,2,17,18,1595,1632
E01027606,1,3,10,21,1487,1522
E01027608,4,3,33,17,1765,1822
E01027609,1,6,16,25,1294,1342
E01027610,4,3,7,34,1637,1685
E01027611,8,7,18,22,1898,1953
E01027612,3,7,12,34,1637,1693
E01027616,0,1,10,8,1415,1434
E01027603,0,10,10,20,1926,1966
E01027604,0,4,2,3,1752,1761
E01027607,0,4,8,10,1215,1237
E01027614,2,4,9,10,1211,1236
E01027615,1,0,16,14,1245,1276
E01027587,1,1,13,1,1342,1358
E01027588,1,3,6,16,1544,1570
E01027589,1,1,4,2,1665,1673
E01027593,0,1,2,1,1724,1728
E01027628,3,2,18,2,1840,1865
E01027633,1,4,9,6,1832,1852
E01033065,2,5,9,6,1177,1199
E01033066,3,18,28,17,2235,2301
E01027620,0,6,5,7,1961,1979
E01027630,3,5,20,26,1686,1740
E01027631,0,1,9,8,1368,1386
E01027632,1,0,7,5,1471,1484
E01027637,2,2,13,3,1843,1863
E01027621,9,6,20,24,2211,2270
E01027629,2,1,9,9,1357,1378
E01027635,23,31,25,39,2486,2604
E01027636,0,2,6,9,2061,2078
E01027594,0,0,8,10,1481,1499
E01027595,2,2,7,7,1602,1620
E01027596,1,0,9,6,1492,1508
E01027601,2,1,11,12,1914,1940
E01027622,1,1,14,4,1899,1919
E01027600,0,3,12,4,1903,1922
E01027619,2,10,9,14,2637,2672
E01027634,5,3,15,10,2057,2090
E01027666,0,2,13,2,1698,1715
E01027667,1,1,4,5,1383,1394
E01027685,4,0,4,2,1195,1205
E01027686,0,2,16,6,1121,1145
E01027712,9,18,29,5,1687,1748
E01027713,11,6,16,16,1637,1686
E01027714,0,16,16,16,1609,1657
E01027715,7,36,17,28,1108,1196
E01027643,18,6,7,3,1415,1449
E01027688,9,0,4,2,1575,1590
E01027736,7,2,9,8,1612,1638
E01027737,2,6,19,10,1804,1841
E01027705,0,9,24,11,1624,1668
E01027706,1,12,26,34,1870,1943
E01027707,0,6,27,10,1708,1751
E01027708,2,5,9,7,1407,1430
E01027709,1,1,3,4,1198,1207
E01027710,2,5,16,2,1095,1120
E01027711,2,7,25,13,1249,1296
E01027644,2,4,9,10,1486,1511
E01027645,0,4,4,17,1568,1593
E01027647,1,3,14,3,1588,1609
E01027687,0,2,6,3,1487,1498
E01027681,3,1,17,10,1576,1607
E01027693,0,4,20,6,1763,1793
E01027701,0,13,21,3,1539,1576
E01027702,0,5,3,4,1130,1142
E01027642,1,1,8,1,1382,1393
E01027646,4,1,11,2,1528,1546
E01027674,1,13,12,3,1369,1398
E01027675,4,6,23,7,2355,2395
E01027641,10,13,11,3,1260,1297
E01027664,13,25,27,12,2092,2169
E01027665,7,15,14,9,1092,1137
E01027722,12,39,24,21,1329,1425
E01027668,0,4,12,17,1506,1539
E01027669,0,3,17,19,1808,1847
E01027673,1,16,3,34,1700,1754
E01027676,3,0,22,18,1719,1762
E01027638,5,14,8,13,1299,1339
E01027639,11,11,12,10,1240,1284
E01027640,2,8,14,12,1453,1489
E01027690,7,8,13,9,1387,1424
E01027738,3,5,20,13,1280,1321
E01027739,2,6,23,26,1043,1100
E01027741,6,12,9,21,1321,1369
E01027689,10,17,23,73,1269,1392
E01027691,7,15,34,15,1423,1494
E01027720,1,7,24,40,1408,1480
E01027721,2,18,25,8,1454,1507
E01027723,6,27,18,38,1401,1490
E01027670,2,0,13,10,1602,1627
E01027671,1,4,7,18,1540,1570
E01027672,2,1,16,18,1745,1782
E01027704,6,5,15,12,1133,1171
E01027649,2,34,23,84,1611,1754
E01027651,5,24,39,110,1341,1519
E01027657,1,35,22,26,1176,1260
E01027658,3,17,27,84,1435,1566
E01027692,6,5,15,52,1098,1176
E01027740,1,31,5,43,1476,1556
E01027648,4,9,22,48,1523,1606
E01027650,7,8,24,22,1477,1538
E01027726,2,8,29,33,1677,1749
E01027727,2,4,18,38,1496,1558
E01027728,1,7,12,12,1311,1343
E01027729,2,21,34,53,1466,1576
E01027652,4,16,17,31,1517,1585
E01027655,5,18,25,140,1295,1483
E01027659,5,64,37,53,1627,1786
E01027677,4,22,18,45,1340,1429
E01027678,21,23,26,107,1520,1697
E01027680,17,26,22,29,1213,1307
E01027683,3,4,4,3,1443,1457
E01027684,1,2,15,4,1409,1431
E01027695,0,1,17,7,1661,1686
E01027696,19,12,15,199,1744,1989
E01027703,0,1,4,8,1831,1844
E01027660,2,8,12,10,1505,1537
E01027661,6,12,15,23,1382,1438
E01027662,1,2,14,15,1230,1262
E01027663,6,12,12,6,1323,1359
E01027697,1,8,19,14,1412,1454
E01027733,3,8,17,18,1369,1415
E01027682,13,18,13,3,1592,1639
E01027694,22,25,30,29,1226,1332
E01027734,6,2,14,8,1519,1549
E01027735,12,1,4,6,1626,1649
E01027656,2,26,28,28,1568,1652
E01027679,5,21,37,26,1506,1595
E01027730,6,49,23,23,1432,1533
E01027731,2,16,13,8,1420,1459
E01027732,3,6,26,11,1296,1342
E01027653,12,7,29,10,1396,1454
E01027654,1,10,24,27,1166,1228
E01027698,1,4,24,7,1525,1561
E01027716,4,9,13,21,1390,1437
E01027717,2,6,18,14,1520,1560
E01027718,12,7,27,43,1797,1886
E01027719,0,14,16,57,1390,1477
E01027699,5,2,11,13,1331,1362
E01027700,4,4,9,17,1151,1185
E01027724,0,8,11,9,1567,1595
E01027725,5,0,11,10,1479,1505
E01027743,1,3,11,3,1206,1224
E01027751,1,4,4,5,1258,1272
E01027752,0,1,7,0,1176,1184
E01027759,0,0,1,7,1398,1406
E01027761,11,6,3,9,1154,1183
E01027762,0,2,7,11,1289,1309
E01027765,1,1,10,16,1585,1613
E01027766,0,1,14,16,1189,1220
E01027767,2,1,5,20,1487,1515
E01027768,0,4,7,2,1153,1166
E01027769,2,1,11,23,1256,1293
E01027770,8,6,19,16,1557,1606
E01027745,3,3,12,11,1633,1662
E01027746,1,6,11,14,1380,1412
E01027747,12,61,37,55,1814,1979
E01027748,0,0,1,1,1174,1176
E01027749,1,7,28,23,1924,1983
E01027750,23,17,38,136,2663,2877
E01027754,16,24,29,60,1253,1382
E01027771,28,181,99,387,2813,3508
E01027772,7,16,17,92,1170,1302
E01033183,15,29,29,89,1438,1600
E01033184,15,67,34,94,2418,2628
E01027742,4,4,3,4,1313,1328
E01027753,2,7,4,48,1286,1347
E01027763,0,2,4,20,1109,1135
E01027764,1,4,6,9,1210,1230
E01027773,1,12,7,8,1047,1075
E01027744,1,1,3,2,1262,1269
E01027756,0,5,17,23,1721,1766
E01027758,2,1,4,5,1465,1477
E01027760,0,2,10,24,1248,1284
E01033185,5,4,4,6,1237,1256
E01033186,1,13,6,8,1270,1298
E01027776,0,0,15,4,1523,1542
E01027777,1,0,4,1,1407,1413
E01027783,0,4,6,11,1744,1765
E01027784,0,7,13,5,1654,1679
E01027792,1,0,10,9,1782,1802
E01027793,0,2,9,1,1406,1418
E01027794,0,1,15,6,2007,2029
E01027795,1,1,11,11,1557,1581
E01027801,0,0,9,4,1620,1633
E01027802,0,1,5,5,1612,1623
E01027775,5,3,18,29,2098,2153
E01027780,0,1,5,5,1800,1811
E01027781,1,5,4,2,1243,1255
E01027800,0,1,4,6,1674,1685
E01027779,1,0,12,5,1147,1165
E01027796,0,4,5,2,1732,1743
E01027798,1,0,5,8,1966,1980
E01027803,1,1,13,2,1784,1801
E01027774,0,1,19,23,1989,2032
E01027778,1,0,11,9,2264,2285
E01027782,2,2,10,3,1639,1656
E01027797,2,2,9,8,1675,1696
E01027799,1,0,4,2,1722,1729
E01027785,8,7,13,17,1486,1531
E01027786,0,6,10,24,1526,1566
E01027787,1,12,5,9,1764,1791
E01027788,0,1,1,1,1402,1405
E01027789,0,9,30,22,2430,2491
E01027790,4,7,17,34,1874,1936
E01027791,1,2,10,5,1537,1555
E01027837,0,0,14,2,1390,1406
E01027839,0,0,16,11,1658,1685
E01027869,0,1,8,9,1082,1100
E01027870,0,3,2,22,1305,1332
E01027871,1,0,17,5,1498,1521
E01027813,2,4,11,24,2031,2072
E01027822,1,3,3,2,1392,1401
E01027840,3,0,3,3,2089,2098
E01027841,1,0,3,0,1316,1320
E01027838,0,0,10,1,1550,1561
E01027864,1,1,9,6,1440,1457
E01027865,0,0,18,25,1573,1616
E01027866,0,1,9,3,1522,1535
E01027821,5,0,8,7,1392,1412
E01027823,6,0,6,0,1430,1442
E01027831,0,0,4,4,1062,1070
E01027832,2,4,4,27,1029,1066
E01027836,5,3,14,16,2172,2210
E01027857,0,1,8,5,1311,1325
E01027842,0,0,10,19,1596,1625
E01027843,1,1,7,15,1406,1430
E01027844,1,1,12,22,1520,1556
E01027845,0,0,11,21,1709,1741
E01027855,1,6,15,19,1441,1482
E01027856,2,1,6,7,1141,1157
E01027805,7,4,16,46,1425,1498
E01027806,9,18,36,37,1640,1740
E01027846,7,4,13,17,1843,1884
E01027847,18,15,31,62,1757,1883
E01027848,0,2,9,14,1027,1052
E01027849,1,0,11,6,1181,1199
E01027850,3,4,14,16,1265,1302
E01027872,1,3,5,27,1430,1466
E01027874,0,3,9,10,1636,1658
E01027810,1,5,16,28,1641,1691
E01027811,5,4,46,47,1606,1708
E01027812,7,6,41,95,1634,1783
E01027851,0,2,7,4,1524,1537
E01027862,4,1,18,50,1565,1638
E01027824,5,1,15,38,1372,1431
E01027825,4,4,19,16,1855,1898
E01027826,2,3,12,31,1478,1526
E01027861,3,2,9,43,1261,1318
E01027863,6,2,6,25,1386,1425
E01027873,7,20,20,111,1328,1486
E01027804,12,11,23,54,1405,1505
E01027852,23,25,24,49,1553,1674
E01027853,1,14,16,17,1215,1263
E01027854,12,18,27,73,1358,1488
E01027868,16,17,24,47,2166,2270
E01027807,0,0,13,4,1447,1464
E01027808,2,1,4,3,1430,1440
E01027809,0,3,5,8,1232,1248
E01027818,0,0,9,2,1360,1371
E01027867,2,9,17,27,1506,1561
E01027817,3,0,5,6,1393,1407
E01027819,1,0,13,5,1413,1432
E01027820,3,1,7,6,1383,1400
E01027858,1,0,2,3,1371,1377
E01027860,0,3,13,6,1528,1550
E01027814,3,0,5,1,1579,1588
E01027815,1,1,10,9,1306,1327
E01027816,6,1,5,2,1557,1571
E01027859,1,0,9,5,1705,1720
E01027827,1,0,10,10,1596,1617
E01027828,1,0,3,6,1626,1636
E01027829,0,0,6,1,1464,1471
E01027830,1,1,8,2,1794,1806
E01027833,1,1,10,10,1559,1581
E01027834,2,1,13,3,1523,1542
E01027835,1,0,7,7,1726,1741
E01027918,0,19,12,8,1446,1485
E01027919,0,6,8,5,1130,1149
E01027920,0,5,15,12,1155,1187
E01027921,0,12,8,7,1714,1741
E01027922,0,15,6,7,1671,1699
E01027875,0,15,16,18,1816,1865
E01027886,0,1,14,3,1316,1334
E01027887,1,0,11,4,1532,1548
E01027888,1,2,12,1,1738,1754
E01027904,2,1,11,13,2314,2341
E01027876,0,1,4,1,1629,1635
E01027877,0,2,18,15,1214,1249
E01027900,0,2,10,4,1897,1913
E01027901,0,5,13,5,1536,1559
E01027902,0,0,19,3,1537,1559
E01027903,3,6,15,15,1155,1194
E01027898,3,10,14,22,2319,2368
E01027914,0,10,9,11,1650,1680
E01027915,1,2,13,7,1591,1614
E01027916,0,2,8,6,1516,1532
E01027917,1,1,19,10,1800,1831
E01027878,1,1,11,12,1254,1279
E01027905,1,3,10,39,1818,1871
E01027907,0,1,6,10,1360,1377
E01027908,6,4,26,25,1517,1578
E01027909,1,7,16,36,1962,2022
E01027910,0,4,17,14,2724,2759
E01027881,4,1,7,5,1277,1294
E01027906,2,0,15,18,1389,1424
E01027911,1,1,3,10,1464,1479
E01027912,0,1,6,2,1021,1030
E01027913,0,0,8,3,1180,1191
E01027879,1,1,8,7,1328,1345
E01027880,0,1,10,6,1566,1583
E01027882,0,0,4,8,1818,1830
E01027894,0,1,17,4,1867,1889
E01027895,0,0,8,10,1549,1567
E01027883,0,5,8,10,1102,1125
E01027884,0,1,24,10,1593,1628
E01027885,0,7,10,8,1539,1564
E01027896,0,0,13,4,1981,1998
E01027897,0,3,13,7,2077,2100
E01027891,0,14,8,8,1642,1672
E01027892,0,2,14,4,1846,1866
E01027893,2,2,11,8,1836,1859
E01027899,5,26,6,3,1688,1728
E01027889,1,8,66,16,1703,1794
E01027890,0,1,5,13,1950,1969
E01027923,0,0,10,8,2248,2266
E01027924,4,0,11,8,2102,2125
E01007434,7,6,16,10,1894,1933
E01007435,1,3,5,2,1568,1579
E01007438,4,4,4,10,1535,1557
E01007439,0,0,3,2,1205,1210
E01007433,0,5,6,7,1597,1615
E01007436,4,0,5,2,1256,1267
E01007437,4,3,11,9,1449,1476
E01007440,0,1,12,7,1500,1520
E01007329,0,5,12,7,1570,1594
E01007331,8,0,10,3,1832,1853
E01007342,1,1,5,2,1389,1398
E01007343,0,4,9,1,1332,1346
E01007356,2,3,10,9,1357,1381
E01007357,0,1,11,14,1371,1397
E01007361,3,2,17,11,1623,1656
E01007362,3,2,18,17,1593,1633
E01007363,10,6,4,11,1544,1575
E01007355,7,1,9,20,1500,1537
E01007358,3,8,12,13,1461,1497
E01007359,5,2,9,12,1481,1509
E01007360,5,3,3,3,1532,1546
E01007386,0,0,9,4,1701,1714
E01007328,2,13,11,5,1891,1922
E01007330,1,3,20,5,1679,1708
E01007332,8,12,17,15,2254,2306
E01007333,1,4,8,5,1313,1331
E01007323,0,10,15,8,1450,1483
E01007324,2,16,15,0,1634,1667
E01007325,5,5,16,21,1667,1714
E01007326,3,17,9,8,1489,1526
E01007327,1,2,7,2,1664,1676
E01007411,1,7,9,16,1158,1191
E01007341,2,15,13,3,1231,1264
E01007345,0,7,14,4,1595,1620
E01007346,0,5,8,17,1590,1620
E01007347,1,5,5,16,1567,1594
E01007334,0,12,14,3,1327,1356
E01007335,0,9,7,2,1488,1506
E01007400,1,2,5,13,1996,2017
E01007404,1,2,4,1,1279,1287
E01007406,1,5,7,11,1696,1720
E01007408,0,14,17,19,1466,1516
E01007409,8,7,13,15,1415,1458
E01007410,6,14,12,16,1583,1631
E01032550,1,40,19,42,2739,2841
E01032551,6,12,7,17,2525,2567
E01007344,1,15,20,15,2084,2135
E01007402,5,9,7,11,1628,1660
E01007403,0,16,25,4,1491,1536
E01007405,1,5,3,8,1401,1418
E01007379,1,2,7,9,1572,1591
E01007380,7,9,11,21,1762,1810
E01007381,4,1,6,26,1510,1547
E01007387,0,6,9,14,1423,1452
E01007442,7,5,3,53,1309,1377
E01007444,19,0,8,50,1473,1550
E01007446,3,8,8,33,1283,1335
E01007336,13,36,12,37,1459,1557
E01007340,10,8,22,27,1569,1636
E01007415,0,2,23,11,1459,1495
E01007417,14,25,12,35,1505,1591
E01007441,20,27,13,48,1429,1537
E01007443,14,83,39,62,1802,2000
E01007445,4,4,13,19,1411,1451
E01007372,1,0,7,9,1270,1287
E01007373,0,3,11,15,1565,1594
E01007374,0,2,7,2,1459,1470
E01007375,6,1,10,5,1637,1659
E01007377,1,3,12,5,1084,1105
E01007378,1,10,10,2,1549,1572
E01007319,1,0,3,5,1456,1465
E01007321,0,3,5,9,1416,1433
E01007322,7,17,11,31,2016,2082
E01007337,13,28,14,16,1704,1775
E01007418,0,0,9,7,1263,1279
E01007419,6,1,10,1,1703,1721
E01007420,5,1,11,3,1412,1432
E01007425,2,4,4,10,1450,1470
E01007338,5,34,7,11,1476,1533
E01007339,15,52,9,44,1370,1490
E01007413,3,19,5,32,1290,1349
E01007414,4,12,21,3,1598,1638
E01007317,1,16,10,1,1465,1493
E01007318,1,45,17,15,1466,1544
E01007320,0,18,6,3,1569,1596
E01007416,6,27,6,11,1144,1194
E01007382,4,0,13,15,1451,1483
E01007383,0,6,12,17,1335,1370
E01007384,0,0,1,8,1605,1614
E01007385,2,2,7,8,1414,1433
E01007348,0,6,8,1,1429,1444
E01007349,0,2,10,1,1520,1533
E01007350,1,1,9,7,1167,1185
E01007351,0,1,5,2,1418,1426
E01007352,0,1,9,13,1389,1412
E01007353,0,13,14,19,1559,1605
E01007354,1,1,15,8,1656,1681
E01007458,1,3,9,11,1431,1455
E01007459,1,3,7,1,1497,1509
E01007460,2,25,7,8,1395,1437
E01007461,2,19,12,23,1591,1647
E01007462,7,18,18,25,1534,1602
E01007463,4,22,8,21,1711,1766
E01007369,2,10,21,6,1451,1490
E01007370,0,6,5,4,1374,1389
E01007371,7,5,20,25,1897,1954
E01007376,1,13,18,0,1375,1407
E01007447,0,3,8,3,1530,1544
E01007448,6,11,21,12,1544,1594
E01007449,0,8,21,17,1724,1770
E01007450,1,7,12,19,1477,1516
E01007427,4,6,20,18,1506,1554
E01007428,1,5,6,7,1426,1445
E01007429,0,1,6,9,1406,1422
E01007430,2,3,19,11,2242,2277
E01007431,2,0,13,5,1343,1363
E01007432,1,0,9,4,1417,1431
E01007364,1,0,5,1,1383,1390
E01007365,0,2,4,5,1201,1212
E01007366,2,3,17,0,1983,2005
E01007367,0,0,10,1,1167,1178
E01007368,4,17,18,3,1633,1675
E01007451,0,6,12,7,1687,1712
E01007452,1,2,9,7,1536,1555
E01007453,1,7,5,6,1539,1558
E01007455,0,7,7,0,1344,1358
E01032924,3,20,21,6,1512,1562
E01032925,6,4,12,7,1361,1390
E01007421,0,7,12,7,1304,1330
E01007422,0,2,12,10,1547,1571
E01007423,4,3,16,6,1626,1655
E01007426,0,2,9,12,1535,1558
E01007396,0,7,14,1,1558,1580
E01007397,5,9,10,3,1429,1456
E01007398,1,0,3,4,1624,1632
E01007399,1,7,9,2,2038,2057
E01007424,1,7,13,6,1644,1671
E01007388,4,10,12,5,1584,1615
E01007393,2,9,12,19,1795,1837
E01007394,3,4,5,6,1366,1384
E01007456,1,2,9,5,1739,1756
E01007457,0,0,27,8,1613,1648
E01007389,1,1,12,3,1379,1396
E01007390,0,1,19,7,1500,1527
E01007391,2,11,20,8,1427,1468
E01007392,1,3,7,10,1517,1538
E01007395,9,12,8,5,1982,2016
E01007632,4,0,3,4,1606,1617
E01007633,1,0,9,12,1333,1355
E01007634,2,0,10,18,1606,1636
E01007635,0,2,9,8,1391,1410
E01007487,0,2,6,4,1603,1615
E01007488,0,4,25,42,1667,1738
E01007489,1,1,12,21,1686,1721
E01007490,2,3,20,17,1523,1565
E01007491,1,5,19,10,1719,1754
E01007492,1,0,16,7,1472,1496
E01007493,2,0,15,7,1760,1784
E01007636,8,1,7,8,1497,1521
E01007637,1,2,5,16,1518,1542
E01007638,0,2,16,13,1556,1587
E01007639,0,3,11,12,1868,1894
E01007640,2,6,9,18,1581,1616
E01007641,5,1,9,4,1493,1512
E01007642,1,2,9,16,1577,1605
E01007625,4,1,5,15,1512,1537
E01007626,2,16,15,43,1150,1226
E01007627,2,6,9,3,1651,1671
E01007628,0,9,8,15,1407,1439
E01007629,1,3,20,8,1574,1606
E01007468,1,0,9,3,1283,1296
E01007469,1,1,12,9,1332,1355
E01007470,1,2,10,1,1414,1428
E01007472,3,5,7,11,1598,1624
E01007473,3,2,8,8,1436,1457
E01007474,0,1,9,4,1311,1325
E01007554,0,5,7,31,1551,1594
E01007555,1,5,12,11,1435,1464
E01007556,0,0,14,11,1339,1364
E01007561,2,2,13,6,1449,1472
E01007562,0,2,9,16,1335,1362
E01007563,5,2,11,16,1421,1455
E01007621,4,6,11,14,1375,1410
E01007622,1,0,4,16,1494,1515
E01007623,2,5,7,6,1204,1224
E01007624,0,13,6,17,1828,1864
E01007630,3,9,9,14,1323,1358
E01007631,0,0,3,0,1218,1221
E01007553,3,3,4,21,1662,1693
E01007557,21,141,138,237,2247,2784
E01007558,2,4,6,3,1438,1453
E01007559,1,19,12,29,1101,1162
E01007560,4,8,8,9,1494,1523
E01007464,0,4,5,7,1481,1497
E01007465,1,10,22,8,1442,1483
E01007466,1,9,12,9,1724,1755
E01007467,2,12,6,10,1523,1553
E01007471,1,6,7,6,1522,1542
E01007504,1,5,21,16,1489,1532
E01007507,0,10,22,33,1310,1375
E01007506,0,1,21,6,1413,1441
E01007508,2,23,44,15,1580,1664
E01007509,7,14,27,13,1699,1760
E01007510,0,7,20,15,1526,1568
E01007511,3,16,27,16,1514,1576
E01007475,1,2,20,19,1507,1549
E01007476,8,9,20,26,1394,1457
E01007477,0,4,7,20,1400,1431
E01007478,3,4,1,12,1512,1532
E01007512,1,7,18,26,1619,1671
E01007513,4,12,17,20,1382,1435
E01007515,2,15,11,10,1532,1570
E01007518,0,3,12,22,1452,1489
E01007519,0,5,18,4,1271,1298
E01007505,0,9,30,10,1624,1673
E01007514,3,24,25,32,1381,1465
E01007516,2,8,9,10,1307,1336
E01007517,13,24,23,24,1469,1553
E01007479,1,3,10,12,1567,1593
E01007480,0,14,3,13,1479,1509
E01007482,0,7,20,11,1336,1374
E01033259,2,15,14,44,1524,1599
E01033260,1,28,26,27,1529,1611
E01007570,6,12,22,49,1393,1482
E01007650,8,13,17,52,1559,1649
E01007651,11,32,29,133,1625,1830
E01007652,18,29,46,73,1723,1889
E01007653,5,22,36,66,1450,1579
E01007656,5,13,14,31,1526,1589
E01007581,3,8,0,22,1526,1559
E01007582,1,1,6,14,1435,1457
E01007588,0,12,21,14,1645,1692
E01007589,0,2,12,15,1683,1712
E01007483,4,4,13,4,1356,1381
E01007484,0,4,22,5,1414,1445
E01007485,3,5,19,7,1401,1435
E01007486,0,7,9,7,1294,1317
E01007564,17,21,25,116,1357,1536
E01007565,2,29,31,139,1326,1527
E01007566,24,27,36,68,1471,1626
E01007567,10,20,15,103,1194,1342
E01007568,9,27,35,66,1525,1662
E01007569,15,29,30,102,1425,1601
E01007644,5,30,23,152,1339,1549
E01007646,7,31,15,107,1303,1463
E01007647,23,13,22,132,1313,1503
E01007648,21,32,46,242,1543,1884
E01007649,10,20,33,144,1342,1549
E01007654,8,40,21,220,1250,1539
E01007583,5,3,4,7,1436,1455
E01007586,1,1,5,5,1510,1522
E01007587,2,13,10,8,1509,1542
E01007620,0,1,6,15,1584,1606
E01007584,8,4,17,24,1495,1548
E01007585,3,8,15,22,1558,1606
E01007617,2,5,11,11,1482,1511
E01007618,2,0,2,14,1249,1267
E01007619,4,4,10,18,1774,1810
E01007529,68,74,50,146,1709,2047
E01007530,25,35,40,253,853,1206
E01007531,26,38,27,78,1456,1625
E01007643,33,53,60,143,1376,1665
E01007645,60,55,56,488,1413,2072
E01007655,46,47,46,161,1593,1893
E01007494,3,12,39,48,1427,1529
E01007532,110,98,71,243,1252,1774
E01007533,14,25,12,73,1295,1419
E01007535,15,29,23,98,1431,1596
E01007522,6,6,16,37,1485,1550
E01007525,14,7,17,39,1455,1532
E01007528,18,8,11,37,1318,1392
E01007604,9,17,24,71,1310,1431
E01007521,1,6,21,86,1377,1491
E01007523,9,5,10,148,1314,1486
E01007524,14,14,18,123,1412,1581
E01007526,3,14,26,157,1433,1633
E01007607,10,21,31,32,1350,1444
E01007599,3,5,17,25,1713,1763
E01007600,1,2,20,8,1403,1434
E01007601,3,7,8,19,1330,1367
E01007602,0,4,21,31,1444,1500
E01007603,1,1,10,37,1435,1484
E01007520,7,5,18,113,1275,1418
E01007527,16,26,42,236,2005,2325
E01007605,9,16,17,58,1443,1543
E01007606,11,13,9,128,1375,1536
E01007495,6,50,51,54,1696,1857
E01007500,3,18,20,37,1230,1308
E01007502,14,52,24,88,2572,2750
E01007534,11,48,49,106,1808,2022
E01007496,7,32,52,44,1487,1622
E01007497,1,31,16,24,1304,1376
E01007498,2,36,28,59,1455,1580
E01007499,1,13,11,23,1453,1501
E01007501,1,3,7,44,1401,1456
E01007503,0,7,13,15,1585,1620
E01007575,0,7,18,7,1376,1408
E01007578,0,6,11,12,1587,1616
E01007579,1,9,6,5,1483,1504
E01007580,4,8,3,8,1355,1378
E01007571,0,1,12,4,1593,1610
E01007572,2,2,13,6,1393,1416
E01007573,5,10,12,13,1506,1546
E01007574,3,4,16,8,1546,1577
E01007576,0,1,12,7,1498,1518
E01007577,2,6,10,13,1509,1540
E01007536,1,8,26,25,1911,1971
E01007542,3,9,17,17,1732,1778
E01007543,1,1,13,4,1481,1500
E01007544,4,6,13,10,1719,1752
E01007546,0,10,9,20,1389,1428
E01007551,0,4,14,6,1647,1671
E01007552,1,2,12,31,1362,1408
E01007613,8,4,13,13,1541,1579
E01007545,1,10,20,24,1429,1484
E01007547,1,9,22,5,1492,1529
E01007548,1,6,9,6,1081,1103
E01007549,7,6,6,5,1431,1455
E01007550,0,3,10,9,1643,1665
E01007537,6,1,11,4,1711,1733
E01007538,1,3,6,4,1516,1530
E01007539,1,7,12,4,1419,1443
E01007540,2,5,7,3,1616,1633
E01007541,1,2,13,3,1501,1520
E01007591,1,4,9,7,1431,1452
E01007594,2,24,15,16,1979,2036
E01007596,0,9,10,2,1225,1246
E01007598,1,15,9,7,1502,1534
E01007590,0,3,7,13,1192,1215
E01007592,1,8,8,26,1609,1652
E01007593,0,2,6,9,1289,1306
E01007595,1,2,2,4,1519,1528
E01007597,3,10,8,5,1542,1568
E01007608,3,4,27,15,1658,1707
E01007609,3,11,7,40,2249,2310
E01007610,1,4,8,22,1764,1799
E01007611,5,2,7,10,1269,1293
E01007612,1,5,10,2,1360,1378
E01007614,3,10,2,3,1335,1353
E01007615,3,2,10,19,1224,1258
E01007616,0,3,7,11,1218,1239
E01007693,4,6,25,15,2098,2148
E01007694,5,4,4,20,1725,1758
E01007695,1,10,17,15,2418,2461
E01007697,0,1,5,4,1567,1577
E01007698,1,1,8,16,1491,1517
E01007816,2,6,17,25,1622,1672
E01007817,2,4,8,3,1404,1421
E01007819,4,8,17,18,1434,1481
E01007820,1,21,12,4,1445,1483
E01007821,5,9,9,3,1582,1608
E01007822,8,18,11,8,1495,1540
E01007796,0,3,5,9,1139,1156
E01007797,1,8,10,14,1329,1362
E01007798,8,0,5,7,1241,1261
E01007799,1,4,6,7,1396,1414
E01007800,9,12,7,3,1443,1474
E01007818,6,10,20,26,1532,1594
E01007777,6,6,11,3,1590,1616
E01007793,1,5,7,2,1351,1366
E01007794,2,0,10,26,1395,1433
E01007795,1,0,9,5,1424,1439
E01007778,2,5,6,11,1502,1526
E01007779,8,8,11,15,1215,1257
E01007780,0,7,3,18,1386,1414
E01007781,1,3,1,14,1505,1524
E01007782,4,8,15,15,1453,1495
E01007771,2,2,11,7,1399,1421
E01007772,5,2,12,17,1293,1329
E01007773,2,7,19,18,1366,1412
E01007774,6,3,12,9,1473,1503
E01007696,0,2,9,7,1460,1478
E01007801,2,4,6,7,1472,1491
E01007802,6,4,4,11,1305,1330
E01007803,1,1,12,5,1318,1337
E01007808,2,0,3,14,1450,1469
E01007775,10,10,20,12,1289,1341
E01007776,4,33,18,18,1414,1487
E01007783,2,17,21,28,1606,1674
E01007784,5,18,26,40,1672,1761
E01007728,0,6,2,5,1103,1116
E01007729,9,33,29,22,1527,1620
E01007730,10,17,17,13,1360,1417
E01007731,4,0,5,11,1218,1238
E01007732,1,11,7,9,1387,1415
E01007733,7,15,12,2,1287,1323
E01007719,1,2,8,13,1223,1247
E01007720,3,9,19,15,1458,1504
E01007721,12,8,14,28,1513,1575
E01007727,0,1,7,4,1486,1498
E01007740,4,25,12,8,1484,1533
E01007804,10,22,6,7,1391,1436
E01007805,7,0,12,9,1402,1430
E01007806,2,24,8,8,1262,1304
E01007807,4,6,15,2,1421,1448
E01007681,2,2,9,5,1313,1331
E01007691,3,2,3,14,2023,2045
E01007692,5,0,4,9,1501,1519
E01032926,2,8,18,42,1703,1773
E01032927,11,5,12,18,1459,1505
E01007723,0,6,14,7,1352,1379
E01007735,9,30,41,89,1258,1427
E01007737,9,64,21,18,1471,1583
E01007738,11,17,50,78,1360,1516
E01007739,8,14,20,179,1366,1587
E01007736,33,34,43,264,1244,1618
E01007765,13,37,7,162,1299,1518
E01007766,18,33,16,155,1246,1468
E01007768,105,122,43,558,1108,1936
E01007770,13,17,27,371,1331,1759
E01007741,3,0,14,22,1488,1527
E01007742,1,6,14,24,1376,1421
E01007743,2,0,3,5,1292,1302
E01007744,4,11,11,26,1504,1556
E01007745,1,17,17,28,1488,1551
E01007746,0,8,14,7,1513,1542
E01007715,65,87,66,625,954,1797
E01007716,38,79,39,716,1039,1911
E01007717,21,49,27,107,1694,1898
E01007718,10,26,32,185,1236,1489
E01007677,52,51,48,104,1212,1467
E01007714,91,112,45,517,1257,2022
E01007767,36,25,31,262,1309,1663
E01007769,117,84,105,561,861,1728
E01007685,0,6,4,10,1417,1437
E01007754,0,3,8,21,1377,1409
E01007755,1,1,4,3,1377,1386
E01007756,3,0,10,5,1428,1446
E01007761,1,2,4,9,1600,1616
E01007762,2,4,10,8,1447,1471
E01007682,1,2,7,22,1408,1440
E01007683,2,2,9,9,1411,1433
E01007686,5,1,2,27,1382,1417
E01007688,0,1,9,16,1403,1429
E01007725,7,5,3,19,1298,1332
E01007726,4,7,16,8,1565,1600
E01007757,0,3,13,15,1638,1669
E01007758,1,2,13,7,1313,1336
E01007759,0,3,15,2,1453,1473
E01007760,1,1,22,15,1745,1784
E01007763,4,1,17,13,1526,1561
E01007764,3,4,14,13,1671,1705
E01007708,6,9,38,113,1506,1672
E01007709,2,1,17,44,1392,1456
E01007710,4,1,5,50,1504,1564
E01007711,3,17,29,149,1601,1799
E01007724,0,3,21,11,1337,1372
E01007734,13,11,22,119,1601,1766
E01007684,1,10,10,32,1574,1627
E01007687,1,1,9,17,1424,1452
E01007689,0,4,8,18,1507,1537
E01007690,3,2,7,35,1597,1644
E01007675,38,24,40,604,1148,1854
E01007678,45,67,25,349,1111,1597
E01007679,23,20,29,515,1267,1854
E01007680,75,54,39,831,883,1882
E01007712,15,32,39,309,1570,1965
E01007713,17,20,19,294,1275,1625
E01007811,8,3,6,76,1265,1358
E01007812,0,15,34,53,1139,1241
E01007813,12,1,2,60,1256,1331
E01007814,0,3,17,29,1063,1112
E01007676,5,35,17,55,1517,1629
E01007702,2,27,15,56,1495,1595
E01007703,8,1,4,51,1173,1237
E01007704,3,15,9,37,1386,1450
E01007705,0,22,25,48,1427,1522
E01007707,4,3,12,28,1480,1527
E01007666,0,3,7,14,1333,1357
E01007809,6,4,6,9,1528,1553
E01007810,6,3,16,7,1926,1958
E01007815,6,2,11,4,1692,1715
E01007665,11,27,20,14,1748,1820
E01007699,10,27,12,24,1753,1826
E01007700,4,13,24,18,1754,1813
E01007701,2,24,11,14,1607,1658
E01007706,1,17,11,53,1376,1458
E01007787,4,15,29,30,2691,2769
E01007788,4,0,14,9,1474,1501
E01007789,0,8,5,11,1593,1617
E01007792,0,2,12,7,1326,1347
E01007657,0,1,11,12,1423,1447
E01007659,0,4,5,8,1131,1148
E01007785,1,3,7,6,1334,1351
E01007786,0,2,8,2,1196,1208
E01007790,3,3,27,10,1442,1485
E01007791,0,4,12,8,1347,1371
E01007667,1,0,12,12,1334,1359
E01007668,0,8,18,20,1525,1571
E01007669,3,2,11,11,1477,1504
E01007670,1,1,10,9,1428,1449
E01007672,2,8,20,22,1381,1433
E01007673,1,14,14,26,1441,1496
E01007671,8,31,23,25,2030,2117
E01007674,2,7,8,14,1908,1939
E01007747,0,5,8,5,1277,1295
E01007750,1,1,7,10,1502,1521
E01007658,1,1,6,11,1372,1391
E01007660,1,0,8,6,1212,1227
E01007661,1,3,10,13,1374,1401
E01007662,0,0,8,2,1025,1035
E01007663,0,1,12,10,1437,1460
E01007664,2,0,5,2,1845,1854
E01007748,0,1,8,10,1425,1444
E01007749,6,2,2,11,1783,1804
E01007751,5,15,20,37,1885,1962
E01007752,4,2,8,10,1463,1487
E01007753,1,4,8,7,1525,1545
E01008144,4,10,1,7,1644,1666
E01008145,2,10,4,3,1453,1472
E01008148,1,16,7,3,1482,1509
E01008149,2,5,11,5,1473,1496
E01008150,0,14,11,7,1422,1454
E01008142,3,7,20,25,1423,1478
E01008143,1,14,7,7,1591,1620
E01008146,0,2,8,4,1320,1334
E01008147,2,6,6,4,1408,1426
E01007888,1,4,19,8,1347,1379
E01007892,2,10,16,6,1432,1466
E01007893,5,1,6,7,1472,1491
E01007898,2,5,17,16,1430,1470
E01007899,1,6,12,9,1435,1463
E01007900,7,17,24,29,1617,1694
E01007901,1,17,22,7,1434,1481
E01007887,4,5,10,22,1321,1362
E01007889,12,14,25,35,2591,2677
E01007890,3,11,13,1,1414,1442
E01007891,4,11,7,24,1505,1551
E01007894,2,20,23,17,1396,1458
E01007895,8,8,19,9,1412,1456
E01007896,4,10,3,18,1245,1280
E01007897,3,3,10,16,1354,1386
E01008134,2,5,13,14,1297,1331
E01008135,14,24,18,32,1682,1770
E01008137,5,2,17,13,1404,1441
E01008141,0,7,24,45,1515,1591
E01008053,4,14,19,3,1205,1245
E01008056,7,21,21,7,1441,1497
E01008058,2,3,5,2,1453,1465
E01008138,13,11,13,21,1244,1302
E01008139,4,13,14,3,1548,1582
E01007856,22,74,37,29,1155,1317
E01008054,19,93,39,47,1126,1324
E01008055,17,51,59,46,1312,1485
E01008057,24,76,44,39,1306,1489
E01008126,0,2,6,8,1536,1552
E01008128,10,11,13,15,1665,1714
E01008136,10,7,9,4,1325,1355
E01008140,9,9,15,18,1755,1806
E01033275,21,60,32,67,1431,1611
E01033280,15,18,17,18,1569,1637
E01008085,5,9,24,23,1307,1368
E01008086,12,35,17,4,1281,1349
E01008116,10,20,16,15,1266,1327
E01008117,8,20,26,16,1151,1221
E01008118,19,31,33,45,1269,1397
E01008119,15,31,20,14,1199,1279
E01008125,7,10,13,15,1436,1481
E01007849,135,184,84,195,1515,2113
E01007857,4,85,57,44,1367,1557
E01008059,14,48,58,74,1318,1512
E01008060,4,61,45,51,1225,1386
E01008061,43,82,55,106,1310,1596
E01008063,22,37,36,89,1357,1541
E01033277,57,103,58,52,2064,2334
E01008087,9,10,25,15,1496,1555
E01008088,12,15,33,4,1365,1429
E01008090,21,32,34,28,1509,1624
E01008092,9,34,39,29,1316,1427
E01008122,11,34,36,13,1256,1350
E01008124,16,60,58,40,1325,1499
E01007848,75,174,66,125,1277,1717
E01007851,97,171,87,303,825,1483
E01007947,133,106,50,155,1182,1626
E01007948,281,207,106,349,814,1757
E01008062,225,150,65,260,993,1693
E01007847,18,65,22,73,1119,1297
E01007850,18,29,39,53,1423,1562
E01007852,11,47,30,52,1342,1482
E01007853,14,131,48,35,1340,1568
E01007854,120,128,148,239,1100,1735
E01007855,89,178,110,314,1344,2035
E01007941,23,83,60,124,1333,1623
E01007945,27,88,70,66,1529,1780
E01007946,31,44,57,35,1418,1585
E01007950,18,48,56,33,1374,1529
E01008123,7,49,41,69,1147,1313
E01007987,6,14,23,16,1409,1468
E01007988,7,12,22,6,1473,1520
E01007989,17,6,31,10,1355,1419
E01007991,20,5,25,12,1441,1503
E01007995,3,18,17,13,1421,1472
E01008089,39,132,83,88,1337,1679
E01008091,6,25,26,25,1382,1464
E01008093,11,34,14,23,1373,1455
E01007903,41,67,56,705,719,1588
E01007904,110,135,59,513,884,1701
E01007913,76,89,35,868,413,1481
E01007914,89,103,46,836,485,1559
E01007870,146,242,86,411,958,1843
E01007871,121,198,78,203,1183,1783
E01007943,38,79,67,79,1485,1748
E01008094,12,42,44,44,973,1115
E01007869,120,249,69,731,545,1714
E01007872,103,158,42,689,761,1753
E01007873,213,295,55,624,573,1760
E01007942,124,165,46,1150,377,1862
E01007949,47,85,55,692,713,1592
E01007990,18,11,21,10,1425,1485
E01007992,8,17,21,29,1549,1624
E01007993,22,13,30,14,1603,1682
E01007994,11,17,19,9,1379,1435
E01007996,26,7,24,28,1467,1552
E01007874,412,484,98,269,599,1862
E01007875,362,403,121,470,482,1838
E01007877,97,147,92,575,535,1446
E01007940,338,184,132,418,621,1693
E01007944,267,194,69,1005,523,2058
E01033269,379,614,179,345,402,1919
E01033270,134,304,59,242,745,1484
E01008129,12,6,11,22,1358,1409
E01008130,1,3,15,9,1466,1494
E01008131,0,4,21,7,1544,1576
E01008132,0,0,7,8,1401,1416
E01008133,6,3,15,8,1498,1530
E01008151,32,20,51,79,1357,1539
E01008153,39,23,36,48,1507,1653
E01008154,18,27,29,70,1484,1628
E01008155,30,39,47,57,1373,1546
E01008156,7,8,25,13,1396,1449
E01008160,5,14,33,18,1329,1399
E01007997,4,5,21,9,1440,1479
E01007998,9,10,24,33,1516,1592
E01008152,6,4,17,17,1382,1426
E01008158,8,27,34,10,1456,1535
E01008065,305,255,118,234,1010,1922
E01008068,319,359,143,724,1315,2860
E01008072,226,169,74,99,1022,1590
E01008157,48,69,40,38,1362,1557
E01008161,24,29,32,62,1521,1668
E01007883,84,75,38,723,402,1322
E01007902,76,138,27,462,1049,1752
E01007905,123,198,60,1103,286,1770
E01007906,109,170,38,1076,688,2081
E01008064,25,20,47,80,1515,1687
E01008066,27,58,41,130,1342,1598
E01008069,28,23,50,97,1419,1617
E01008074,19,20,36,48,1337,1460
E01007951,14,22,30,71,1448,1585
E01007960,24,17,23,77,1439,1580
E01007962,25,24,30,91,1295,1465
E01008159,15,7,39,57,1409,1527
E01007866,16,26,52,122,1511,1727
E01007867,35,42,57,166,1710,2010
E01007868,55,19,23,74,1008,1179
E01008067,45,74,60,105,1400,1684
E01008073,67,71,64,66,1434,1702
E01007907,30,27,65,643,891,1656
E01007908,12,28,27,106,1319,1492
E01007909,14,34,44,167,1788,2047
E01007911,5,28,23,16,1325,1397
E01008014,40,46,28,296,1169,1579
E01008016,23,61,23,81,1304,1492
E01007952,16,6,20,85,1442,1569
E01007953,14,19,18,93,1421,1565
E01007954,18,10,27,77,1518,1650
E01007961,35,8,38,77,1350,1508
E01007859,36,27,43,172,1360,1638
E01007860,62,56,39,153,1243,1553
E01007863,18,28,37,111,1671,1865
E01007864,15,34,37,74,1722,1882
E01008104,107,122,36,109,1213,1587
E01007910,4,48,24,126,1436,1638
E01007912,4,8,15,61,1428,1516
E01007971,8,29,26,55,1316,1434
E01007973,2,19,21,37,1444,1523
E01007858,14,12,47,64,1306,1443
E01007861,8,4,23,44,1446,1525
E01007862,36,73,150,387,3537,4183
E01007865,11,23,40,31,1577,1682
E01008011,40,94,81,59,1359,1633
E01008012,61,157,108,90,1728,2144
E01008013,23,26,46,40,1033,1168
E01008015,32,57,36,59,1424,1608
E01008017,26,81,50,66,1365,1588
E01008018,26,41,43,31,1146,1287
E01008105,125,171,110,828,2095,3329
E01008107,100,213,65,297,852,1527
E01008111,35,69,38,150,1396,1688
E01033271,167,311,55,258,612,1403
E01033272,66,184,52,145,712,1159
E01007955,15,4,10,102,1240,1371
E01007956,8,31,27,190,1941,2197
E01007957,27,19,35,163,1385,1629
E01007958,11,10,20,58,1366,1465
E01007959,24,9,26,43,1389,1491
E01008108,46,164,48,595,1128,1981
E01008109,93,135,63,642,1102,2035
E01008112,48,96,41,1023,542,1750
E01008113,47,65,70,584,966,1732
E01033273,55,111,55,525,1676,2422
E01033274,25,37,51,268,2029,2410
E01008095,33,94,57,152,1253,1589
E01008096,87,130,94,171,1694,2176
E01008097,32,122,95,45,1327,1621
E01008101,29,119,89,114,1412,1763
E01007965,9,58,46,27,1766,1906
E01007969,33,28,23,30,1443,1557
E01007972,4,13,13,0,1443,1473
E01007974,6,19,35,16,1392,1468
E01007963,8,48,18,15,1354,1443
E01007967,4,48,26,16,1574,1668
E01007999,6,26,17,16,1284,1349
E01008008,4,46,38,28,1532,1648
E01008009,10,84,53,14,1386,1547
E01008043,19,33,40,268,1370,1730
E01008044,27,39,38,349,1162,1615
E01008047,9,29,35,72,1364,1509
E01008048,39,29,45,66,1355,1534
E01008050,14,19,47,35,1296,1411
E01007931,1,21,39,94,1449,1604
E01007934,13,14,31,45,1365,1468
E01007935,14,12,53,33,1307,1419
E01007936,10,25,56,59,1440,1590
E01007937,5,22,23,55,1290,1395
E01007938,11,12,34,40,1412,1509
E01008098,12,85,71,51,1371,1590
E01008100,26,65,48,32,1094,1265
E01008102,17,46,37,19,996,1115
E01008103,20,80,37,28,1245,1410
E01007964,6,16,36,17,1454,1529
E01007966,6,35,44,31,1435,1551
E01007968,17,19,50,29,1352,1467
E01007970,5,25,23,25,1499,1577
E01008042,31,60,43,520,980,1634
E01008045,6,40,31,405,911,1393
E01008046,19,37,56,289,1258,1659
E01008049,6,19,42,103,1419,1589
E01008051,21,80,59,569,1033,1762
E01008052,10,72,60,218,1434,1794
E01007975,34,120,65,174,1243,1636
E01007976,22,98,52,81,1232,1485
E01007977,64,103,63,52,1214,1496
E01007979,38,206,58,104,1228,1634
E01008099,10,72,54,113,1349,1598
E01008000,4,13,35,18,1433,1503
E01008001,16,22,40,23,1434,1535
E01008004,5,31,14,22,1534,1606
E01008005,1,12,10,19,1504,1546
E01008010,3,57,43,28,1323,1454
E01007978,19,66,68,152,1359,1664
E01007980,12,38,68,128,1298,1544
E01007981,39,84,55,126,1144,1448
E01007983,7,38,43,78,1317,1483
E01007985,10,28,36,34,1447,1555
E01007982,29,131,56,64,1541,1821
E01008002,4,40,20,23,1478,1565
E01008003,6,27,21,30,1326,1410
E01008006,8,17,15,10,1312,1362
E01007927,8,5,34,94,1531,1672
E01007928,11,17,49,101,1573,1751
E01007929,18,35,35,55,1485,1628
E01007930,24,9,39,124,1280,1476
E01007932,9,25,28,44,1309,1415
E01007939,6,7,24,51,1446,1534
E01008028,6,15,22,11,1493,1547
E01008029,2,8,15,27,1444,1496
E01008032,8,11,21,5,1362,1407
E01008034,8,25,46,35,1631,1745
E01007828,14,43,43,66,1544,1710
E01007829,11,27,39,89,1396,1562
E01007831,3,19,34,24,1443,1523
E01007832,11,15,33,17,1467,1543
E01007986,1,31,25,49,1263,1369
E01008007,17,51,63,26,1541,1698
E01008075,68,123,75,44,1131,1441
E01008076,9,71,53,13,1206,1352
E01008077,15,39,28,11,1368,1461
E01008031,8,19,20,17,1372,1436
E01008033,4,19,9,31,1227,1290
E01008038,2,15,15,34,1469,1535
E01008040,12,25,34,37,1596,1704
E01007835,4,11,5,13,1409,1442
E01007836,0,16,17,13,1585,1631
E01007843,14,14,18,18,1536,1600
E01007846,1,10,13,21,1449,1494
E01008030,9,1,6,26,1414,1456
E01008035,3,12,6,7,1167,1195
E01008036,3,14,11,8,1391,1427
E01008041,9,10,11,52,1437,1519
E01007827,4,17,22,12,1449,1504
E01007830,10,17,24,20,1476,1547
E01007833,3,11,16,21,1597,1648
E01007984,2,12,21,19,1381,1435
E01008078,6,13,4,16,1296,1335
E01008079,5,17,15,16,1182,1235
E01008019,2,16,21,18,1809,1866
E01008020,15,24,11,31,1353,1434
E01008022,9,40,42,22,1400,1513
E01008027,5,19,19,14,1475,1532
E01008037,1,5,23,10,1353,1392
E01008039,14,27,13,20,1238,1312
E01007824,2,7,36,11,1337,1393
E01007825,2,5,22,20,1408,1457
E01007826,5,9,20,24,1468,1526
E01007834,12,19,21,51,1551,1654
E01007920,11,5,27,71,1524,1638
E01007921,7,18,24,10,1512,1571
E01007923,16,17,30,45,1694,1802
E01007925,9,15,29,38,1539,1630
E01007926,5,11,25,27,1646,1714
E01007933,9,10,34,68,1542,1663
E01007823,7,28,28,29,1566,1658
E01007916,10,53,64,19,1383,1529
E01007919,16,59,35,43,1450,1603
E01008080,7,19,31,33,1393,1483
E01008081,20,44,24,12,1381,1481
E01008082,17,65,43,23,1340,1488
E01008083,20,67,35,27,1365,1514
E01008084,32,67,59,25,1461,1644
E01007915,5,9,11,48,1342,1415
E01007917,8,13,13,12,1414,1460
E01007918,16,13,35,42,1529,1635
E01007922,3,3,11,55,1334,1406
E01007924,14,19,21,33,1456,1543
E01008021,2,14,18,20,1418,1472
E01008023,3,5,12,38,2052,2110
E01008024,3,12,28,16,1727,1786
E01008025,16,14,27,24,1940,2021
E01032585,13,0,12,10,1374,1409
E01033261,141,140,33,596,857,1767
E01033262,59,103,36,639,912,1749
E01033263,206,97,23,185,819,1330
E01033264,123,130,24,290,920,1487
E01033276,138,195,67,1316,1207,2923
E01008114,286,482,89,510,1248,2615
E01008115,97,201,62,367,1090,1817
E01033265,68,52,34,203,947,1304
E01033266,160,100,30,407,914,1611
E01033267,96,75,31,325,860,1387
E01007878,116,229,61,132,1178,1716
E01007879,48,98,54,289,1157,1646
E01007881,30,114,71,94,1300,1609
E01007882,29,148,56,352,1052,1637
E01007885,56,214,111,99,1077,1557
E01007886,23,87,65,43,1405,1623
E01033268,187,143,88,353,1602,2373
E01007838,3,10,18,6,1470,1507
E01007839,2,14,5,23,1591,1635
E01007841,6,4,17,15,1623,1665
E01007842,5,3,26,7,1534,1575
E01033278,12,16,27,43,2333,2431
E01033279,30,48,15,37,2248,2378
E01010646,0,2,11,7,1299,1319
E01010647,1,1,8,2,1079,1091
E01010648,3,0,6,4,1307,1320
E01010692,1,1,16,18,1828,1864
E01010691,1,2,25,12,1488,1528
E01010693,0,5,20,24,1500,1549
E01010694,1,0,17,9,1549,1576
E01010695,7,7,28,27,1595,1664
E01010696,1,2,21,18,1506,1548
E01010697,5,2,21,14,1473,1515
E01010698,10,6,18,21,1753,1808
E01010699,2,4,15,20,1716,1757
E01010767,0,1,11,12,1426,1450
E01010768,0,5,18,5,1631,1659
E01010769,0,2,18,12,1547,1579
E01010771,13,1,4,4,1238,1260
E01010638,1,2,10,4,1506,1523
E01010639,11,1,18,10,1722,1762
E01010640,9,4,10,30,1638,1691
E01010641,4,3,7,17,1497,1528
E01010642,7,2,10,4,1741,1764
E01010643,0,5,4,36,1378,1423
E01010644,7,11,10,118,1468,1614
E01010645,4,12,12,37,1273,1338
E01010770,0,2,28,10,1589,1629
E01010772,0,4,2,6,1258,1270
E01010773,1,4,17,21,1357,1400
E01010774,5,0,14,9,1561,1589
E01010706,2,3,14,53,1599,1671
E01010707,12,8,13,126,1577,1736
E01010708,5,6,28,423,1194,1656
E01010709,11,6,26,276,2344,2663
E01010719,0,5,16,1167,533,1721
E01010727,2,11,28,204,1473,1718
E01010728,42,33,24,1026,675,1800
E01010729,4,0,12,627,960,1603
E01010700,4,10,32,1038,449,1533
E01010701,8,3,13,1221,229,1474
E01010702,33,4,22,1789,297,2145
E01010703,9,15,38,274,1306,1642
E01010704,1,5,26,85,1344,1461
E01010705,2,2,26,74,1595,1699
E01010710,59,41,47,1012,888,2047
E01010712,4,23,40,1166,538,1771
E01010720,4,13,24,244,1286,1571
E01010721,0,10,25,85,1330,1450
E01010723,45,15,21,1078,455,1614
E01010724,11,5,36,213,1187,1452
E01010725,2,13,13,139,1388,1555
E01010579,3,17,11,30,1513,1574
E01010580,5,21,42,87,2344,2499
E01010764,14,4,15,27,1577,1637
E01010765,6,4,31,20,2166,2227
E01010766,1,0,14,16,1271,1302
E01010711,43,21,28,366,943,1401
E01010713,4,13,26,25,1282,1350
E01010714,1,7,17,136,1232,1393
E01010716,2,38,32,56,1737,1865
E01010715,3,2,18,40,1081,1144
E01010717,0,6,32,72,1496,1606
E01010718,4,25,32,31,1491,1583
E01010726,4,3,13,30,1467,1517
E01010859,2,3,38,10,1597,1650
E01010573,8,12,18,26,1718,1782
E01010574,4,2,19,64,1311,1400
E01010575,5,4,15,15,1580,1619
E01010577,6,3,16,13,1554,1592
E01010722,5,12,33,83,1451,1584
E01010860,7,4,6,9,1523,1549
E01010862,0,4,8,4,1710,1726
E01010863,3,5,15,25,1457,1505
E01010578,5,15,27,22,1462,1531
E01010581,4,30,35,29,1588,1686
E01010582,8,9,20,25,1567,1629
E01010584,18,6,38,49,1636,1747
E01010585,77,20,26,40,1761,1924
E01010568,10,9,26,43,1694,1782
E01010569,9,3,35,16,1649,1712
E01010571,21,8,38,17,1565,1649
E01010572,3,8,13,17,1409,1450
E01010576,1,1,14,27,1503,1546
E01010683,0,11,33,36,1533,1613
E01010684,3,10,32,24,1454,1523
E01010685,8,5,19,12,1610,1654
E01010686,1,13,25,22,1556,1617
E01010570,0,2,16,70,1324,1412
E01010583,31,16,39,29,1505,1620
E01010784,2,3,51,53,1483,1592
E01010785,3,12,46,107,1400,1568
E01010786,14,21,41,283,1186,1545
E01010790,24,6,30,192,1227,1479
E01010680,34,29,51,59,1605,1778
E01010681,8,18,19,135,1205,1385
E01010682,12,41,34,45,1376,1508
E01010687,7,7,21,28,1790,1853
E01010688,13,20,29,71,1747,1880
E01010689,0,12,35,66,1583,1696
E01010690,8,20,45,98,1751,1922
E01010782,4,21,58,49,1615,1747
E01010787,6,24,38,169,1354,1591
E01010788,15,9,57,209,1194,1484
E01033689,12,12,29,83,1060,1196
E01033694,4,11,36,31,929,1011
E01010776,2,14,61,77,1527,1681
E01010777,20,19,57,69,1317,1482
E01010779,17,18,39,36,1310,1420
E01010781,20,6,52,45,1378,1501
E01010783,22,6,29,78,1436,1571
E01010586,4,1,11,8,1576,1600
E01010587,23,4,24,120,1688,1859
E01010588,21,7,24,125,1488,1665
E01010589,0,1,10,19,1486,1516
E01010591,10,11,34,90,1379,1524
E01010593,1,6,33,25,1703,1768
E01010596,6,7,27,68,1354,1462
E01010854,7,7,21,38,1683,1756
E01010855,12,3,18,24,1698,1755
E01010856,4,12,14,21,1550,1601
E01010857,11,8,19,18,1524,1580
E01010858,2,3,14,10,1555,1584
E01010861,1,6,26,18,1786,1837
E01010603,12,26,51,145,1412,1646
E01010604,39,20,24,159,1567,1809
E01010605,8,47,60,82,1344,1541
E01010775,25,41,36,233,1514,1849
E01010778,49,47,64,171,1545,1876
E01010789,13,20,58,642,1066,1799
E01010791,3,21,42,969,712,1747
E01010792,25,25,42,1261,523,1876
E01010793,135,55,54,1162,547,1953
E01010652,6,22,23,24,1479,1554
E01010653,34,31,44,57,1406,1572
E01010655,12,21,63,38,1312,1446
E01010656,5,17,42,137,1306,1507
E01010657,6,5,51,58,1422,1542
E01010649,0,17,28,47,1303,1395
E01010650,12,66,39,67,1463,1647
E01010654,3,18,43,35,1299,1398
E01010826,19,36,33,407,973,1468
E01010597,72,32,69,272,1073,1518
E01010598,34,18,48,396,1255,1751
E01010599,77,26,63,540,670,1376
E01010600,99,39,31,674,590,1433
E01010602,29,19,56,384,1061,1549
E01010670,24,16,69,951,639,1699
E01010671,32,14,28,1200,420,1694
E01010673,33,10,57,1389,327,1816
E01010675,20,29,71,1103,767,1990
E01010669,39,46,58,1145,646,1934
E01010674,51,25,71,881,599,1627
E01010677,43,42,81,1233,730,2129
E01010805,13,15,51,976,549,1604
E01010590,5,3,26,45,1717,1796
E01010592,2,16,39,29,1374,1460
E01010594,3,5,36,30,1616,1690
E01010595,4,28,31,46,1690,1799
E01010601,1,19,36,174,1498,1728
E01010651,2,8,31,169,1311,1521
E01010825,18,19,42,162,1105,1346
E01010827,10,13,29,282,988,1322
E01010804,66,28,17,2080,139,2330
E01010806,17,31,29,1145,359,1581
E01010807,101,43,47,1543,360,2094
E01010808,37,13,44,2049,132,2275
E01010809,25,14,34,2005,157,2235
E01010676,8,14,41,2196,180,2439
E01010679,62,40,31,1283,330,1746
E01010824,104,93,61,778,653,1689
E01010840,21,50,37,1293,263,1664
E01010841,45,41,33,1569,139,1827
E01010828,11,35,64,288,1226,1624
E01010829,25,40,53,788,744,1650
E01010830,36,28,86,898,788,1836
E01010831,79,47,63,1370,436,1995
E01010832,13,8,36,1165,528,1750
E01010672,2,18,31,157,1093,1301
E01010678,9,19,19,313,985,1345
E01010799,9,25,41,303,1140,1518
E01010800,42,108,89,284,1236,1759
E01010801,17,19,58,913,824,1831
E01010802,19,56,107,241,1177,1600
E01010803,32,22,59,1379,317,1809
E01010810,25,48,54,1541,387,2055
E01010811,37,40,43,1901,181,2202
E01010813,48,50,23,1406,284,1811
E01010618,29,22,42,1143,468,1704
E01010619,23,25,39,1965,188,2240
E01010625,14,7,79,995,636,1731
E01010626,18,26,38,1552,375,2009
E01010627,30,40,33,901,600,1604
E01010606,65,39,50,1534,310,1998
E01010607,100,49,72,1637,214,2072
E01010617,63,73,67,694,506,1403
E01010842,81,95,93,1442,234,1945
E01033690,174,92,43,222,607,1138
E01033691,89,85,45,889,416,1524
E01033692,161,99,69,250,500,1079
E01033693,98,78,53,1768,420,2417
E01010628,31,41,39,505,1111,1727
E01010629,59,40,53,1153,623,1928
E01010630,28,15,55,516,960,1574
E01010631,18,91,69,428,938,1544
E01010632,11,31,70,352,874,1338
E01010658,152,57,91,1129,560,1989
E01010812,121,78,58,1366,421,2044
E01010833,98,77,55,1083,350,1663
E01010843,27,41,12,1955,90,2125
E01010620,32,39,50,1413,292,1826
E01010621,41,13,19,2199,99,2371
E01010622,47,24,53,2075,237,2436
E01010623,68,21,57,1154,382,1682
E01010624,46,34,62,1996,136,2274
E01010794,26,38,66,349,1356,1835
E01010795,11,14,36,51,1684,1796
E01010796,12,3,40,49,1515,1619
E01010797,16,4,15,33,1338,1406
E01010798,6,7,44,45,1482,1584
E01010834,108,417,108,1701,1387,3721
E01010835,126,77,34,2659,300,3196
E01010836,58,149,32,1586,424,2249
E01010837,78,16,34,1933,127,2188
E01010838,27,65,49,1528,251,1920
E01010839,69,46,36,1134,379,1664
E01010608,51,39,68,1563,163,1884
E01010613,31,46,35,369,996,1477
E01010730,138,196,124,381,729,1568
E01010734,22,35,65,442,1010,1574
E01010609,18,39,56,202,1227,1542
E01010610,41,41,73,100,1318,1573
E01010611,35,87,94,591,1403,2210
E01010614,10,33,55,242,1130,1470
E01010633,40,20,30,363,1110,1563
E01010634,4,9,27,34,1414,1488
E01010635,16,16,49,154,1218,1453
E01010636,27,20,43,161,1506,1757
E01010637,11,13,55,659,1145,1883
E01010731,181,194,72,757,564,1768
E01010732,178,208,118,1089,473,2066
E01010733,124,141,111,965,544,1885
E01010736,125,148,75,925,776,2049
E01010737,146,87,37,1110,354,1734
E01010659,23,19,84,916,834,1876
E01010662,8,21,40,550,757,1376
E01010664,29,9,39,743,703,1523
E01010761,27,18,65,376,1151,1637
E01033695,22,24,71,401,1457,1975
E01033696,15,24,47,157,1290,1533
E01033697,108,33,65,2157,474,2837
E01010663,45,59,97,708,732,1641
E01010665,33,24,83,770,751,1661
E01010666,14,20,79,411,1027,1551
E01010667,27,71,73,621,813,1605
E01010735,48,117,113,831,667,1776
E01010738,35,97,68,1430,402,2032
E01010739,16,72,128,762,811,1789
E01010740,59,38,50,1367,302,1816
E01010744,39,56,53,1373,304,1825
E01010612,4,69,70,43,1191,1377
E01010819,8,88,49,50,1378,1573
E01010820,3,88,59,17,1358,1525
E01010821,7,117,90,65,1767,2046
E01010822,7,60,38,52,1255,1412
E01010615,32,22,71,200,1094,1419
E01010616,38,125,79,800,817,1859
E01010742,59,90,77,1323,439,1988
E01010743,85,143,76,971,542,1817
E01010847,3,15,48,169,1344,1579
E01010848,1,19,61,225,1198,1504
E01010852,11,49,51,452,1031,1594
E01010853,61,32,55,201,976,1325
E01010668,7,24,21,401,903,1356
E01010755,9,40,72,58,1494,1673
E01010762,34,22,69,381,1088,1594
E01010763,4,11,25,202,1289,1531
E01010846,41,55,82,193,1779,2150
E01010745,16,71,72,653,845,1657
E01010747,27,50,77,495,965,1614
E01010748,4,49,65,38,1351,1507
E01010749,6,16,50,31,1241,1344
E01010814,7,22,51,45,1527,1652
E01010815,64,102,110,332,1789,2397
E01010816,21,46,49,71,1686,1873
E01010817,33,109,66,147,1831,2186
E01010818,55,38,50,314,1399,1856
E01010752,1,11,39,109,1573,1733
E01010753,1,2,16,14,1404,1437
E01010754,0,6,29,36,1536,1607
E01010756,2,5,31,49,1391,1478
E01010758,7,7,14,27,1235,1290
E01010759,17,9,29,25,1485,1565
E01010760,3,3,12,6,1552,1576
E01010741,1,10,57,108,1311,1487
E01010845,13,76,93,80,1769,2031
E01010849,3,4,25,24,1373,1429
E01010850,2,35,44,23,1277,1381
E01010851,6,17,40,87,1435,1585
E01010864,4,18,49,40,1209,1320
E01010867,2,35,54,65,1312,1468
E01010874,1,14,44,15,1166,1240
E01010746,5,5,42,280,1296,1628
E01010750,6,20,27,67,1497,1617
E01010751,7,19,31,34,1418,1509
E01010865,4,6,30,36,1542,1618
E01010866,3,13,69,49,1245,1379
E01010868,9,44,76,58,1415,1602
E01010869,11,20,47,49,1567,1694
E01010870,5,8,25,21,1444,1503
E01010871,32,14,34,64,1542,1686
E01010872,2,34,35,37,1519,1627
E01010873,0,8,11,29,1176,1224
E01010911,0,2,27,10,1674,1713
E01010912,2,3,18,5,1558,1586
E01010913,0,2,11,2,1268,1283
E01010915,0,12,11,5,1401,1429
E01010914,0,4,28,14,1795,1841
E01010924,1,16,29,15,1125,1186
E01010925,0,4,19,10,1371,1404
E01010926,1,6,19,2,1168,1196
E01010931,3,3,12,21,1367,1406
E01010932,3,0,18,30,1496,1547
E01010933,0,0,12,32,1534,1578
E01010935,0,2,17,25,1516,1560
E01010936,1,7,15,31,1946,2000
E01010937,1,2,17,12,1528,1560
E01010881,6,5,31,4,1606,1652
E01010882,2,3,25,14,1404,1448
E01010883,0,4,11,3,1515,1533
E01010887,5,1,13,13,1577,1609
E01010888,3,5,48,15,1460,1531
E01010923,11,8,42,8,1532,1601
E01010916,1,4,20,11,1391,1427
E01010939,5,6,19,14,1722,1766
E01010941,1,2,22,5,1316,1346
E01010942,7,7,36,16,1539,1605
E01010944,2,6,25,35,1311,1379
E01010938,2,29,40,23,1333,1427
E01010940,0,15,29,12,1381,1437
E01010943,0,10,36,8,1441,1495
E01010961,0,5,9,19,1130,1163
E01010917,0,1,16,25,1772,1814
E01010918,6,5,16,7,1661,1695
E01010919,1,4,18,5,1563,1591
E01010920,4,4,12,23,1627,1670
E01010921,1,10,22,16,1591,1640
E01010934,10,3,15,10,1929,1967
E01010967,7,7,24,17,1449,1504
E01010994,14,29,46,273,1365,1727
E01032923,3,17,41,50,2202,2313
E01010927,3,3,22,24,1605,1657
E01010928,1,12,31,54,1317,1415
E01010997,0,6,5,119,1325,1455
E01010999,0,3,25,141,1329,1498
E01010929,21,26,59,798,1465,2369
E01010930,2,4,38,104,1428,1576
E01010998,1,6,21,339,1244,1611
E01011000,11,13,45,1350,641,2060
E01010904,1,3,20,3,1368,1395
E01010906,1,2,10,19,1379,1411
E01010907,5,3,15,25,1388,1436
E01010909,1,2,24,28,1466,1521
E01010960,29,28,17,1120,498,1692
E01010964,22,40,25,1105,437,1629
E01010965,14,20,26,1089,324,1473
E01010966,26,33,41,1353,238,1691
E01010995,14,5,35,979,318,1351
E01010982,1,6,20,90,1219,1336
E01010983,2,2,36,233,1337,1610
E01010985,0,4,10,15,1387,1416
E01010986,4,5,21,16,1644,1690
E01010987,1,7,33,17,1733,1791
E01010988,2,2,18,29,1423,1474
E01010996,6,27,33,1273,264,1603
E01011001,5,13,20,1321,281,1640
E01011002,10,7,35,772,921,1745
E01011003,3,12,24,499,676,1214
E01010878,3,12,30,27,1684,1756
E01010879,3,5,11,11,1804,1834
E01010905,1,6,19,6,1833,1865
E01010908,3,13,20,25,2025,2086
E01010910,4,5,19,7,1240,1275
E01010969,2,8,35,172,1480,1697
E01010970,7,10,23,268,1533,1841
E01010974,8,4,35,570,907,1524
E01010977,1,2,11,17,1484,1515
E01010975,1,3,12,20,1497,1533
E01010976,5,2,27,31,1729,1794
E01010978,1,5,21,22,1254,1303
E01010979,6,1,14,37,1455,1513
E01010980,0,3,11,32,1453,1499
E01010981,2,3,20,16,1431,1472
E01010989,2,5,20,91,1383,1501
E01010990,9,0,14,7,1606,1636
E01010991,1,5,19,12,1539,1576
E01010992,4,8,27,36,1634,1709
E01010993,4,6,11,31,1634,1686
E01010875,4,1,14,21,1694,1734
E01010876,2,3,17,18,1588,1628
E01010877,1,10,12,41,1461,1525
E01010880,0,16,27,18,1421,1482
E01010949,8,4,22,33,1478,1545
E01010922,0,9,6,12,1884,1911
E01010956,0,2,8,3,1526,1539
E01010958,2,3,18,11,1437,1471
E01010959,0,1,26,7,1742,1776
E01010968,12,4,23,174,1610,1823
E01010971,6,9,25,141,1725,1906
E01010972,18,15,18,177,1365,1593
E01010973,9,5,24,65,1570,1673
E01010884,1,1,6,12,1582,1602
E01010885,2,1,10,4,1413,1430
E01010886,0,2,12,1,1098,1113
E01010984,0,0,16,60,1211,1287
E01010946,1,11,15,46,1306,1379
E01010947,0,8,12,29,1441,1490
E01010950,1,11,21,6,1401,1440
E01010951,6,7,24,24,1450,1511
E01010891,9,11,45,18,1654,1737
E01010892,2,8,23,54,1817,1904
E01010895,1,7,17,24,1391,1440
E01010945,1,7,17,33,1560,1618
E01010948,1,5,14,24,1407,1451
E01010889,1,10,43,49,1639,1742
E01010890,1,6,28,82,1675,1792
E01010893,0,3,21,49,1347,1420
E01010894,0,17,38,154,1405,1614
E01010901,1,4,20,95,1533,1653
E01010903,3,6,14,33,1611,1667
E01010896,4,0,17,0,1607,1628
E01010897,2,12,17,19,1621,1671
E01010898,1,8,18,14,1610,1651
E01010899,0,1,21,12,1374,1408
E01010900,2,0,8,17,1568,1595
E01010902,2,7,25,7,1575,1616
E01010952,0,0,7,10,1529,1546
E01010953,1,7,8,10,1441,1467
E01010954,1,2,35,18,2333,2389
E01010955,6,1,17,54,1393,1471
E01010957,0,1,11,3,1470,1485
E01011051,15,9,21,17,1504,1566
E01011055,6,1,13,59,1185,1264
E01011056,7,9,28,39,1559,1642
E01011057,5,13,19,23,1305,1365
E01011058,1,8,20,9,1225,1263
E01011048,6,10,23,18,1582,1639
E01011049,2,9,18,23,1592,1644
E01011050,0,4,14,14,1488,1520
E01011052,6,7,11,13,1605,1642
E01011053,0,6,23,16,1431,1476
E01011059,2,4,34,25,1459,1524
E01011062,0,2,23,39,1630,1694
E01011064,0,7,13,26,1424,1470
E01011068,0,7,11,18,1633,1669
E01011069,1,6,12,21,1301,1341
E01011241,5,1,21,40,1638,1705
E01011242,6,8,13,39,1514,1580
E01011243,3,4,22,28,1624,1681
E01011244,0,17,19,33,1964,2033
E01011060,8,13,17,65,1542,1645
E01011061,4,11,13,80,1581,1689
E01011063,2,13,16,94,1922,2047
E01011065,5,4,22,26,1605,1662
E01011066,2,10,20,53,1430,1515
E01011027,0,1,31,60,1166,1258
E01011028,2,3,27,103,1346,1481
E01011030,13,4,43,107,1363,1530
E01011031,8,7,29,198,1385,1627
E01011054,3,2,16,77,1287,1385
E01011013,2,2,16,222,1302,1544
E01011014,4,12,42,634,842,1534
E01011023,5,6,20,669,970,1670
E01011024,5,9,26,633,1089,1762
E01011067,0,3,16,35,1532,1586
E01011247,2,0,13,41,1523,1579
E01011249,1,6,20,36,1522,1585
E01011251,3,22,36,16,1545,1622
E01011245,1,6,24,54,1481,1566
E01011246,2,4,25,128,1316,1475
E01011248,4,7,8,48,1419,1486
E01011250,4,6,24,50,1563,1647
E01011015,8,2,22,1207,368,1607
E01011029,10,11,22,440,963,1446
E01011032,3,7,18,612,926,1566
E01011034,1,6,25,1301,296,1629
E01011157,4,6,19,806,810,1645
E01011161,4,3,19,113,1172,1311
E01011163,0,12,13,124,1221,1370
E01011164,5,6,19,105,1560,1695
E01011165,3,8,18,929,865,1823
E01011166,9,10,15,482,1107,1623
E01011167,5,13,41,800,1073,1932
E01011033,1,9,28,367,1281,1686
E01011035,10,13,16,1363,283,1685
E01011036,15,6,27,943,737,1728
E01011037,4,14,42,750,1294,2104
E01011016,6,2,25,976,548,1557
E01011017,1,1,16,1538,118,1674
E01011018,6,1,18,1214,301,1540
E01011019,2,2,15,1041,654,1714
E01011020,4,4,19,994,327,1348
E01011021,3,3,14,100,1523,1643
E01011022,0,11,27,167,1244,1449
E01011126,1,5,23,39,1479,1547
E01011127,2,2,22,62,1327,1415
E01011156,2,4,26,39,1485,1556
E01011158,1,2,27,200,1578,1808
E01011159,0,3,11,21,1708,1743
E01011160,0,2,14,46,1337,1399
E01011162,1,4,12,30,1438,1485
E01011025,6,6,47,288,1223,1570
E01011026,11,7,20,887,585,1510
E01011136,2,30,35,388,1025,1480
E01011137,18,6,31,182,1279,1516
E01011128,5,4,29,1155,807,2000
E01011130,15,11,33,696,1262,2017
E01033542,13,14,47,1315,1527,2916
E01011121,2,9,24,12,1435,1482
E01011122,0,6,14,2,1392,1414
E01011123,1,19,29,325,1249,1623
E01011124,2,0,22,29,1805,1858
E01011125,0,9,24,78,1432,1543
E01011129,1,4,40,75,1233,1353
E01011138,16,22,77,827,742,1684
E01011139,3,8,31,621,783,1446
E01011140,3,5,36,1006,593,1643
E01011141,0,7,33,1091,656,1787
E01011132,1,2,21,63,1358,1445
E01011142,2,2,17,22,1514,1557
E01011217,1,1,12,26,1561,1601
E01011218,6,1,16,26,1577,1626
E01011216,2,14,30,28,1390,1464
E01011219,0,9,15,18,1509,1551
E01011220,5,20,60,17,1691,1793
E01011221,5,8,18,10,1703,1744
E01011046,5,20,15,204,1088,1332
E01011100,25,148,147,152,1030,1502
E01011102,20,46,68,175,1105,1414
E01011108,21,71,50,217,1101,1460
E01011133,9,6,35,886,547,1483
E01011134,8,8,69,1350,529,1964
E01011143,20,5,41,1099,456,1621
E01011144,13,23,26,1037,411,1510
E01011260,8,12,16,452,866,1354
E01011257,5,7,1,2197,16,2226
E01011258,21,5,29,1957,62,2074
E01011259,5,8,9,1103,572,1697
E01011261,8,2,30,1001,361,1402
E01011262,22,8,22,1080,524,1656
E01011263,9,8,25,541,1053,1636
E01011101,26,418,211,80,1003,1738
E01011103,20,278,128,67,837,1330
E01011104,18,237,176,159,993,1583
E01011105,58,265,235,251,1232,2041
E01011212,0,4,46,20,1542,1612
E01011213,4,3,9,24,1547,1587
E01011214,7,2,18,24,1494,1545
E01011215,2,15,34,32,1955,2038
E01011039,32,89,63,825,799,1808
E01011042,30,44,55,461,1000,1590
E01011047,15,25,25,122,1362,1549
E01011210,18,47,38,327,1522,1952
E01011252,2,2,11,31,1105,1151
E01011253,0,6,14,11,1233,1264
E01011254,0,3,15,42,1454,1514
E01011255,0,1,30,16,1417,1464
E01011256,4,2,13,32,1304,1355
E01011038,59,267,116,535,736,1713
E01011041,31,171,155,439,743,1539
E01011106,25,219,124,134,983,1485
E01011107,101,177,138,455,942,1813
E01011201,10,40,58,152,1471,1731
E01011203,13,24,21,153,1594,1805
E01011209,4,9,29,60,1454,1556
E01011211,6,39,39,153,1354,1591
E01011040,28,105,68,892,786,1879
E01011043,30,131,84,1159,942,2346
E01011044,36,77,39,731,659,1542
E01011045,42,170,84,1092,500,1888
E01011089,6,19,39,18,1215,1297
E01011091,0,12,26,20,1398,1456
E01011092,0,2,30,10,1234,1276
E01011200,7,35,53,123,2139,2357
E01011204,13,7,15,256,1194,1485
E01011206,0,26,55,140,1458,1679
E01011208,2,46,95,126,1337,1606
E01011240,27,62,75,225,1310,1699
E01011231,7,43,58,165,1260,1533
E01011236,100,130,69,481,960,1740
E01011238,51,46,48,327,1170,1642
E01011239,15,52,62,285,1213,1627
E01011093,46,119,85,109,1077,1436
E01011094,17,214,104,114,1093,1542
E01011096,16,78,77,336,1054,1561
E01011098,30,68,76,173,1185,1532
E01011146,0,9,19,12,1517,1557
E01011151,5,1,21,10,1599,1636
E01011202,17,16,43,154,1335,1565
E01011205,7,14,15,80,1489,1605
E01011090,10,41,68,77,1354,1550
E01011095,3,36,32,49,1285,1405
E01011097,14,61,53,142,1290,1560
E01011099,20,73,60,47,1289,1489
E01011150,5,17,38,26,1530,1616
E01011155,1,13,44,29,1774,1861
E01011207,5,32,30,117,1311,1495
E01011234,7,59,98,129,1194,1487
E01011232,27,63,62,602,885,1639
E01011233,26,34,75,354,1164,1653
E01011235,58,120,73,638,925,1814
E01011237,20,49,53,628,911,1661
E01011004,24,51,66,58,1164,1363
E01011006,4,44,59,98,1342,1547
E01011008,6,54,51,87,1307,1505
E01011012,78,44,50,113,1383,1668
E01011145,12,14,24,18,1462,1530
E01011147,3,14,37,18,1461,1533
E01011148,6,45,92,40,1473,1656
E01011152,4,13,16,12,1663,1708
E01011007,8,76,66,99,1237,1486
E01011223,23,159,125,125,1550,1982
E01011225,44,83,119,184,1358,1788
E01011229,104,125,77,580,1995,2881
E01011080,54,61,73,871,865,1924
E01011081,55,91,58,677,928,1809
E01011082,59,73,22,1582,100,1836
E01011230,144,55,70,1479,346,2094
E01011005,10,34,26,66,1385,1521
E01011009,8,25,43,42,1222,1340
E01011010,16,103,88,90,1275,1572
E01011011,7,9,23,34,1503,1576
E01011077,7,16,33,13,1543,1612
E01011149,4,55,78,86,1637,1860
E01011153,3,50,43,82,1537,1715
E01011154,14,53,77,59,1385,1588
E01011191,1,13,22,12,1528,1576
E01011192,3,2,36,15,1521,1577
E01011193,0,12,31,34,1835,1912
E01011194,4,0,4,27,1335,1370
E01011079,18,73,78,512,1206,1887
E01011083,14,48,40,420,1260,1782
E01011084,41,192,132,547,907,1819
E01011085,7,75,74,257,1141,1554
E01011224,25,95,104,139,1363,1726
E01011226,8,26,35,161,1330,1560
E01011227,15,87,103,99,1315,1619
E01011228,12,17,36,113,1321,1499
E01011071,2,4,18,20,1634,1678
E01011072,3,5,16,19,1570,1613
E01011073,3,18,36,23,1424,1504
E01011078,1,9,26,19,1699,1754
E01011086,5,11,33,179,1400,1628
E01011087,5,29,50,38,1466,1588
E01011088,0,13,4,23,1374,1414
E01011222,19,69,64,72,1544,1768
E01011190,0,4,19,39,1555,1617
E01011195,17,33,39,97,2044,2230
E01011196,1,4,23,25,1767,1820
E01011197,1,9,34,11,1510,1565
E01011070,0,9,21,12,1532,1574
E01011074,3,4,17,8,1880,1912
E01011075,0,6,8,10,1415,1439
E01011076,1,21,20,8,1426,1476
E01011169,6,4,16,6,1416,1448
E01011170,2,2,23,20,1791,1838
E01011171,3,6,17,16,1346,1388
E01011172,1,16,26,31,942,1016
E01011173,1,13,13,15,1279,1321
E01011176,0,5,34,24,1369,1432
E01011109,1,0,7,6,1781,1795
E01011113,2,1,12,1,1675,1691
E01011114,0,2,16,16,1503,1537
E01011119,0,1,13,12,1471,1497
E01011168,0,6,11,6,1608,1631
E01011174,0,6,21,21,1803,1851
E01011175,0,1,20,21,1408,1450
E01011177,3,0,21,24,1697,1745
E01011178,2,3,24,27,1801,1857
E01011118,1,4,16,9,1548,1578
E01011120,3,1,16,11,1544,1575
E01011198,3,3,13,7,1567,1593
E01011199,1,3,10,10,1494,1518
E01011110,1,7,2,8,1340,1358
E01011111,0,1,24,10,1599,1634
E01011112,3,7,13,12,1581,1616
E01011115,0,3,11,4,1772,1790
E01011116,0,2,10,17,1632,1661
E01011117,0,1,12,19,1754,1786
E01011180,1,2,29,16,1869,1917
E01011182,0,2,20,9,1703,1734
E01011186,0,3,17,7,1581,1608
E01011188,1,3,28,14,1671,1717
E01011179,0,6,9,8,1748,1771
E01011181,2,3,13,6,1764,1788
E01011183,2,1,15,5,1976,1999
E01011184,1,13,14,9,1435,1472
E01011185,0,6,14,12,1533,1565
E01011187,7,9,31,21,1690,1758
E01011189,0,1,14,13,1575,1603
E01011698,0,2,8,12,1481,1503
E01011699,1,1,7,19,1317,1345
E01011701,0,5,14,10,1258,1287
E01011702,2,4,6,9,1163,1184
E01011703,3,3,13,12,1248,1279
E01011697,2,23,70,113,1883,2091
E01011700,6,8,24,21,1294,1353
E01011704,4,3,8,19,1736,1770
E01011705,1,2,12,7,1356,1378
E01011581,0,2,14,7,1446,1469
E01011582,0,3,21,23,1604,1651
E01011583,2,6,18,15,1438,1479
E01011584,1,1,11,8,1229,1250
E01011569,1,8,17,13,1623,1662
E01011571,2,2,11,10,1572,1597
E01011572,0,3,11,15,1734,1763
E01011573,6,1,13,11,1310,1341
E01011574,5,4,26,4,1417,1456
E01011707,4,0,7,3,1345,1359
E01011709,8,1,10,5,1564,1588
E01011710,0,2,10,7,1402,1421
E01011711,1,1,11,13,1363,1389
E01011712,1,0,2,7,1349,1359
E01011561,4,14,32,122,1045,1217
E01011696,5,11,10,30,1442,1498
E01011706,2,2,28,19,1475,1526
E01011708,8,3,16,17,1424,1468
E01011713,16,14,23,35,1755,1843
E01011570,6,15,34,36,2193,2284
E01011576,15,7,17,30,1363,1432
E01032503,5,1,11,21,1427,1465
E01032504,7,4,33,44,1496,1584
E01011266,11,12,18,54,1932,2027
E01011270,5,6,16,39,1550,1616
E01011279,0,2,15,11,1284,1312
E01011280,6,6,17,13,1715,1757
E01011265,6,0,24,15,1580,1625
E01011267,1,6,23,25,1441,1496
E01011271,17,4,24,24,2089,2158
E01011272,8,6,14,11,1482,1521
E01011268,4,3,8,21,1358,1394
E01011273,4,7,11,26,1439,1487
E01011274,1,3,23,14,1447,1488
E01011275,2,0,11,11,1326,1350
E01011264,1,0,5,6,1267,1279
E01011269,1,2,17,23,1509,1552
E01011276,6,3,15,26,1334,1384
E01011578,1,7,15,17,1281,1321
E01011554,32,25,34,119,1236,1446
E01011562,25,17,21,272,1257,1592
E01011563,18,19,16,177,1186,1416
E01011564,12,30,29,133,1297,1501
E01011567,21,28,26,208,1110,1393
E01011376,1,7,12,17,1479,1516
E01011377,4,4,8,47,1323,1386
E01011378,75,27,57,88,1147,1394
E01011382,8,15,22,29,1382,1456
E01011277,0,8,11,44,1448,1511
E01011278,5,11,21,34,1560,1631
E01011579,1,3,13,8,1220,1245
E01011580,0,0,9,23,1310,1342
E01011556,24,37,67,289,1159,1576
E01011557,41,22,30,210,1226,1529
E01011565,54,35,28,218,1098,1433
E01011566,33,16,19,241,1000,1309
E01011568,52,20,27,311,1421,1831
E01011380,27,18,15,108,1355,1523
E01011381,70,5,24,175,1038,1312
E01011385,23,35,24,158,1009,1249
E01011386,38,15,39,150,1177,1419
E01011379,49,27,39,63,1304,1482
E01011384,37,11,36,37,1364,1485
E01032501,8,10,24,23,1108,1173
E01032502,95,19,76,68,1584,1842
E01011555,28,27,32,243,1032,1362
E01011558,55,101,97,218,1106,1577
E01011559,43,85,54,154,923,1259
E01011560,77,133,124,189,1277,1800
E01011383,81,42,40,128,1275,1566
E01011388,61,8,38,87,1213,1407
E01011684,42,12,35,166,1293,1548
E01011695,65,18,82,82,1343,1590
E01011650,34,20,22,164,1203,1443
E01011651,21,56,72,123,1174,1446
E01011653,11,19,57,124,1141,1352
E01011655,12,17,27,88,1252,1396
E01011455,1,4,16,29,1332,1382
E01011456,4,1,21,19,1662,1707
E01011459,5,8,18,31,1520,1582
E01011461,1,1,8,17,1503,1530
E01011311,13,2,23,121,1058,1217
E01011649,2,2,23,61,1378,1466
E01011715,2,2,18,20,1247,1289
E01011719,2,1,7,18,1399,1427
E01011509,26,22,37,196,1070,1351
E01011511,55,44,36,354,840,1329
E01011512,40,50,37,313,1126,1566
E01011515,17,21,46,174,1163,1421
E01011516,46,66,46,243,1303,1704
E01011508,44,31,37,371,931,1414
E01011517,28,76,87,186,1261,1638
E01011652,26,29,49,173,1054,1331
E01011654,5,35,39,124,1231,1434
E01011505,74,58,43,403,1021,1599
E01011506,35,52,40,552,760,1439
E01011507,35,43,36,241,1225,1580
E01011510,34,50,88,127,1277,1576
E01011514,59,39,50,389,1094,1631
E01011452,4,0,22,26,1472,1524
E01011454,8,7,25,52,1400,1492
E01011457,7,11,17,84,1472,1591
E01011458,2,4,22,20,1334,1382
E01011465,9,13,23,34,1453,1532
E01011453,4,6,35,21,1416,1482
E01011460,3,23,36,30,1317,1409
E01011462,19,20,42,57,1494,1632
E01011463,10,14,31,54,1474,1583
E01011464,9,22,27,44,1576,1678
E01011714,1,19,26,88,1340,1474
E01011716,8,27,15,233,1203,1486
E01011717,5,24,19,61,1386,1495
E01011718,0,13,31,18,1338,1400
E01011720,1,20,20,15,1442,1498
E01011296,2,4,4,1,1667,1678
E01011297,6,7,25,21,1526,1585
E01011309,1,2,14,13,1477,1507
E01011310,4,10,19,33,1557,1623
E01011513,11,56,68,260,1786,2181
E01011688,28,115,102,219,1024,1488
E01011689,17,32,35,46,1422,1552
E01011691,10,100,127,80,1210,1527
E01011504,21,101,117,97,1090,1426
E01011641,2,36,58,119,1307,1522
E01011642,28,42,66,281,909,1326
E01011645,3,54,86,216,1113,1472
E01011484,15,60,63,109,1291,1538
E01011485,34,77,47,134,1232,1524
E01011686,24,30,58,128,1305,1545
E01032493,19,26,48,71,1179,1343
E01032494,23,72,87,96,1467,1745
E01011350,34,91,43,193,1264,1625
E01011351,11,33,55,64,1533,1696
E01011352,22,98,98,94,1478,1790
E01011353,24,127,75,125,1514,1865
E01011656,5,41,59,38,1347,1490
E01011657,6,15,28,33,1225,1307
E01011659,1,12,25,25,1310,1373
E01011661,10,18,33,12,1525,1598
E01011643,15,34,26,183,1134,1392
E01011644,8,38,47,117,1039,1249
E01011646,38,81,88,392,1067,1666
E01011647,33,115,45,1094,429,1716
E01011648,47,150,38,825,684,1744
E01011354,12,246,107,81,951,1397
E01011355,21,100,100,66,1091,1378
E01011357,57,614,183,350,710,1914
E01011450,50,91,70,129,886,1226
E01011588,11,6,32,46,1630,1725
E01011589,11,8,33,30,1439,1521
E01011590,4,2,12,50,1472,1540
E01011592,1,2,9,13,1377,1402
E01011593,1,3,25,63,1672,1764
E01011421,19,87,54,278,1048,1486
E01011425,7,123,44,208,1179,1561
E01011658,2,50,55,32,1205,1344
E01011660,4,31,44,25,1255,1359
E01011662,16,59,21,37,1056,1189
E01011721,2,26,25,13,1456,1522
E01011722,1,39,55,27,1771,1893
E01011723,12,8,44,21,1332,1417
E01011724,5,25,42,22,1727,1821
E01011356,58,330,129,400,1009,1926
E01011358,15,282,130,185,841,1453
E01011359,18,346,118,394,806,1682
E01011360,30,645,165,962,273,2075
E01011361,28,1234,276,549,391,2478
E01011435,7,26,60,51,1676,1820
E01011440,10,18,44,35,1515,1622
E01011441,19,40,70,181,1644,1954
E01032945,6,24,90,136,2907,3163
E01011477,175,123,80,274,1276,1928
E01011480,52,18,43,231,1246,1590
E01011488,12,17,67,46,1289,1431
E01011489,25,26,45,78,1513,1687
E01011324,13,99,71,38,2030,2251
E01011325,9,23,20,35,1349,1436
E01011326,6,33,21,22,1277,1359
E01011332,5,37,37,33,1228,1340
E01011423,10,143,75,333,1061,1622
E01011424,14,174,79,541,792,1600
E01011427,23,173,78,785,710,1769
E01011431,21,250,124,281,1202,1878
E01011422,36,163,90,848,348,1485
E01011426,48,222,114,1154,167,1705
E01011428,80,191,57,1242,300,1870
E01011429,39,315,181,1169,303,2007
E01011663,5,74,50,24,1103,1256
E01011664,2,17,27,29,1035,1110
E01011665,3,9,32,32,1310,1386
E01011667,2,67,54,24,1344,1491
E01011323,1,4,14,13,1235,1267
E01011329,7,4,26,6,1443,1486
E01011330,1,9,21,25,1198,1254
E01011333,3,19,32,12,1197,1263
E01011327,5,20,22,26,1252,1325
E01011328,1,19,37,8,1426,1491
E01011335,2,16,33,36,1584,1671
E01011591,4,5,13,39,1555,1616
E01011430,46,146,47,924,345,1508
E01011432,23,198,79,699,559,1558
E01011433,33,254,92,367,792,1538
E01011434,36,223,89,571,478,1397
E01011445,7,22,47,159,1444,1679
E01011446,38,24,79,236,1197,1574
E01011447,23,28,57,215,1105,1428
E01011448,35,62,87,203,1185,1572
E01011449,9,43,63,283,985,1383
E01011670,101,381,167,443,1542,2634
E01011671,45,405,151,188,746,1535
E01033002,217,172,52,198,671,1310
E01033003,171,459,114,305,734,1783
E01033005,181,362,161,832,1994,3530
E01011478,16,51,87,124,1401,1679
E01011479,13,41,63,53,1306,1476
E01011481,53,92,81,398,954,1578
E01011482,19,90,64,54,1466,1693
E01011483,30,129,94,405,912,1570
E01011406,0,13,10,7,1373,1403
E01011407,2,9,24,17,1396,1448
E01011408,1,7,11,10,1422,1451
E01011409,4,7,12,12,1362,1397
E01011410,0,16,11,20,1227,1274
E01011412,3,1,7,8,1351,1370
E01011331,2,12,20,8,1196,1238
E01011334,1,16,32,13,1231,1293
E01011336,3,10,26,10,1476,1525
E01011337,9,34,31,40,1285,1399
E01011281,16,97,86,147,1532,1878
E01011282,4,12,31,12,1319,1378
E01011283,1,54,51,43,1182,1331
E01011286,5,28,23,78,1110,1244
E01011295,3,46,28,27,1422,1526
E01011339,4,246,79,171,1283,1783
E01011340,12,266,81,139,1118,1616
E01011342,10,240,48,71,1041,1410
E01011346,10,142,74,49,1516,1791
E01011341,1,39,47,35,1362,1484
E01011343,5,37,53,35,1533,1663
E01011345,15,13,39,45,1306,1418
E01011666,1,11,30,28,1420,1490
E01011585,1,6,22,28,1378,1435
E01011587,0,5,15,44,1599,1663
E01011594,0,9,16,17,1413,1455
E01011596,1,14,20,29,1611,1675
E01011598,0,7,25,30,1482,1544
E01011678,64,129,144,518,3301,4156
E01011681,50,141,95,507,941,1734
E01033006,185,166,152,773,2109,3385
E01011338,107,571,127,128,738,1671
E01011673,81,353,133,521,603,1691
E01011677,38,273,92,360,763,1526
E01033031,67,140,67,203,812,1289
E01033035,161,447,125,281,398,1412
E01011344,30,191,142,207,1194,1764
E01011347,17,274,109,122,1149,1671
E01011348,31,307,81,118,1085,1622
E01011349,53,242,96,173,1152,1716
E01011586,25,30,21,409,1009,1494
E01011595,81,26,40,719,938,1804
E01011597,36,19,30,639,783,1507
E01011599,11,9,21,195,1299,1535
E01011287,0,16,31,31,1242,1320
E01032499,25,24,20,183,1497,1749
E01032500,3,19,34,123,965,1144
E01032606,7,10,39,46,1880,1982
E01032607,8,17,27,60,989,1101
E01032608,10,21,24,150,965,1170
E01011608,6,10,12,15,1341,1384
E01011609,0,2,32,23,1396,1453
E01011610,4,8,13,38,1355,1418
E01011611,0,3,27,18,1316,1364
E01011614,3,9,24,53,1722,1811
E01011413,0,8,9,5,1540,1562
E01011415,3,7,26,11,1547,1594
E01011416,1,6,20,5,1466,1498
E01011417,1,10,11,26,1448,1496
E01011420,2,5,16,12,1258,1293
E01011615,2,34,33,66,1394,1529
E01011617,3,85,34,82,1404,1608
E01011618,7,60,52,88,1374,1581
E01011621,4,146,53,51,1232,1486
E01011284,12,22,64,68,1585,1751
E01011292,15,46,41,269,1248,1619
E01011293,48,69,68,295,1240,1720
E01011294,5,39,49,206,1219,1518
E01011363,22,160,68,71,1293,1614
E01011616,5,40,50,20,1316,1431
E01011620,11,94,33,35,1141,1314
E01011622,4,197,75,89,1270,1635
E01011624,5,170,98,98,1452,1823
E01011411,10,9,18,28,1526,1591
E01011414,3,6,12,14,1449,1484
E01011418,2,10,11,30,1423,1476
E01011419,3,2,9,14,1195,1223
E01011396,5,8,25,34,1694,1766
E01011399,0,4,8,10,1459,1481
E01011400,1,2,14,8,1403,1428
E01011403,2,5,4,15,1370,1396
E01011623,32,179,96,92,1118,1517
E01011625,9,106,36,93,1228,1472
E01011626,22,178,103,110,1369,1782
E01033021,15,145,74,78,988,1300
E01033033,52,39,51,145,1293,1580
E01033034,28,31,43,81,842,1025
E01011602,6,3,14,50,1452,1525
E01011603,5,4,16,48,1443,1516
E01011605,0,2,20,10,1426,1458
E01011606,8,12,54,268,1340,1682
E01011613,3,5,18,47,1230,1303
E01011397,3,4,16,19,1464,1506
E01011398,0,1,6,11,1239,1257
E01011401,0,15,5,22,1467,1509
E01011404,0,3,5,9,1304,1321
E01011405,0,4,14,1,1406,1425
E01011725,2,55,61,48,1391,1557
E01011729,3,37,42,92,1440,1614
E01011730,3,25,36,28,1467,1559
E01011735,0,38,25,35,1561,1659
E01011600,3,7,15,21,1473,1519
E01011601,3,6,36,26,1423,1494
E01011604,3,4,15,41,1271,1334
E01011607,1,10,14,52,1511,1588
E01011612,0,5,14,20,1263,1302
E01011726,5,42,23,12,1367,1449
E01011727,14,13,26,31,1463,1547
E01011728,1,10,15,25,1363,1414
E01011739,0,27,41,26,1436,1530
E01011362,11,109,63,128,1509,1820
E01011731,5,7,12,31,1363,1418
E01011732,3,30,33,112,1683,1861
E01011733,3,12,19,18,1440,1492
E01011366,19,166,77,250,1076,1588
E01011368,18,140,49,176,892,1275
E01011370,20,106,35,420,1143,1724
E01033013,25,111,36,113,904,1189
E01033032,48,52,35,253,890,1278
E01011734,9,65,51,117,2073,2315
E01011736,2,5,19,42,1417,1485
E01011737,1,6,37,36,1483,1563
E01011738,0,7,14,41,1373,1435
E01011364,27,133,78,183,1210,1631
E01011371,19,98,62,226,1055,1460
E01011373,41,153,78,298,869,1439
E01011374,7,78,34,78,998,1195
E01011312,39,159,74,659,668,1599
E01011316,41,161,74,488,893,1657
E01011372,43,150,57,618,512,1380
E01011375,9,175,78,886,699,1847
E01011390,1,3,6,12,1421,1443
E01011391,2,6,19,15,1603,1645
E01011392,0,1,7,7,1448,1463
E01011402,6,8,15,16,1723,1768
E01011298,3,15,11,18,1491,1538
E01011299,5,14,19,7,2193,2238
E01011302,0,5,8,1,1392,1406
E01011303,0,7,6,5,1127,1145
E01011300,1,2,19,12,1435,1469
E01011301,1,3,10,1,1321,1336
E01011304,8,5,29,5,1544,1591
E01011305,1,11,20,10,1454,1496
E01011306,3,3,5,9,1322,1342
E01011315,15,12,41,115,1369,1552
E01011317,38,118,49,64,1436,1705
E01011318,35,137,59,63,1176,1470
E01011321,15,130,57,92,1250,1544
E01011369,6,15,38,62,1440,1561
E01011313,16,44,33,160,1342,1595
E01011314,8,14,55,215,1180,1472
E01011319,12,30,25,347,1154,1568
E01011320,8,47,33,245,1341,1674
E01011322,12,50,52,91,1339,1544
E01011471,0,54,60,27,1259,1400
E01011472,2,47,28,10,1511,1598
E01011473,1,147,49,31,1248,1476
E01011474,0,83,33,28,1313,1457
E01011518,17,14,46,128,1982,2187
E01011524,1,5,18,40,1177,1241
E01011526,10,12,27,63,1179,1291
E01011531,3,9,23,44,1382,1461
E01011466,7,30,35,3,1414,1489
E01011469,5,26,21,15,1393,1460
E01011475,2,74,33,11,1377,1497
E01011476,8,26,22,14,1125,1195
E01011519,4,8,11,19,1446,1488
E01011522,6,3,16,17,1354,1396
E01011525,1,12,25,36,1502,1576
E01011528,1,8,25,87,1475,1596
E01011532,6,14,29,10,1497,1556
E01011520,0,6,18,35,1432,1491
E01011521,3,9,17,63,1876,1968
E01011523,7,5,14,40,1716,1782
E01011527,7,4,11,31,1720,1773
E01011529,0,2,17,15,1400,1434
E01011635,1,8,20,39,1479,1547
E01011637,6,3,34,22,1703,1768
E01011638,0,1,12,18,1456,1487
E01032487,3,5,15,11,979,1013
E01032488,1,6,21,16,1802,1846
E01011627,1,11,13,27,1365,1417
E01011628,4,5,24,5,1290,1328
E01011629,5,7,18,6,1266,1302
E01011632,0,13,30,28,1264,1335
E01011633,9,2,6,34,1421,1472
E01011490,4,73,51,87,2303,2518
E01011502,0,23,9,19,1282,1333
E01032497,0,122,49,54,1271,1496
E01032498,0,7,22,9,1493,1531
E01011496,3,2,28,31,1446,1510
E01011630,0,5,17,59,2007,2088
E01011634,0,1,15,7,1476,1499
E01011636,0,8,17,24,1576,1625
E01011639,1,6,32,17,1467,1523
E01011491,1,35,24,11,1286,1357
E01011492,0,89,23,21,1233,1366
E01011493,2,58,13,14,1453,1540
E01011494,2,53,17,20,1212,1304
E01011497,3,101,36,41,1427,1608
E01011540,1,9,17,24,1388,1439
E01032489,4,13,34,31,1854,1936
E01032490,6,10,28,69,1283,1396
E01032491,14,4,5,41,1166,1230
E01032492,2,13,38,44,1894,1991
E01011307,1,1,10,3,1511,1526
E01011308,2,4,8,4,1510,1528
E01011393,12,1,12,6,1694,1725
E01011394,1,2,3,7,1224,1237
E01011395,1,18,17,9,1139,1184
E01011533,1,14,21,65,1193,1294
E01011541,13,10,17,45,1629,1714
E01011545,0,6,14,41,1327,1388
E01011547,2,14,29,70,1666,1781
E01011499,5,40,38,44,2461,2588
E01011500,5,11,13,7,1554,1590
E01032495,8,80,47,120,2144,2399
E01032496,6,12,25,34,1967,2044
E01011530,12,16,33,50,1349,1460
E01011534,0,13,23,21,1364,1421
E01011546,1,13,28,39,1583,1664
E01011548,0,7,16,25,1397,1445
E01011550,18,8,7,18,1353,1404
E01011537,8,10,24,25,1999,2066
E01011538,5,1,19,17,1465,1507
E01011551,0,8,19,30,1508,1565
E01011552,5,6,27,18,1411,1467
E01011535,4,7,16,32,1605,1664
E01011536,1,2,19,48,1517,1587
E01011549,18,4,17,75,1389,1503
E01011553,1,8,16,33,1378,1436
E01011685,21,18,56,159,1899,2153
E01011687,40,17,60,234,1137,1488
E01011690,9,6,31,65,1245,1356
E01011692,7,15,43,59,1280,1404
E01011693,13,18,65,54,1371,1521
E01011694,13,23,53,205,1510,1804
E01032876,21,26,83,153,2408,2691
E01011442,12,34,72,86,1415,1619
E01011443,23,24,46,100,1188,1381
E01011444,22,69,75,124,1559,1849
E01011451,19,28,75,86,1899,2107
E01011668,25,85,80,134,1285,1609
E01011669,36,62,67,99,1211,1475
E01032946,38,54,82,176,2122,2472
E01033008,115,20,44,143,798,1120
E01033010,291,69,90,620,1737,2807
E01033011,46,28,48,109,1142,1373
E01033015,47,16,48,150,906,1167
E01033016,53,25,44,119,776,1017
E01011467,18,102,32,154,1236,1542
E01011468,14,84,42,27,1333,1500
E01011470,3,38,22,24,1179,1266
E01033018,42,9,35,177,874,1137
E01033019,60,26,54,170,1390,1700
E01011740,4,6,1,5,1483,1499
E01011741,0,7,13,4,1462,1486
E01011742,0,7,9,1,1620,1637
E01011745,3,10,22,8,1702,1745
E01011746,0,4,3,8,1489,1504
E01011752,2,11,14,34,1486,1547
E01011753,0,1,11,11,1379,1402
E01011756,1,4,9,14,1416,1444
E01011760,1,10,6,16,1641,1674
E01011762,8,10,11,17,1526,1572
E01011743,2,0,9,1,1454,1466
E01011744,1,3,9,2,1606,1621
E01011747,4,18,10,15,1593,1640
E01011750,2,9,16,10,1535,1572
E01011754,1,10,2,13,1426,1452
E01011757,2,14,10,34,1791,1851
E01011759,3,3,13,21,1855,1895
E01011761,3,21,16,18,1827,1885
E01011763,3,4,14,4,1418,1443
E01011764,9,18,15,22,1488,1552
E01011748,0,9,6,4,1611,1630
E01011749,2,17,19,51,2030,2119
E01011751,0,2,4,13,1298,1317
E01011755,1,5,11,9,1621,1647
E01011873,3,14,10,12,1536,1575
E01011877,7,19,18,61,1391,1496
E01011894,0,7,12,28,1343,1390
E01011895,0,5,7,40,1430,1482
E01011875,1,3,22,8,1401,1435
E01011876,0,6,22,46,1327,1401
E01011878,5,8,15,29,1508,1565
E01011880,10,16,30,65,1359,1480
E01011881,2,2,11,25,1428,1468
E01011887,7,12,9,18,1171,1217
E01011893,4,16,6,16,1463,1505
E01011896,4,11,10,28,1338,1391
E01011897,2,2,11,32,1376,1423
E01011874,3,2,10,8,1632,1655
E01011879,0,0,11,13,1434,1458
E01011882,0,3,7,5,1496,1511
E01011883,4,3,11,21,1375,1414
E01011805,2,14,12,16,1419,1463
E01011807,1,4,14,26,1380,1425
E01011808,0,7,8,19,1697,1731
E01011810,2,2,4,16,1503,1527
E01011803,0,0,9,10,1360,1379
E01011804,1,3,5,3,1606,1618
E01011806,0,7,24,8,1476,1515
E01011809,15,1,10,7,1441,1474
E01011811,5,11,6,18,1538,1578
E01011835,0,12,21,15,1455,1503
E01011836,2,7,16,22,1415,1462
E01011839,4,5,12,14,1577,1612
E01011843,8,4,10,32,1589,1643
E01011844,2,8,11,15,1882,1918
E01011758,7,0,7,38,1298,1350
E01011812,1,8,23,80,2483,2595
E01011820,2,4,10,13,1456,1485
E01011821,1,11,5,15,1295,1327
E01011885,0,8,17,17,1432,1474
E01011886,1,5,17,21,1431,1475
E01011888,1,0,8,16,1418,1443
E01011890,0,9,21,23,1216,1269
E01011891,1,10,11,15,1488,1525
E01011834,0,19,13,22,1533,1587
E01011837,3,7,12,77,1368,1467
E01011838,14,33,16,41,1854,1958
E01011841,0,5,7,22,1488,1522
E01011842,1,11,16,21,1380,1429
E01011813,0,4,4,18,1595,1621
E01011814,1,17,9,17,1654,1698
E01011815,3,23,18,34,1445,1523
E01011816,0,6,14,12,1379,1411
E01011819,1,15,16,29,1506,1567
E01011822,4,7,10,6,1401,1428
E01011884,38,42,25,196,2038,2339
E01011912,42,64,36,476,934,1552
E01011913,29,27,36,742,826,1660
E01011916,51,115,41,306,1489,2002
E01011840,0,1,9,21,1509,1540
E01011850,0,1,6,17,1498,1522
E01011852,3,17,13,12,1581,1626
E01011853,0,5,13,21,1422,1461
E01011920,22,91,53,383,1756,2305
E01011923,13,15,31,83,1491,1633
E01011924,13,37,19,176,1291,1536
E01011925,19,34,29,94,1516,1692
E01011909,12,30,23,193,1146,1404
E01011910,22,25,17,110,1341,1515
E01011911,7,32,24,72,1391,1526
E01011914,36,37,33,148,1293,1547
E01011915,37,51,34,341,1148,1611
E01011823,0,10,7,18,1378,1413
E01011824,0,11,25,33,1451,1520
E01011825,7,10,20,18,1783,1838
E01011826,3,2,19,11,1399,1434
E01011827,0,3,11,12,1151,1177
E01011828,2,8,11,5,1401,1427
E01011889,6,8,17,36,1236,1303
E01011892,10,4,11,31,1745,1801
E01011919,8,36,21,88,1671,1824
E01011921,0,5,10,42,1411,1468
E01011926,13,23,27,292,1245,1600
E01011927,2,21,10,22,1298,1353
E01011845,1,2,6,13,1345,1367
E01011846,1,4,7,9,1341,1362
E01011847,0,4,9,10,1405,1428
E01011848,1,5,5,8,1450,1469
E01011851,5,11,8,16,1389,1429
E01011775,0,14,27,44,2782,2867
E01011776,1,5,10,25,1568,1609
E01011777,0,5,7,11,1329,1352
E01011778,0,5,7,12,1544,1568
E01011817,0,3,17,12,1300,1332
E01011818,1,1,8,14,1307,1331
E01011829,2,4,10,7,1403,1426
E01011830,3,3,8,7,1234,1255
E01011831,0,6,13,25,1664,1708
E01011832,0,5,8,12,1386,1411
E01011833,5,6,10,12,1474,1507
E01011899,8,17,51,18,1412,1506
E01011900,10,41,16,18,1446,1531
E01011901,4,44,23,51,1523,1645
E01011904,4,46,33,40,1304,1427
E01011918,1,41,17,34,1450,1543
E01011922,1,43,27,24,1357,1452
E01011779,3,0,2,8,1495,1508
E01011780,1,0,5,13,1813,1832
E01011781,9,3,8,11,1679,1710
E01011782,4,3,10,18,1455,1490
E01011783,2,8,7,24,1267,1308
E01011902,5,14,25,37,1309,1390
E01011903,16,28,8,28,1135,1215
E01011905,1,10,19,55,1533,1618
E01011907,17,50,21,233,1444,1765
E01011793,13,7,6,11,1584,1621
E01011794,8,3,25,5,1358,1399
E01011795,1,0,9,1,1267,1278
E01011796,4,3,14,5,1414,1440
E01011799,9,3,16,31,1531,1590
E01011800,1,12,19,21,1605,1658
E01011898,3,51,22,79,1301,1456
E01011906,11,89,45,52,1387,1584
E01011908,19,80,36,402,1678,2215
E01011917,46,58,50,357,1079,1590
E01011944,10,26,16,194,1143,1389
E01011797,6,5,17,12,1681,1721
E01011798,2,11,14,10,1264,1301
E01011801,1,4,16,18,1477,1516
E01011802,0,1,6,9,1492,1508
E01011765,0,5,5,6,1529,1545
E01011766,1,6,10,5,1501,1523
E01011773,3,1,8,12,1466,1490
E01011774,0,7,11,4,1365,1387
E01011939,9,3,7,55,1409,1483
E01011945,5,8,13,55,1410,1491
E01011947,17,4,29,80,1450,1580
E01011948,7,2,9,74,1498,1590
E01011767,3,5,10,10,1740,1768
E01011768,4,2,13,8,1347,1374
E01011769,1,11,15,17,2089,2133
E01011770,1,5,21,56,1829,1912
E01011849,1,9,9,10,1547,1576
E01011857,3,16,9,15,1598,1641
E01011928,1,2,7,3,1321,1334
E01011931,2,7,8,3,1486,1506
E01011932,6,2,13,15,1381,1417
E01011938,4,13,18,27,1644,1706
E01011929,4,0,7,9,1581,1601
E01011930,2,18,9,17,1665,1711
E01011933,0,4,12,25,1563,1604
E01011937,0,3,7,11,1399,1420
E01011934,0,4,8,26,1421,1459
E01011936,0,26,15,11,1424,1476
E01011940,7,5,9,16,1402,1439
E01011943,2,22,12,18,1687,1741
E01011935,6,3,15,27,1747,1798
E01011941,1,12,8,21,1407,1449
E01011942,0,1,9,19,1217,1246
E01011946,1,8,15,21,1437,1482
E01011785,1,8,18,21,1510,1558
E01011789,0,16,7,3,1242,1268
E01011791,2,4,17,5,1475,1503
E01011792,3,12,8,11,1482,1516
E01011771,1,8,12,2,1278,1301
E01011772,1,1,11,10,1570,1593
E01011784,0,0,16,8,1793,1817
E01011786,0,3,20,8,1579,1610
E01011854,0,0,6,9,1213,1228
E01011855,0,3,8,8,1572,1591
E01011856,1,3,1,0,1420,1425
E01011858,2,2,13,5,1566,1588
E01011787,1,1,17,9,1682,1710
E01011788,0,2,19,11,1640,1672
E01011790,0,2,10,9,1608,1629
E01011865,0,6,10,4,1660,1680
E01011867,0,5,10,22,1606,1643
E01011859,2,8,2,17,1440,1469
E01011869,2,8,9,17,1399,1435
E01011870,0,0,2,0,1405,1407
E01011871,3,5,5,6,1542,1561
E01011860,2,2,9,7,1494,1514
E01011861,2,2,29,2,1982,2017
E01011862,3,11,16,4,1446,1480
E01011863,0,4,8,3,1299,1314
E01011864,0,9,15,3,1615,1642
E01011866,0,1,4,6,1587,1598
E01011868,0,3,6,6,1897,1912
E01011872,3,1,14,3,1529,1550
E01013461,27,5,12,28,1563,1635
E01013462,7,9,13,21,1474,1524
E01013463,1,4,12,71,1436,1524
E01013464,5,2,18,39,1388,1452
E01013465,3,20,19,15,1604,1661
E01013466,3,11,16,21,1491,1542
E01013467,6,18,14,23,1328,1389
E01013468,2,5,13,51,1544,1615
E01013469,18,13,10,39,1200,1280
E01013574,0,12,14,35,1294,1355
E01013575,7,10,15,61,1311,1404
E01013576,2,19,26,55,1380,1482
E01013577,6,10,26,46,1495,1583
E01013578,3,18,28,42,1292,1383
E01013579,4,24,30,47,1351,1456
E01013580,3,12,22,31,1407,1475
E01013530,8,33,40,26,1423,1530
E01013531,2,28,40,19,1326,1415
E01013532,9,13,33,12,1424,1491
E01013581,1,24,51,22,1458,1556
E01013526,2,11,22,23,1552,1610
E01013527,5,8,17,18,1463,1511
E01013528,12,17,42,65,1512,1648
E01013529,9,31,50,69,2203,2362
E01013505,2,11,26,12,1457,1508
E01013506,8,4,31,8,1541,1592
E01013513,0,18,16,7,1251,1292
E01013534,6,33,27,24,1564,1654
E01013582,1,14,28,22,1500,1565
E01013533,1,20,41,25,1558,1645
E01013535,19,32,50,37,1477,1615
E01013536,5,38,40,28,1484,1595
E01013537,8,19,27,28,1553,1635
E01013538,2,23,25,38,1434,1522
E01013522,30,46,69,80,1511,1736
E01013523,29,44,38,49,1387,1547
E01013524,63,92,78,137,2127,2497
E01013525,32,42,52,60,1800,1986
E01013548,6,25,44,26,1410,1511
E01013549,1,28,29,14,1359,1431
E01013552,9,34,41,26,1561,1671
E01013553,2,17,22,19,1428,1488
E01013555,7,31,20,18,1456,1532
E01013592,1,5,14,10,1371,1401
E01013594,2,1,10,5,1335,1353
E01013596,4,11,8,11,1525,1559
E01013599,1,5,16,16,1350,1388
E01013547,25,38,45,64,1582,1754
E01013550,3,32,24,35,1185,1279
E01013551,15,42,53,94,1672,1876
E01013554,13,51,50,78,1446,1638
E01013507,7,6,28,19,1467,1527
E01013508,0,7,14,33,1207,1261
E01013509,2,8,36,12,1615,1673
E01013510,3,6,35,22,1453,1519
E01013511,1,6,20,36,1498,1561
E01013512,17,25,28,32,1378,1480
E01013453,16,112,105,110,2015,2358
E01013454,19,74,59,107,1270,1529
E01013456,34,85,101,106,1716,2042
E01013457,26,79,65,132,1536,1838
E01013460,27,113,86,139,1652,2017
E01013479,89,139,89,208,1510,2035
E01013593,1,8,11,7,1351,1378
E01013595,13,45,76,41,2145,2320
E01013597,7,10,25,15,1379,1436
E01013598,1,21,23,28,1469,1542
E01013556,2,24,33,60,1311,1430
E01013557,3,3,9,30,1339,1384
E01013558,20,52,30,159,1777,2038
E01013559,3,8,22,50,1285,1368
E01013564,11,22,37,87,1843,2000
E01013480,51,105,101,291,1502,2050
E01013483,58,90,97,995,879,2119
E01013485,94,118,53,1120,679,2064
E01013565,53,70,46,1018,532,1719
E01013566,165,110,63,1120,561,2019
E01013455,16,38,75,251,1541,1921
E01013458,27,51,23,670,862,1633
E01013542,23,41,53,312,1303,1732
E01013546,30,41,48,332,1228,1679
E01013481,23,125,50,1232,455,1885
E01013484,115,108,100,1130,503,1956
E01013486,88,103,70,1270,473,2004
E01013487,125,170,109,1067,783,2254
E01033166,36,93,59,127,772,1087
E01033167,38,80,36,249,733,1136
E01013540,25,31,29,307,1166,1558
E01013560,17,14,17,146,1315,1509
E01013561,3,20,26,27,1478,1554
E01013562,8,11,15,30,1317,1381
E01013563,15,11,25,27,1280,1358
E01013459,36,110,77,1105,668,1996
E01013567,108,160,73,1149,532,2022
E01013568,86,181,71,1054,673,2065
E01013569,91,106,84,834,466,1581
E01013539,130,60,61,964,1261,2476
E01013541,21,72,83,317,1132,1625
E01013543,36,6,38,304,1432,1816
E01013544,63,51,35,459,1236,1844
E01013545,21,54,57,299,1214,1645
E01013488,59,71,46,471,916,1563
E01013489,25,36,43,377,1084,1565
E01013490,16,32,32,250,1191,1521
E01013491,73,102,50,574,869,1668
E01013570,87,123,108,827,819,1964
E01013571,46,95,114,494,1155,1904
E01013572,29,75,68,445,1107,1724
E01013573,38,231,176,320,1308,2073
E01013470,6,10,24,37,1393,1470
E01013474,0,27,35,34,1439,1535
E01013476,1,20,39,37,1350,1447
E01033171,7,45,58,109,1180,1399
E01033172,39,70,69,98,1281,1557
E01013471,21,86,80,96,1575,1858
E01013473,9,38,39,80,1350,1516
E01013475,17,70,55,84,1361,1587
E01013477,1,23,45,83,1641,1793
E01013502,7,27,41,32,1322,1429
E01013503,14,44,41,33,1393,1525
E01013472,12,111,97,128,1745,2093
E01013497,14,52,37,136,1294,1533
E01013504,22,74,57,118,1641,1912
E01013583,11,81,111,138,1322,1663
E01013590,24,177,107,167,1299,1774
E01013591,39,145,119,193,1539,2035
E01013492,32,65,42,392,1064,1595
E01013493,40,106,59,420,892,1517
E01013494,11,95,89,146,1519,1860
E01013495,45,70,78,321,1252,1766
E01013496,4,25,88,50,1378,1545
E01013498,1,19,23,18,1395,1456
E01013499,2,26,27,39,1290,1384
E01013500,3,32,45,46,1564,1690
E01013501,2,13,28,23,1334,1400
E01013584,34,143,143,174,1376,1870
E01013585,24,123,94,381,1129,1751
E01013586,14,112,125,153,1148,1552
E01013587,49,68,68,441,902,1528
E01013588,49,85,94,217,1087,1532
E01013589,31,37,40,370,945,1423
E01013517,0,30,24,68,1304,1426
E01013518,11,23,39,62,1281,1416
E01013521,1,45,22,33,1245,1346
E01033168,4,12,31,97,1206,1350
E01033169,7,36,54,324,1353,1774
E01033170,2,23,14,89,1104,1232
E01013514,9,10,35,62,1516,1632
E01013515,10,22,64,154,1592,1842
E01013519,4,24,73,99,1448,1648
E01013520,4,15,29,66,1418,1532
E01013615,12,37,60,378,1039,1526
E01013616,27,62,92,205,1211,1597
E01013618,5,182,70,222,1085,1564
E01013619,52,345,101,233,1013,1744
E01013733,21,35,81,545,943,1625
E01013734,23,39,22,1125,275,1484
E01013735,21,32,16,1130,129,1328
E01013736,24,72,34,467,1111,1708
E01013737,48,14,22,1189,164,1437
E01013600,16,145,64,139,1557,1921
E01013601,24,112,58,96,1394,1684
E01013602,18,168,78,154,1428,1846
E01013603,23,197,95,254,1152,1721
E01013604,6,122,62,133,1340,1663
E01013605,34,86,79,517,1058,1774
E01013617,35,177,114,886,1336,2548
E01013620,55,327,117,154,1159,1812
E01013621,63,426,92,202,1108,1891
E01013622,59,353,77,241,905,1635
E01013623,43,183,63,794,1080,2163
E01013732,75,85,67,916,964,2107
E01013739,31,28,35,1146,297,1537
E01013740,15,30,29,1235,204,1513
E01013741,62,24,30,1251,308,1675
E01013625,24,43,43,1545,209,1864
E01013628,30,73,63,905,463,1534
E01013715,10,25,14,1185,80,1314
E01013716,15,47,12,1634,104,1812
E01013738,35,17,7,1290,199,1548
E01013624,29,58,59,787,531,1464
E01013626,29,51,36,1557,182,1855
E01013627,22,20,5,1143,111,1301
E01013629,20,53,37,1408,197,1715
E01013630,51,31,23,1535,185,1825
E01013606,21,69,43,599,1012,1744
E01013607,150,124,74,1069,1156,2573
E01013680,36,91,71,416,1474,2088
E01013685,2,38,48,224,1164,1476
E01013686,30,46,31,432,1311,1850
E01013696,153,82,80,1265,862,2442
E01013697,112,205,87,1335,900,2639
E01013699,32,52,65,728,832,1709
E01032862,179,125,99,866,741,2010
E01032863,121,86,54,962,485,1708
E01032865,96,77,71,1263,613,2120
E01013713,28,33,19,1385,78,1543
E01013714,13,21,12,1562,116,1724
E01013717,22,74,51,1124,298,1569
E01013718,15,33,18,1325,196,1587
E01013719,3,25,31,1423,80,1562
E01013720,10,38,28,1070,200,1346
E01013651,77,144,69,712,714,1716
E01013652,44,229,63,676,779,1791
E01013653,44,165,143,681,866,1899
E01013655,108,220,86,1073,552,2039
E01013721,9,72,58,263,1196,1598
E01013723,15,91,41,95,1140,1382
E01013725,17,112,44,76,1151,1400
E01013726,48,113,58,61,1447,1727
E01013728,10,123,67,75,1341,1616
E01013694,29,50,75,381,1112,1647
E01013700,30,43,43,329,1072,1517
E01013770,36,68,54,418,814,1390
E01013771,58,53,56,869,568,1604
E01013773,35,50,55,316,1024,1480
E01013681,15,117,81,222,1378,1813
E01013682,10,103,75,86,1513,1787
E01013683,35,162,121,215,1564,2097
E01013684,51,187,93,217,1413,1961
E01013654,63,412,114,1169,441,2199
E01013656,45,98,40,1494,151,1828
E01013657,74,108,62,1393,182,1819
E01013658,70,106,47,1452,195,1870
E01013659,68,67,64,1679,130,2008
E01013743,22,57,36,1458,72,1645
E01013745,53,73,30,1461,63,1680
E01013742,18,92,17,1644,51,1822
E01013744,32,61,10,1858,22,1983
E01013746,88,187,77,1412,93,1857
E01013748,104,368,58,1352,135,2017
E01013754,58,787,81,801,332,2059
E01013755,112,826,90,903,285,2216
E01013660,83,140,105,984,502,1814
E01013661,57,227,87,764,581,1716
E01013664,31,195,90,802,716,1834
E01013665,64,105,72,1243,353,1837
E01013667,21,86,76,753,632,1568
E01013668,52,127,49,916,437,1581
E01013729,5,27,32,57,1175,1296
E01013780,11,34,40,178,1234,1497
E01013783,36,44,48,318,1108,1554
E01013785,26,34,40,181,1239,1520
E01013786,15,30,67,209,1197,1518
E01013662,95,58,34,1489,116,1792
E01013663,119,85,29,1318,247,1798
E01013747,60,125,40,1561,119,1905
E01013749,68,81,10,1234,223,1616
E01013750,34,67,23,1341,57,1522
E01013758,63,75,20,1325,158,1641
E01013751,37,95,30,1698,102,1962
E01013752,50,79,21,1350,70,1570
E01013753,56,194,43,1297,127,1717
E01013760,101,212,69,827,754,1963
E01013761,71,340,97,1290,302,2100
E01013762,58,210,29,1318,272,1887
E01013774,45,99,94,358,1153,1749
E01013776,52,136,79,388,1056,1711
E01013778,133,216,134,507,1512,2502
E01013779,45,89,87,249,1480,1950
E01013781,16,99,104,152,1266,1637
E01013782,25,50,55,159,1227,1516
E01013784,17,73,69,280,928,1367
E01013666,35,28,26,924,575,1588
E01013669,74,10,31,964,350,1429
E01013670,46,39,46,793,868,1792
E01013671,86,71,49,966,632,1804
E01013672,70,23,37,692,549,1371
E01013631,6,92,53,131,1266,1548
E01013632,13,148,77,47,1586,1871
E01013638,7,172,52,37,1461,1729
E01013640,21,319,72,30,1508,1950
E01013756,100,80,76,1098,581,1935
E01013757,94,39,31,1241,259,1664
E01013759,111,68,43,1526,217,1965
E01013763,51,253,91,777,881,2053
E01013764,64,65,26,1339,142,1636
E01013765,59,139,80,957,463,1698
E01013766,99,73,49,1386,241,1848
E01013633,24,95,58,134,1339,1650
E01013634,15,89,54,114,1261,1533
E01013637,15,95,88,74,1696,1968
E01013639,11,78,73,117,1185,1464
E01013641,54,63,54,255,1183,1609
E01013635,44,49,58,488,852,1491
E01013636,69,32,32,616,611,1360
E01013775,190,100,89,407,1369,2155
E01013777,18,83,58,265,1153,1577
E01013642,45,49,68,243,1416,1821
E01013643,41,36,67,341,1359,1844
E01013649,50,57,43,347,1044,1541
E01013650,18,34,64,165,1527,1808
E01013702,35,39,55,407,1037,1573
E01013710,47,49,65,319,929,1409
E01013711,65,39,52,301,1168,1625
E01013613,12,44,88,70,1432,1646
E01013614,10,37,65,84,1365,1561
E01013687,25,88,75,109,1276,1573
E01013688,5,53,70,118,1204,1450
E01013703,27,16,30,266,951,1290
E01013704,32,18,47,250,1089,1436
E01013706,36,17,57,322,1196,1628
E01013707,30,38,67,325,1138,1598
E01013712,40,39,48,377,1008,1512
E01013608,9,26,52,104,1356,1547
E01013609,7,23,35,60,1450,1575
E01013610,4,43,46,98,1508,1699
E01013611,14,68,53,119,1327,1581
E01013612,3,20,54,80,1385,1542
E01013678,11,51,71,118,1393,1644
E01013679,26,169,96,59,1209,1559
E01013691,28,148,76,99,1308,1659
E01013692,9,140,84,89,1091,1413
E01013693,24,153,75,64,1161,1477
E01013673,2,64,58,36,1397,1557
E01013674,2,42,44,47,1486,1621
E01013675,10,43,49,22,1510,1634
E01013676,5,102,89,45,1730,1971
E01013677,4,28,68,27,1407,1534
E01013695,8,55,76,172,1214,1525
E01013698,12,48,63,278,1136,1537
E01013767,27,36,55,478,941,1537
E01013768,16,45,47,235,1201,1544
E01013772,14,54,100,158,1275,1601
E01032597,11,76,75,141,1137,1440
E01013689,23,96,69,605,1044,1837
E01013690,11,85,61,128,1255,1540
E01013705,54,78,65,434,948,1579
E01013709,110,55,36,863,512,1576
E01032599,65,32,47,563,872,1579
E01013722,11,89,61,166,1426,1753
E01013727,9,103,58,38,1283,1491
E01013730,28,102,65,76,1303,1574
E01013731,36,201,106,73,1203,1619
E01032602,15,92,68,83,1414,1672
E01013646,118,221,117,956,1348,2760
E01013647,116,366,91,643,1288,2504
E01013648,74,279,149,814,1372,2688
E01032875,87,167,81,533,1035,1903
E01032867,212,144,75,513,856,1800
E01032868,77,184,62,469,900,1692
E01032872,119,89,58,244,696,1206
E01032873,159,118,61,282,714,1334
E01013887,5,87,25,196,1221,1534
E01013892,2,92,26,158,1136,1414
E01013893,23,175,104,41,1006,1349
E01013894,7,77,65,89,1238,1476
E01013879,3,74,79,30,1107,1293
E01013880,4,60,117,11,1341,1533
E01013881,4,74,102,32,1293,1505
E01013882,3,51,55,26,1297,1432
E01013885,2,92,103,58,1407,1662
E01013886,4,75,77,37,1257,1450
E01013888,4,46,58,28,1371,1507
E01013889,2,74,68,40,1469,1653
E01013890,2,55,88,15,1386,1546
E01013891,7,136,84,44,1414,1685
E01013875,3,25,59,56,1228,1371
E01013876,8,166,144,47,1432,1797
E01013877,5,116,157,25,1091,1394
E01013878,2,120,121,17,1036,1296
E01013883,5,118,80,30,1291,1524
E01013884,3,78,111,12,1146,1350
E01013853,5,89,63,30,1288,1475
E01013854,7,141,96,24,1161,1429
E01013855,10,152,137,50,1253,1602
E01013856,7,108,95,102,1304,1616
E01033397,10,208,130,137,1285,1770
E01033398,16,157,135,120,722,1150
E01013963,26,102,118,53,1270,1569
E01013964,12,111,109,242,1205,1679
E01013965,18,159,104,158,1044,1483
E01013966,26,113,115,91,1071,1416
E01013967,32,80,117,247,1335,1811
E01013827,7,190,148,129,1007,1481
E01013828,12,110,149,107,1268,1646
E01013834,4,135,115,66,1280,1600
E01013835,10,181,183,85,1188,1647
E01013836,9,135,190,114,1428,1876
E01013829,16,161,125,109,1214,1625
E01013830,10,103,92,220,1244,1669
E01013831,16,53,52,121,1311,1553
E01013832,6,117,160,232,1254,1769
E01013833,6,164,159,128,884,1341
E01013935,8,61,65,64,1328,1526
E01013968,11,40,49,44,1160,1304
E01013969,13,81,93,71,1352,1610
E01013970,10,56,81,100,1307,1554
E01013971,13,68,70,52,1330,1533
E01013817,4,207,174,48,1274,1707
E01013818,8,224,164,41,1337,1774
E01013822,9,218,125,64,1289,1705
E01013825,10,169,134,126,1411,1850
E01013826,4,216,220,51,1456,1947
E01013837,20,119,89,318,1226,1772
E01013838,11,101,88,307,1293,1800
E01013839,15,221,197,154,1170,1757
E01013840,22,130,144,470,1429,2195
E01013841,24,163,160,212,1024,1583
E01013819,18,162,140,78,1322,1720
E01013820,21,197,162,79,1322,1781
E01013821,18,166,212,100,1183,1679
E01013823,3,161,154,160,1375,1853
E01013824,4,162,184,112,1144,1606
E01013864,11,149,166,35,1169,1530
E01013865,2,104,126,43,1277,1552
E01013866,5,66,72,84,1272,1499
E01013867,9,132,125,112,1216,1594
E01013937,30,103,104,132,1371,1740
E01013938,23,62,80,188,1195,1548
E01013941,15,81,85,270,1187,1638
E01013943,17,133,152,216,1302,1820
E01013972,5,121,74,95,1160,1455
E01013936,24,142,172,193,1634,2165
E01013939,25,87,115,58,1250,1535
E01013940,8,264,251,147,1091,1761
E01013942,15,289,244,165,1400,2113
E01013843,36,83,84,369,1025,1597
E01013844,30,114,99,367,863,1473
E01013845,21,106,76,801,684,1688
E01013847,33,64,77,704,495,1373
E01013810,62,203,110,649,633,1657
E01013811,64,203,139,397,652,1455
E01013812,36,284,172,512,620,1624
E01013842,42,134,140,638,721,1675
E01013846,85,185,94,645,729,1738
E01013930,67,151,107,838,817,1980
E01013931,67,46,43,692,842,1690
E01013932,68,78,56,605,937,1744
E01013933,53,192,193,414,988,1840
E01013934,33,120,84,436,858,1531
E01013859,10,33,43,87,1281,1454
E01013861,17,37,61,66,1339,1520
E01013868,2,97,80,58,1335,1572
E01013929,19,78,82,306,1432,1917
E01013954,14,147,131,119,928,1339
E01013959,40,372,238,132,1052,1834
E01013960,37,337,206,108,881,1569
E01013962,32,245,161,133,1241,1812
E01013813,28,135,252,246,1538,2199
E01013814,25,200,197,202,1400,2024
E01013815,25,117,125,161,1376,1804
E01013816,80,209,180,534,1555,2558
E01013958,45,450,217,179,915,1806
E01013961,44,330,250,314,1365,2303
E01033399,58,176,135,688,1042,2099
E01033401,124,86,70,243,536,1059
E01033405,70,106,106,343,675,1300
E01033409,42,89,101,370,935,1537
E01033411,18,231,159,114,544,1066
E01013913,18,88,80,398,1178,1762
E01013914,26,58,90,464,1117,1755
E01013915,13,59,51,160,1277,1560
E01013916,14,70,115,203,1101,1503
E01013917,19,94,104,250,1285,1752
E01013858,5,105,87,68,1192,1457
E01013860,16,67,77,78,1339,1577
E01013862,7,206,200,140,1020,1573
E01013863,13,78,79,186,1108,1464
E01013944,142,135,52,675,724,1728
E01013945,77,282,172,438,874,1843
E01013947,67,342,223,408,960,2000
E01013948,28,354,165,230,504,1281
E01013953,44,183,156,747,2168,3298
E01033395,90,212,140,846,884,2172
E01033396,16,177,96,209,599,1097
E01013977,23,43,56,387,1382,1891
E01013978,38,72,45,458,1069,1682
E01013979,24,48,58,322,1148,1600
E01013981,15,27,54,287,1289,1672
E01032520,25,36,108,246,1677,2092
E01032522,34,52,129,224,1607,2046
E01033404,56,182,181,509,2929,3857
E01013918,18,198,109,514,1093,1932
E01013919,34,134,135,595,1150,2048
E01013920,30,180,308,269,1454,2241
E01013921,59,236,257,508,1141,2201
E01013957,29,111,128,283,1041,1592
E01013980,41,24,30,217,1317,1629
E01013982,35,21,50,204,1281,1591
E01013983,35,83,119,212,970,1419
E01013984,24,15,17,195,1208,1459
E01013985,49,51,48,490,1160,1798
E01013924,45,176,124,141,1162,1648
E01013926,53,95,80,279,1154,1661
E01013928,112,113,71,597,689,1582
E01033408,46,150,146,441,2573,3356
E01033410,94,102,89,735,1653,2673
E01013973,108,168,127,893,2584,3880
E01013974,53,74,78,586,1280,2071
E01013975,21,61,83,455,1767,2387
E01013976,39,149,156,189,1081,1614
E01013895,5,29,14,103,1356,1507
E01013896,1,48,56,78,1124,1307
E01013901,6,18,34,57,1343,1458
E01013902,5,12,39,70,1337,1463
E01013897,4,13,23,58,1407,1505
E01013898,14,32,67,149,1364,1626
E01013899,2,46,41,28,1154,1271
E01013900,3,34,41,57,1367,1502
E01013903,9,27,32,61,1120,1249
E01013907,9,30,66,48,1314,1467
E01013905,6,37,27,30,1448,1548
E01013908,2,41,69,35,1538,1685
E01013909,1,38,81,23,1386,1529
E01013912,0,27,54,32,1468,1581
E01013904,2,29,77,57,1385,1550
E01013906,3,38,60,67,1443,1611
E01013910,11,17,46,31,1351,1456
E01013911,4,17,37,19,1443,1520
E01013849,3,145,133,34,1226,1541
E01013850,6,74,84,16,1282,1462
E01013851,10,160,166,31,1204,1571
E01013852,6,72,86,18,1368,1550
E01032621,2,85,52,31,1417,1587
E01013874,7,77,61,149,1182,1476
E01033400,42,158,136,219,754,1309
E01033402,42,55,70,204,692,1063
E01033403,65,50,95,158,715,1083
E01033406,56,51,78,257,607,1049
E01033407,51,56,48,256,659,1070
E01013870,47,242,183,268,1278,2018
E01013871,43,228,170,258,1012,1711
E01013872,44,219,172,414,949,1798
E01013873,22,216,140,571,1143,2092
E01013788,7,11,19,11,2598,2646
E01013789,1,6,10,4,1383,1404
E01013790,2,64,65,54,1879,2064
E01013796,11,72,19,10,1586,1698
E01013793,0,2,7,4,1358,1371
E01013800,2,5,10,10,1509,1536
E01013801,1,4,16,20,1650,1691
E01013809,2,0,1,6,1244,1253
E01013798,7,12,21,22,1362,1424
E01013799,2,26,25,61,1575,1689
E01013802,4,1,24,23,2478,2530
E01013803,0,5,25,11,2218,2259
E01013791,0,4,8,7,1126,1145
E01013792,1,3,22,4,1654,1684
E01013797,7,8,15,15,1630,1675
E01013804,1,3,5,7,1528,1544
E01013805,0,2,10,8,1316,1336
E01013787,2,2,13,2,1264,1283
E01013794,1,5,4,8,1256,1274
E01013795,3,5,15,6,1089,1118
E01013806,7,3,33,45,1962,2050
E01013807,1,5,16,13,1362,1397
E01013808,1,3,6,14,1274,1298
E01019400,3,0,13,14,1560,1590
E01019401,4,3,12,21,1619,1659
E01019402,1,3,15,28,1533,1580
E01019404,2,3,15,20,1590,1630
E01019406,0,1,9,3,1014,1027
E01019423,3,2,3,0,1201,1209
E01019424,0,2,9,0,1181,1192
E01019477,1,0,3,3,2195,2202
E01019403,4,0,12,8,1488,1512
E01019444,0,4,9,3,1349,1365
E01019468,1,4,21,2,1510,1538
E01019469,0,6,9,5,1634,1654
E01019471,6,5,10,21,1363,1405
E01019443,0,1,4,4,1510,1519
E01019470,1,4,8,9,1636,1658
E01019473,1,2,5,9,1300,1317
E01019474,1,2,6,7,1209,1225
E01019475,4,2,8,2,1160,1176
E01019476,0,0,3,1,1362,1366
E01019420,1,6,6,7,1343,1363
E01019442,0,6,12,12,1507,1537
E01019445,0,1,5,24,1370,1400
E01019455,2,2,1,15,1354,1374
E01019456,0,9,15,26,1765,1815
E01019457,0,1,9,8,1317,1335
E01019429,2,2,8,7,1571,1590
E01019454,3,2,12,4,1401,1422
E01019460,0,3,9,7,1606,1625
E01019461,5,1,11,1,1413,1431
E01019462,0,0,2,1,1255,1258
E01019405,0,2,6,17,1433,1458
E01019414,3,0,4,6,1581,1594
E01019428,0,1,13,3,1480,1497
E01019430,1,3,12,6,1904,1926
E01019421,2,0,7,3,1919,1931
E01019422,2,3,2,3,1543,1553
E01019432,2,1,7,2,1970,1982
E01019458,2,5,20,25,1486,1538
E01019459,1,2,14,4,1347,1368
E01019463,1,4,15,12,1515,1547
E01019408,3,4,16,10,1467,1500
E01019409,1,4,22,12,1705,1744
E01019412,3,6,18,8,1535,1570
E01019413,6,1,11,7,1398,1423
E01019416,2,1,4,2,1424,1433
E01019407,3,10,34,42,2005,2094
E01019415,3,6,50,15,1743,1817
E01019417,3,8,17,30,1900,1958
E01019419,5,4,30,22,1867,1928
E01019410,1,1,18,5,1444,1469
E01019411,1,2,14,18,1481,1516
E01019418,1,4,13,5,1754,1777
E01019447,3,3,11,26,1495,1538
E01019449,1,7,15,3,1718,1744
E01019431,0,3,14,13,1477,1507
E01019433,1,1,11,2,1831,1846
E01019438,0,9,7,15,1674,1705
E01019451,1,8,11,22,1901,1943
E01019464,2,1,14,5,1993,2015
E01019434,3,3,6,7,1177,1196
E01019435,3,4,19,16,1602,1644
E01019436,0,3,12,20,1275,1310
E01019439,1,9,11,2,1335,1358
E01019440,0,7,15,19,1480,1521
E01019446,0,1,14,7,1200,1222
E01019448,0,3,9,11,1682,1705
E01019450,0,0,9,10,1459,1478
E01019465,0,2,9,13,1118,1142
E01019467,0,4,15,4,1455,1478
E01019425,3,0,25,29,1582,1639
E01019426,4,4,25,28,1490,1551
E01019427,5,5,37,29,1780,1856
E01019472,3,10,35,52,2571,2671
E01019437,3,1,11,22,1446,1483
E01019441,0,4,8,17,1454,1483
E01019452,0,6,7,6,1611,1630
E01019453,0,6,13,18,1795,1832
E01032613,0,0,6,4,1205,1215
E01019478,0,12,27,7,1495,1541
E01019479,0,14,15,78,1613,1720
E01019491,0,21,21,12,2178,2232
E01019493,4,0,5,4,1560,1573
E01019494,0,9,10,9,1998,2026
E01019492,0,11,9,9,1730,1759
E01019495,0,2,5,7,1602,1616
E01019524,0,4,8,6,1346,1364
E01019525,0,2,7,5,1468,1482
E01019496,0,5,13,27,1347,1392
E01019497,0,6,10,12,1386,1414
E01019498,0,3,13,29,1746,1791
E01019523,0,1,1,4,1048,1054
E01019483,0,22,18,30,2027,2097
E01019484,1,3,9,8,1929,1950
E01019485,0,1,4,1,1188,1194
E01019488,2,3,13,10,1418,1446
E01019486,0,0,4,4,1091,1099
E01019487,0,0,4,6,1543,1553
E01019489,1,4,1,4,1194,1204
E01019490,1,2,6,4,1117,1130
E01019502,0,5,4,14,1480,1503
E01019504,0,2,7,5,1278,1292
E01019508,0,4,7,2,1944,1957
E01019509,1,3,4,1,1206,1215
E01019510,1,6,7,1,1268,1283
E01019512,1,10,10,26,2543,2590
E01019503,1,6,15,16,2267,2305
E01019505,0,1,8,5,1512,1526
E01019506,0,0,10,1,1334,1345
E01019507,0,2,14,10,1657,1683
E01019511,0,11,17,26,2103,2157
E01019480,0,1,17,5,1513,1536
E01019482,0,2,10,8,1472,1492
E01019520,0,5,12,22,1723,1762
E01019521,0,2,9,4,1532,1547
E01019522,0,9,16,20,1486,1531
E01019481,0,3,5,9,1344,1361
E01019514,0,3,20,15,1526,1564
E01019515,0,1,15,15,1611,1642
E01019516,0,7,15,6,1437,1465
E01019519,1,6,18,9,1811,1845
E01019499,1,6,21,29,1239,1296
E01019500,0,7,12,12,1408,1439
E01019501,0,5,15,8,1439,1467
E01019513,0,28,9,20,1234,1291
E01019517,0,5,9,23,1514,1551
E01019518,2,2,9,24,1547,1584
E01019526,4,4,10,6,1363,1387
E01019528,0,7,16,6,1530,1559
E01019572,0,9,19,1,1293,1322
E01019573,2,14,24,8,1472,1520
E01019574,0,2,8,15,1314,1339
E01019563,3,18,15,19,1637,1692
E01019564,3,5,11,9,1495,1523
E01019565,1,13,10,6,1392,1422
E01019566,2,17,18,12,1585,1634
E01019568,0,22,17,5,1487,1531
E01019527,1,10,10,22,1422,1465
E01019529,0,4,17,17,1454,1492
E01019530,1,6,14,21,1401,1443
E01019531,0,10,13,6,1458,1487
E01019553,4,2,11,12,1759,1788
E01019541,2,11,14,49,1477,1553
E01019542,5,5,25,45,1549,1629
E01019543,1,18,20,20,1498,1557
E01019544,3,10,18,28,1505,1564
E01019571,1,5,29,30,1446,1511
E01019532,0,6,4,8,1201,1219
E01019533,0,4,9,5,1385,1403
E01019534,1,5,10,20,1415,1451
E01019535,5,3,14,26,1394,1442
E01019536,2,6,16,24,1698,1746
E01019549,1,23,19,4,1321,1368
E01019550,4,12,10,3,1604,1633
E01019551,2,1,8,3,1562,1576
E01019552,2,9,9,1,1307,1328
E01019567,3,7,22,5,1690,1727
E01019537,0,5,21,23,1428,1477
E01019569,6,18,21,38,1502,1585
E01019570,1,8,14,8,1232,1263
E01019580,1,24,9,5,1412,1451
E01019581,0,21,27,36,1326,1410
E01019557,2,9,23,21,1422,1477
E01019558,5,5,5,13,1405,1433
E01019559,6,11,5,10,1135,1167
E01019560,1,12,13,11,1347,1384
E01019561,1,16,21,13,1273,1324
E01019562,1,11,12,16,1167,1207
E01019539,1,18,16,16,1595,1646
E01019540,1,6,8,11,1390,1416
E01019555,0,12,27,31,1466,1536
E01019590,0,6,18,5,1789,1818
E01019591,0,5,22,11,1519,1557
E01019538,3,37,36,76,1515,1667
E01019554,1,19,23,56,1278,1377
E01019556,6,18,21,71,1348,1464
E01019579,3,23,17,101,1558,1702
E01033387,2,19,20,57,1073,1171
E01033388,1,21,27,42,1276,1367
E01019586,5,3,16,15,1310,1349
E01019587,6,17,12,20,1443,1498
E01019588,9,5,12,10,1388,1424
E01019589,1,3,9,13,1371,1397
E01019592,2,2,12,15,1637,1668
E01019593,1,4,3,12,1081,1101
E01019545,0,6,11,27,1344,1388
E01019546,0,5,11,32,1435,1483
E01019547,0,7,17,22,1379,1425
E01019548,3,12,15,42,2247,2319
E01019582,1,15,15,15,1383,1429
E01019583,2,6,7,26,1389,1430
E01019585,15,16,26,109,2091,2257
E01019575,4,16,25,26,1616,1687
E01019576,3,26,21,55,1469,1574
E01019577,0,29,11,18,1487,1545
E01019578,1,18,25,28,1532,1604
E01019602,0,0,12,4,1827,1843
E01019614,1,1,8,5,1698,1713
E01019615,1,0,25,13,2144,2183
E01019631,0,4,6,4,1813,1827
E01019600,0,1,10,4,1640,1655
E01019604,4,2,13,14,1768,1801
E01019606,0,0,17,15,1638,1670
E01019618,0,1,6,4,1625,1636
E01019599,1,0,11,4,1453,1469
E01019601,1,2,4,3,1629,1639
E01019613,1,1,4,2,1674,1682
E01019617,1,0,12,7,1575,1595
E01019608,0,1,11,15,1667,1694
E01019610,0,0,20,8,1522,1550
E01019630,0,0,7,9,1858,1874
E01019609,2,2,13,5,2147,2169
E01019621,1,0,3,6,1248,1258
E01019622,2,0,5,7,1540,1554
E01019624,0,0,12,8,1197,1217
E01019627,0,0,4,0,1193,1197
E01019628,0,1,11,15,1136,1163
E01019619,0,1,13,5,1414,1433
E01019620,4,1,12,16,1523,1556
E01019623,0,0,7,6,1280,1293
E01019625,0,2,17,13,1560,1592
E01019626,0,3,6,6,1451,1466
E01019632,1,0,14,11,1684,1710
E01019633,0,0,9,2,1541,1552
E01019634,0,0,11,4,1490,1505
E01019635,1,1,7,2,1202,1213
E01019636,1,2,9,9,1522,1543
E01019595,2,0,9,24,2020,2055
E01019605,0,1,13,1,1864,1879
E01019611,2,0,7,0,1724,1733
E01019616,1,1,17,4,1757,1780
E01019594,1,7,12,17,1741,1778
E01019596,2,2,7,8,1586,1605
E01019597,0,1,7,4,1468,1480
E01019598,7,3,7,11,1691,1719
E01019603,1,2,5,4,1665,1677
E01019607,1,0,9,4,1812,1826
E01019612,9,43,53,90,2437,2632
E01019629,0,1,1,5,1693,1700
E01019644,1,2,16,7,1425,1451
E01019646,1,1,8,1,1512,1523
E01019663,7,4,18,9,1461,1499
E01019664,0,2,22,10,1264,1298
E01019665,3,4,13,4,1353,1377
E01019657,6,0,21,17,1711,1755
E01019660,2,7,7,16,1834,1866
E01019661,4,8,24,10,1263,1309
E01019662,0,1,12,9,1510,1532
E01019672,6,6,27,23,1652,1714
E01019690,0,2,4,27,1186,1219
E01019670,0,5,13,12,1791,1821
E01019671,3,4,15,18,1755,1795
E01019701,0,5,7,10,2078,2100
E01019673,0,2,6,12,1304,1324
E01019702,0,3,9,1,1913,1926
E01019703,1,3,15,5,1555,1579
E01019704,1,1,13,4,1456,1475
E01019658,3,7,15,5,1826,1856
E01019659,1,3,9,13,1719,1745
E01019674,0,4,7,6,1166,1183
E01019688,0,1,5,2,1473,1481
E01019689,1,3,11,10,1470,1495
E01019666,1,3,20,1,1488,1513
E01019667,3,3,16,10,1613,1645
E01019668,0,0,7,1,1487,1495
E01019669,0,7,12,1,1543,1563
E01019656,0,5,5,6,1200,1216
E01019691,0,4,11,19,1564,1598
E01019692,1,6,15,19,1482,1523
E01019693,3,5,28,60,1739,1835
E01019694,0,2,8,23,1153,1186
E01019696,0,7,16,5,1302,1330
E01019683,4,2,14,10,1257,1287
E01019684,0,3,20,19,1635,1677
E01019685,0,1,12,12,1438,1463
E01019686,0,1,11,40,1349,1401
E01019687,4,2,27,11,1463,1507
E01019648,0,25,35,13,1472,1545
E01019649,0,37,32,38,1652,1759
E01019650,0,5,48,16,1577,1646
E01019651,1,7,31,30,1382,1451
E01019695,1,11,19,24,1362,1417
E01019641,0,13,8,10,1374,1405
E01019652,5,15,32,41,1604,1697
E01019653,9,24,9,92,1270,1404
E01019707,0,8,24,52,1389,1473
E01019708,5,12,23,99,1496,1635
E01019647,4,35,37,36,1788,1900
E01019675,8,13,30,24,1495,1570
E01019679,3,11,18,23,1660,1715
E01019682,5,15,30,31,1439,1520
E01019642,3,1,14,13,1414,1445
E01019643,1,15,16,17,1556,1605
E01019654,1,3,15,17,1515,1551
E01019655,0,4,22,19,1494,1539
E01019676,0,26,24,23,1388,1461
E01019677,6,7,18,17,1380,1428
E01019678,1,18,14,22,1539,1594
E01019680,4,9,21,24,1491,1549
E01019681,5,5,13,20,1450,1493
E01019698,0,12,17,6,1329,1364
E01019697,0,5,13,7,1470,1495
E01019699,0,10,39,27,1436,1512
E01019700,2,10,16,17,2213,2258
E01019705,4,14,33,36,1702,1789
E01019706,0,10,15,23,1195,1243
E01019709,0,10,42,37,1170,1259
E01019638,0,1,8,9,1338,1356
E01019639,0,2,11,2,1088,1103
E01019640,0,1,7,6,1467,1481
E01019645,2,11,7,34,1502,1556
E01032614,2,2,9,10,1278,1301
E01019733,4,3,17,18,1469,1511
E01019752,3,1,29,14,1272,1319
E01019753,1,3,44,6,1423,1477
E01019763,2,5,28,7,2059,2101
E01019728,0,7,15,22,1177,1221
E01019729,0,9,19,4,1278,1310
E01019730,2,8,20,15,1958,2003
E01019731,0,0,15,10,1280,1305
E01019732,1,4,28,10,1443,1486
E01019738,2,2,30,13,1317,1364
E01019739,7,5,17,30,1556,1615
E01019740,2,6,27,11,1146,1192
E01019750,2,2,12,4,1236,1256
E01019751,4,12,17,16,2191,2240
E01019768,5,3,13,17,2161,2199
E01019727,2,4,18,19,1688,1731
E01019749,0,1,10,10,1231,1252
E01019754,0,3,22,8,1748,1781
E01019756,1,6,20,22,1779,1828
E01019757,0,5,9,6,1320,1340
E01019758,1,1,9,8,1540,1559
E01019746,4,1,18,8,1556,1587
E01019747,0,2,12,21,1145,1180
E01019748,2,0,10,8,1442,1462
E01019755,1,2,25,9,1969,2006
E01019766,3,0,12,3,1425,1443
E01019711,1,0,14,17,1290,1322
E01019734,2,2,21,5,2026,2056
E01019743,0,0,14,17,1345,1376
E01019744,2,1,18,27,1419,1467
E01019745,0,1,10,1,1084,1096
E01019712,0,0,12,3,1459,1474
E01019713,2,0,9,2,1111,1124
E01019764,2,1,7,14,1569,1593
E01019765,0,2,6,9,1773,1790
E01019767,2,0,19,8,1600,1629
E01019710,3,7,22,13,1900,1945
E01019715,1,7,14,31,1482,1535
E01019717,6,6,22,44,1297,1375
E01019722,6,16,19,23,1795,1859
E01019723,3,6,21,28,1768,1826
E01019716,2,2,18,8,1248,1278
E01019724,0,3,5,2,1211,1221
E01019759,2,3,16,11,1474,1506
E01019760,0,5,9,6,1441,1461
E01019761,0,6,31,17,1552,1606
E01019714,2,0,24,11,2503,2540
E01019725,1,1,9,3,1392,1406
E01019726,0,0,6,8,1325,1339
E01019762,0,2,21,16,1750,1789
E01019718,6,10,13,17,2192,2238
E01019719,3,0,5,10,1537,1555
E01019720,0,0,11,2,1444,1457
E01019721,1,2,8,2,1135,1148
E01019735,1,0,5,5,1520,1531
E01019736,1,0,8,6,1166,1181
E01019737,1,3,14,9,1141,1168
E01019741,0,3,10,10,1090,1113
E01019742,0,0,7,7,1106,1120
E01019801,1,1,12,0,1082,1096
E01019802,4,0,12,23,1324,1363
E01019803,0,0,7,13,1260,1280
E01019804,1,0,9,19,1304,1333
E01019805,1,3,6,16,1356,1382
E01019806,3,2,14,11,1462,1492
E01019807,3,13,21,4,1458,1499
E01019778,6,2,9,9,1671,1697
E01019779,4,0,14,16,1553,1587
E01019790,4,5,22,19,1902,1952
E01019816,1,1,13,1,1734,1750
E01019780,0,0,12,12,1409,1433
E01019781,0,0,10,13,1405,1428
E01019782,7,1,12,16,1245,1281
E01019786,1,2,13,7,1497,1520
E01019827,3,7,19,25,1822,1876
E01019770,1,4,16,9,1861,1891
E01019787,3,1,7,3,1760,1774
E01019788,3,6,10,3,1639,1661
E01019794,1,0,14,26,1375,1416
E01019783,1,2,9,0,1247,1259
E01019784,1,2,11,8,1235,1257
E01019785,1,1,6,2,1282,1292
E01019793,1,10,17,0,1413,1441
E01019795,3,13,17,14,2168,2215
E01019798,3,2,12,30,1354,1401
E01019821,8,51,13,25,1279,1376
E01019822,4,8,10,21,1539,1582
E01019823,0,6,11,28,1073,1118
E01019771,1,2,13,6,2109,2131
E01019772,1,2,14,17,1511,1545
E01019828,2,0,11,20,1379,1412
E01019829,4,1,15,4,1413,1437
E01019796,0,0,12,15,1084,1111
E01019797,6,0,9,8,1315,1338
E01019799,0,1,12,19,1933,1965
E01019800,0,1,25,18,1723,1767
E01019808,1,1,4,18,1569,1593
E01019826,2,1,11,4,1399,1417
E01019769,0,1,11,9,1884,1905
E01019774,6,0,5,5,1551,1567
E01019824,0,3,17,6,1149,1175
E01019830,1,3,6,1,1250,1261
E01019831,1,1,8,5,1360,1375
E01019809,0,0,5,3,1127,1135
E01019810,0,4,8,13,1409,1434
E01019811,3,8,4,10,1539,1564
E01019812,2,7,14,4,1756,1783
E01019813,2,1,19,9,1673,1704
E01019825,0,5,19,18,1358,1400
E01019773,1,6,19,41,2311,2378
E01019775,0,5,11,12,1734,1762
E01019776,2,6,16,25,1317,1366
E01019777,2,5,27,17,2330,2381
E01019814,0,7,4,36,1673,1720
E01019817,1,1,2,3,1204,1211
E01019818,2,3,6,5,1525,1541
E01019819,2,2,12,7,1400,1423
E01019820,3,4,5,4,1401,1417
E01019791,2,3,17,8,1730,1760
E01019792,0,2,25,11,1993,2031
E01019815,5,6,26,29,2653,2719
E01032586,1,1,16,12,1613,1643
E01019839,1,29,31,77,1727,1865
E01019845,4,2,13,7,1298,1324
E01019846,0,1,5,5,1228,1239
E01019866,2,19,31,45,2290,2387
E01019840,8,11,17,26,1562,1624
E01019841,8,6,15,21,1472,1522
E01019847,1,2,14,20,1319,1356
E01019848,8,6,57,39,2016,2126
E01033532,10,5,39,61,1348,1463
E01033533,4,6,48,36,1602,1696
E01033534,3,6,28,26,1010,1073
E01019873,19,56,39,268,1079,1461
E01019874,20,37,34,321,1037,1449
E01019875,30,42,41,565,740,1418
E01019881,0,6,16,18,1319,1359
E01019882,1,2,7,11,1544,1565
E01019832,3,4,11,24,1671,1713
E01019833,3,6,13,15,1789,1826
E01019834,3,0,6,18,1479,1506
E01019835,7,28,30,97,1459,1621
E01019867,3,8,21,53,1467,1552
E01019868,2,4,36,17,1664,1723
E01019869,5,14,32,34,1577,1662
E01019880,7,4,13,24,1559,1607
E01019843,4,2,8,13,1513,1540
E01019853,0,2,10,2,1529,1543
E01019854,2,7,16,12,1704,1741
E01019855,0,7,15,13,1524,1559
E01019844,1,0,4,8,1535,1548
E01019856,7,3,14,8,1464,1496
E01019857,1,1,3,8,1262,1275
E01019858,1,4,15,25,1576,1621
E01019859,3,1,13,5,1652,1674
E01019860,2,2,10,2,1306,1322
E01019861,3,7,13,8,1752,1783
E01019862,1,2,11,7,1459,1480
E01019863,0,1,23,12,1557,1593
E01019864,0,1,20,17,1454,1492
E01019865,1,3,13,11,1290,1318
E01019876,6,4,10,35,1873,1928
E01019877,6,10,21,27,1506,1570
E01019878,4,2,5,13,1527,1551
E01019879,2,2,5,33,1809,1851
E01019850,1,3,6,6,1546,1562
E01019851,0,2,14,8,1615,1639
E01019852,4,4,10,21,1753,1792
E01019870,2,3,10,25,1556,1596
E01019871,1,5,13,24,1725,1768
E01019872,1,2,10,11,1874,1898
E01019837,4,5,27,41,1854,1931
E01019838,1,8,7,17,1636,1669
E01033531,5,4,19,21,1547,1596
E01033536,0,0,18,16,1614,1648
E01033537,0,7,16,21,1641,1685
E01019842,0,1,9,10,1692,1712
E01019883,6,9,38,33,2759,2845
E01019885,1,3,11,17,1669,1701
E01033535,0,4,28,17,1498,1547
E01025631,8,8,27,67,1102,1212
E01025632,13,24,24,388,1008,1457
E01025633,15,24,30,135,1514,1718
E01025635,8,9,24,53,1159,1253
E01025634,13,21,24,213,1217,1488
E01025638,0,11,15,98,1318,1442
E01025639,0,4,9,79,1152,1244
E01025640,1,9,29,83,1450,1572
E01025645,3,1,14,21,1106,1145
E01025666,2,28,26,38,1372,1466
E01025667,5,15,33,47,1080,1180
E01025668,22,84,67,361,1825,2359
E01025669,17,51,75,487,1471,2101
E01025636,10,37,26,239,1029,1341
E01025637,29,31,17,236,997,1310
E01025652,10,49,35,342,909,1345
E01025653,13,40,40,146,1329,1568
E01025654,12,13,29,252,964,1270
E01025655,17,57,43,339,1115,1571
E01025656,10,36,31,442,820,1339
E01025625,3,8,30,18,1170,1229
E01025626,1,8,11,11,1223,1254
E01025627,11,21,26,66,2085,2209
E01025651,3,6,31,37,1545,1622
E01025657,7,25,41,79,1709,1861
E01025660,1,11,40,62,1564,1678
E01025641,0,6,45,20,1695,1766
E01025642,1,2,22,46,1870,1941
E01025643,2,10,31,39,1512,1594
E01025649,1,4,12,39,1517,1573
E01025650,1,2,26,34,1511,1574
E01025610,1,5,29,21,1508,1564
E01025611,4,4,11,32,1481,1532
E01025612,8,15,18,34,1534,1609
E01025658,4,42,88,65,2148,2347
E01025659,8,18,19,41,1706,1792
E01025615,1,16,29,60,1496,1602
E01025646,1,4,22,29,1609,1665
E01025647,1,4,11,16,1554,1586
E01025648,10,9,26,87,1928,2060
E01025613,1,6,14,5,1384,1410
E01025614,1,5,21,18,1704,1749
E01025620,1,4,15,3,1074,1097
E01025621,0,5,11,15,1020,1051
E01025644,0,1,25,19,1373,1418
E01025616,1,1,16,18,1606,1642
E01025617,2,2,14,18,1660,1696
E01025618,0,1,9,11,1645,1666
E01025619,4,4,10,12,1613,1643
E01025661,0,4,16,6,1738,1764
E01025662,1,1,6,18,1509,1535
E01025663,1,0,6,30,1399,1436
E01025664,1,5,10,12,1198,1226
E01025665,0,6,19,11,1464,1500
E01025622,10,15,27,40,1561,1653
E01025623,7,8,12,86,1437,1550
E01025624,11,15,22,223,1527,1798
E01025629,10,13,14,32,1439,1508
E01025630,11,17,34,154,1498,1714
E01032603,2,15,18,85,1300,1420
E01025692,19,28,40,268,1641,1996
E01025693,6,3,10,24,1823,1866
E01033386,32,8,20,495,1644,2199
E01025699,13,23,29,280,1058,1403
E01025700,37,38,56,534,1121,1786
E01025701,18,24,42,455,1046,1585
E01025703,21,32,50,589,1308,2000
E01025704,11,37,28,224,1143,1443
E01025705,10,27,31,418,886,1372
E01025706,27,17,26,545,1074,1689
E01025720,30,60,53,301,1644,2088
E01025721,13,20,41,145,1505,1724
E01025722,7,14,27,95,883,1026
E01025723,17,43,44,263,1791,2158
E01025724,19,44,35,253,1219,1570
E01025725,6,8,11,85,1206,1316
E01025695,17,16,23,203,1233,1492
E01025696,9,3,24,226,1140,1402
E01025697,14,12,16,170,1146,1358
E01025698,18,23,29,217,1290,1577
E01025744,0,7,29,26,1851,1913
E01025745,2,0,4,15,1409,1430
E01025746,0,3,11,18,1772,1804
E01025747,4,3,20,20,1792,1839
E01025740,1,2,16,28,1452,1499
E01025741,0,5,11,21,1506,1543
E01025742,5,2,15,17,1597,1636
E01025743,0,3,22,25,1791,1841
E01025689,29,96,53,334,2086,2598
E01025690,49,114,116,606,3004,3889
E01025707,27,36,26,328,1378,1795
E01025709,20,75,64,364,1857,2380
E01025760,1,10,15,11,1310,1347
E01025761,1,1,10,9,1787,1808
E01025768,1,2,7,18,1412,1440
E01025769,5,6,15,73,1462,1561
E01025702,10,9,15,200,996,1230
E01025715,8,5,24,88,1397,1522
E01025716,9,6,36,77,1440,1568
E01025717,4,12,40,93,2051,2200
E01025718,17,45,41,187,1093,1383
E01025719,13,13,38,115,1351,1530
E01025708,25,3,25,188,1024,1265
E01025710,8,7,11,152,1073,1251
E01025711,20,9,25,95,1424,1573
E01025712,0,3,14,91,1245,1353
E01025713,10,17,26,133,1334,1520
E01025714,47,7,33,247,1792,2126
E01025674,8,2,13,29,1491,1543
E01025675,2,6,23,8,1469,1508
E01025676,4,2,26,26,2068,2126
E01025677,2,5,18,30,1302,1357
E01025732,7,2,8,48,1540,1605
E01025733,1,2,15,22,1458,1498
E01025734,0,4,22,24,1512,1562
E01025735,8,5,18,53,1744,1828
E01025748,3,5,23,33,2089,2153
E01025749,1,1,16,9,1569,1596
E01025750,2,1,12,27,1379,1421
E01025751,3,6,16,26,2036,2087
E01025726,0,9,21,62,1768,1860
E01025727,1,1,25,18,1540,1585
E01025728,2,3,34,20,1789,1848
E01025729,7,2,14,40,1551,1614
E01025737,0,8,30,57,1770,1865
E01025739,2,2,16,36,1347,1403
E01025685,0,3,21,25,1357,1406
E01025686,3,2,9,71,1375,1460
E01025730,2,3,13,23,1447,1488
E01025731,0,0,12,44,1474,1530
E01025687,4,1,13,51,1506,1575
E01025688,6,6,29,25,1781,1847
E01025736,1,5,16,33,1411,1466
E01025738,11,13,14,82,1334,1454
E01025756,2,2,33,167,1690,1894
E01025757,5,9,24,424,1024,1486
E01025758,21,8,33,500,1234,1796
E01025759,5,4,14,64,1298,1385
E01025752,19,6,33,108,1792,1958
E01025753,10,1,17,34,1458,1520
E01025754,2,0,18,44,1206,1270
E01025755,0,1,13,47,1434,1495
E01025679,9,28,57,472,1935,2501
E01025680,4,4,26,403,1229,1666
E01025681,2,8,34,292,1261,1597
E01025682,13,5,19,98,1322,1457
E01025678,9,15,35,356,1320,1735
E01025683,4,14,31,130,1508,1687
E01025684,16,8,37,158,1659,1878
E01025762,24,11,25,245,1157,1462
E01025763,2,15,32,250,1358,1657
E01025764,13,7,13,570,792,1395
E01025765,26,25,31,821,701,1604
E01025766,12,23,40,232,1776,2083
E01025767,4,11,20,294,1138,1467
E01025670,0,8,20,23,1261,1312
E01025671,0,5,39,34,1769,1847
E01025672,2,12,37,22,1698,1771
E01025673,0,17,22,59,1500,1598
E01025770,1,9,21,33,1799,1863
E01025809,1,2,13,26,2266,2308
E01025815,0,6,12,20,1992,2030
E01025781,5,18,40,389,1120,1572
E01025782,9,3,14,49,1228,1303
E01025783,3,3,10,109,1358,1483
E01025785,17,4,34,40,2061,2156
E01025786,0,0,10,9,1573,1592
E01025787,2,2,17,17,1655,1693
E01025772,1,2,31,34,2256,2324
E01025773,0,3,16,14,1479,1512
E01025774,5,2,6,9,1306,1328
E01025775,2,3,15,13,1739,1772
E01025776,2,3,15,20,1964,2004
E01025771,1,6,13,25,2512,2557
E01025778,5,3,19,56,1870,1953
E01025779,0,6,22,18,1563,1609
E01025780,0,2,28,6,1296,1332
E01025784,0,1,14,11,1356,1382
E01025788,0,2,18,28,1164,1212
E01025777,3,0,11,20,2166,2200
E01025808,4,0,19,25,2539,2587
E01025810,6,0,19,22,2301,2348
E01025816,4,3,31,13,2230,2281
E01025789,18,58,31,55,1575,1737
E01025794,0,1,26,25,1811,1863
E01025797,1,1,25,1,1660,1688
E01025802,1,8,11,13,1297,1330
E01025803,4,8,26,20,1498,1556
E01025805,1,5,6,6,1528,1546
E01025795,7,40,27,85,1641,1800
E01025796,7,1,12,25,1900,1945
E01025801,6,11,16,58,1178,1269
E01025806,0,5,25,32,1456,1518
E01025798,0,7,11,23,1723,1764
E01025799,2,1,40,57,2037,2137
E01025800,2,2,9,26,1115,1154
E01025804,0,6,18,19,1896,1939
E01025807,7,2,19,24,1350,1402
E01025790,1,6,21,31,2269,2328
E01025791,3,6,23,27,2168,2227
E01025792,5,1,17,25,2249,2297
E01025793,2,6,24,58,2411,2501
E01025812,16,22,40,229,1422,1729
E01025813,24,17,20,361,1182,1604
E01025814,7,12,24,78,1403,1524
E01032598,20,18,52,279,1754,2123
E01025868,7,1,15,29,1430,1482
E01025869,3,3,8,26,1438,1478
E01025870,9,5,14,79,1409,1516
E01025871,1,0,7,15,1182,1205
E01025878,4,14,28,40,2519,2605
E01025846,1,13,29,120,1866,2029
E01025847,6,9,29,155,1459,1658
E01025848,1,5,15,58,1433,1512
E01025845,1,2,29,120,1445,1597
E01025877,2,3,11,27,1584,1627
E01025879,3,4,11,10,1218,1246
E01025880,3,6,7,36,1543,1595
E01025819,0,2,11,8,1629,1650
E01025820,0,2,8,13,1577,1600
E01025837,0,3,8,9,1993,2013
E01025838,1,2,10,9,1457,1479
E01025882,0,1,18,9,1603,1631
E01025872,2,1,8,13,1470,1494
E01025873,4,6,15,26,1513,1564
E01025874,1,6,15,15,1515,1552
E01025875,1,1,13,24,1479,1518
E01025876,8,5,26,73,1769,1881
E01025839,2,12,16,34,1583,1647
E01025840,5,3,20,17,1468,1513
E01025841,2,9,11,19,1659,1700
E01025842,5,3,34,20,1773,1835
E01025843,8,3,21,17,1564,1613
E01025844,2,5,11,33,1688,1739
E01025821,0,4,19,13,1661,1697
E01025822,0,2,24,3,1395,1424
E01025823,0,2,29,7,1513,1551
E01025824,1,7,19,15,1447,1489
E01025825,0,4,16,14,1420,1454
E01025826,7,7,10,14,1369,1407
E01025817,1,2,13,5,1944,1965
E01025818,8,10,21,71,1380,1490
E01025864,7,0,10,22,1552,1591
E01025881,1,2,5,16,1349,1373
E01025859,0,2,18,23,1343,1386
E01025860,2,0,12,33,1382,1429
E01025861,2,1,16,37,1631,1687
E01025862,0,4,8,11,1428,1451
E01025850,2,5,23,34,1364,1428
E01025852,2,8,21,120,1532,1683
E01025858,9,5,14,47,1777,1852
E01025863,2,1,18,28,1597,1646
E01025865,3,3,26,38,1696,1766
E01025853,1,1,27,80,2681,2790
E01025854,5,1,8,23,1712,1749
E01025855,1,3,14,23,1369,1410
E01025866,6,2,26,25,1533,1592
E01025867,0,3,9,17,1502,1531
E01025849,3,2,22,92,1514,1633
E01025851,0,3,15,29,1250,1297
E01025856,0,4,7,24,1272,1307
E01025857,0,1,13,66,1373,1453
E01025827,1,3,13,18,1373,1408
E01025828,0,15,2,17,1386,1420
E01025829,2,2,14,32,1392,1442
E01025830,0,5,10,14,1407,1436
E01025831,0,7,6,14,1265,1292
E01025832,14,1,18,77,1475,1585
E01025833,2,2,21,12,1571,1608
E01025834,6,5,9,15,1462,1497
E01025835,1,3,8,54,1519,1585
E01025836,3,1,15,9,1267,1295
E01025885,1,4,14,5,1807,1831
E01025886,0,4,10,6,1736,1756
E01025887,0,1,6,3,1793,1803
E01025890,1,1,11,12,1240,1265
E01025891,0,2,4,1,1305,1312
E01025892,1,0,12,6,1630,1649
E01025901,0,1,11,7,1701,1720
E01025902,6,3,10,18,1585,1622
E01025903,1,1,15,24,1709,1750
E01025904,0,3,13,12,1998,2026
E01025906,2,1,9,9,1767,1788
E01025883,1,1,8,11,1547,1568
E01025884,0,0,9,18,1691,1718
E01025888,1,2,23,12,1738,1776
E01025909,0,2,11,9,1912,1934
E01025896,0,10,21,14,1579,1624
E01025897,7,9,19,24,1978,2037
E01025898,0,3,8,9,1321,1341
E01025899,0,14,16,20,1105,1155
E01025900,0,5,19,8,1467,1499
E01025905,3,4,25,15,1680,1727
E01025893,2,6,20,88,1951,2067
E01025894,0,5,29,56,1418,1508
E01025895,2,2,14,29,1665,1712
E01025907,1,2,14,39,1725,1781
E01025908,1,1,16,28,1755,1801
E01025889,0,2,16,12,1717,1747
E01025910,0,1,13,11,1731,1756
E01025911,0,3,9,1,1562,1575
E01025912,0,2,9,11,1506,1528
E01025924,6,0,10,5,1008,1029
E01025925,8,4,29,54,2438,2533
E01025926,1,7,14,15,1540,1577
E01025927,3,1,13,14,1588,1619
E01025928,0,3,14,17,1491,1525
E01025923,6,0,2,6,1356,1370
E01025944,1,1,8,11,1490,1511
E01025945,2,3,7,27,1494,1533
E01025946,4,7,16,32,1622,1681
E01025915,5,10,15,61,1202,1293
E01025916,0,0,12,33,1424,1469
E01025917,4,2,35,75,1926,2042
E01025918,3,2,29,11,1514,1559
E01025960,2,1,11,15,1444,1473
E01025961,4,1,9,14,1445,1473
E01025962,2,1,4,2,1412,1421
E01025965,0,3,12,3,1252,1270
E01025955,1,4,10,8,1346,1369
E01025956,2,2,3,4,1142,1153
E01025963,0,3,12,11,1512,1538
E01025964,0,1,18,18,1615,1652
E01025914,0,3,11,3,1369,1386
E01025919,0,3,14,21,1482,1520
E01025920,1,1,10,12,1617,1641
E01025921,1,0,4,28,1587,1620
E01025966,3,2,8,7,1537,1557
E01025967,1,2,6,4,1646,1659
E01025968,6,1,15,6,1824,1852
E01025969,3,6,29,22,1739,1799
E01025950,2,2,22,8,1649,1683
E01025951,1,0,9,8,1771,1789
E01025952,3,1,7,2,1437,1450
E01025953,0,0,8,1,1112,1121
E01025954,1,1,11,7,1496,1516
E01025932,1,13,8,13,1456,1491
E01025933,4,1,14,6,1335,1360
E01025934,3,9,22,15,1566,1615
E01025935,1,3,13,6,1149,1172
E01025936,4,2,1,2,1260,1269
E01025929,0,14,20,53,2058,2145
E01025930,0,14,26,43,1572,1655
E01025931,1,2,20,36,1675,1734
E01025957,1,4,25,42,1787,1859
E01025937,2,1,6,26,1530,1565
E01025958,1,5,24,11,1581,1622
E01025959,2,2,16,15,2081,2116
E01033102,4,9,42,34,1532,1621
E01033103,11,7,20,51,1663,1752
E01025913,3,5,20,6,2218,2252
E01025947,0,3,14,12,1770,1799
E01025948,4,4,20,23,1685,1736
E01025949,0,7,27,13,1627,1674
E01025938,0,0,8,9,1222,1239
E01025939,0,10,26,41,1911,1988
E01025940,2,2,20,14,1919,1957
E01025941,0,2,13,9,1488,1512
E01025942,0,7,21,16,1738,1782
E01025943,1,1,18,13,1837,1870
E01025970,32,15,28,569,770,1414
E01025971,68,20,25,459,676,1248
E01025972,39,15,19,462,756,1291
E01025976,41,29,54,304,931,1359
E01025977,10,21,30,359,931,1351
E01025978,28,25,40,369,1053,1515
E01025992,2,7,22,21,1517,1569
E01025994,6,5,25,62,1438,1536
E01025997,6,15,50,93,1313,1477
E01025999,2,22,33,74,1295,1426
E01026005,11,11,40,220,1484,1766
E01025985,0,5,10,35,1262,1312
E01025986,6,8,19,68,1378,1479
E01025987,11,4,45,45,1383,1488
E01025988,1,16,42,70,1438,1567
E01025989,2,20,31,30,1561,1644
E01025990,1,12,7,83,1249,1352
E01025991,7,9,21,103,1335,1475
E01025993,6,17,27,119,1334,1503
E01025998,9,7,27,115,1614,1772
E01026000,1,13,11,66,1230,1321
E01026001,2,13,10,47,1307,1379
E01025995,33,32,27,464,939,1495
E01026003,10,27,27,266,1292,1622
E01026004,24,5,37,256,1409,1731
E01032600,15,41,39,353,1506,1954
E01032601,30,10,20,191,1202,1453
E01025973,52,71,86,1398,1209,2816
E01025974,36,57,100,593,1534,2320
E01025975,61,12,32,775,591,1471
E01025979,37,19,38,619,687,1400
E01025980,38,15,31,877,438,1399
E01025981,46,17,26,828,707,1624
E01025982,39,24,39,939,893,1934
E01025983,22,18,30,431,725,1226
E01025984,58,14,28,757,624,1481
E01026007,0,0,1,2,1103,1106
E01026008,2,17,15,17,1451,1502
E01026009,0,1,3,3,1262,1269
E01026023,2,5,5,3,1382,1397
E01026024,2,2,5,2,2011,2022
E01026010,11,5,28,11,1423,1478
E01026011,15,14,57,44,2860,2990
E01026030,8,9,38,15,2130,2200
E01026032,22,4,28,26,1951,2031
E01026037,0,2,27,5,1288,1322
E01026006,25,27,43,90,2373,2558
E01026021,9,14,22,111,1607,1763
E01026025,8,8,41,71,2054,2182
E01026036,3,14,26,36,1549,1628
E01026012,2,4,9,0,1135,1150
E01026015,3,8,31,20,1398,1460
E01026026,3,7,40,13,1891,1954
E01026027,0,9,17,17,1804,1847
E01026028,14,14,21,12,1757,1818
E01026016,3,3,9,11,2286,2312
E01026033,2,2,9,3,1971,1987
E01026034,1,4,14,2,1765,1786
E01026017,1,4,11,5,1550,1571
E01026018,2,3,3,12,1651,1671
E01026019,7,15,28,16,2688,2754
E01026020,1,1,22,15,2206,2245
E01026041,1,2,8,2,1287,1300
E01026013,2,10,6,27,1401,1446
E01026014,5,5,12,27,1895,1944
E01026022,8,22,22,204,1848,2104
E01026038,4,4,17,15,1216,1256
E01026040,2,8,5,11,1227,1253
E01026029,5,19,16,43,2534,2617
E01026031,1,0,11,0,1445,1457
E01026035,0,10,10,33,2010,2063
E01026039,1,2,4,4,1183,1194
E01026045,5,1,9,4,1812,1831
E01026061,1,1,5,2,1192,1201
E01026062,4,6,1,12,1204,1227
E01026063,1,0,3,3,1256,1263
E01026080,7,1,13,7,1905,1933
E01026106,1,1,4,1,1187,1194
E01026107,2,5,14,10,1224,1255
E01026058,0,2,8,7,2164,2181
E01026076,0,2,16,5,2171,2194
E01026079,2,2,4,6,1949,1963
E01026077,0,0,7,12,1114,1133
E01026078,3,4,10,4,1120,1141
E01026087,0,0,8,2,1173,1183
E01026088,2,0,2,5,1338,1347
E01026090,0,1,6,8,1330,1345
E01026091,0,1,6,4,1069,1080
E01026108,3,3,22,12,2364,2404
E01026081,1,10,33,19,2287,2350
E01026089,1,0,12,8,1984,2005
E01032986,1,6,13,15,1096,1131
E01032987,1,4,12,8,1275,1300
E01026072,5,4,8,4,1962,1983
E01026073,0,2,8,23,1972,2005
E01026074,0,1,12,5,2010,2028
E01026099,0,2,11,3,2050,2066
E01026103,0,0,7,23,2057,2087
E01026104,0,1,11,3,2254,2269
E01026109,0,0,7,5,2147,2159
E01026071,1,0,10,2,2115,2128
E01026082,2,2,8,8,2250,2270
E01026121,0,6,20,7,2436,2469
E01026042,0,0,4,11,1515,1530
E01026043,0,2,12,14,1607,1635
E01026044,0,0,6,2,1358,1366
E01026113,2,0,6,2,2017,2027
E01026117,0,2,10,2,1812,1826
E01026060,1,12,14,7,1287,1321
E01026068,0,0,14,4,2089,2107
E01026070,0,2,14,1,1874,1891
E01026105,0,2,10,13,2171,2196
E01026048,4,0,18,4,1491,1517
E01026049,1,3,13,2,1537,1556
E01026050,0,0,7,3,1591,1601
E01026069,1,1,21,21,2348,2392
E01026064,0,1,10,12,1432,1455
E01026065,1,4,7,17,1787,1816
E01026066,0,3,17,16,1856,1892
E01026067,1,6,21,18,1864,1910
E01026084,0,28,11,30,1529,1598
E01026085,1,6,15,10,2194,2226
E01026115,4,6,12,5,1728,1755
E01026116,2,5,14,29,1650,1700
E01026046,1,3,16,6,1115,1141
E01026047,1,1,7,2,1188,1199
E01026055,0,0,11,2,1104,1117
E01026059,1,3,9,8,1153,1174
E01026100,1,8,12,15,1746,1782
E01026101,1,2,17,2,1241,1263
E01026092,1,10,17,11,1392,1431
E01026093,5,3,18,37,1678,1741
E01026095,0,5,11,6,1185,1207
E01026114,4,6,17,16,1439,1482
E01026083,4,3,29,19,1715,1770
E01026094,0,5,10,6,1647,1668
E01026096,0,0,6,16,1490,1512
E01026097,2,7,10,13,1457,1489
E01026051,0,4,4,3,1233,1244
E01026052,0,4,6,19,1467,1496
E01026053,2,2,15,10,2013,2042
E01026054,0,11,26,22,2102,2161
E01026118,8,4,13,12,1650,1687
E01026119,0,4,10,5,1145,1164
E01026120,0,3,12,23,1409,1447
E01026056,1,0,1,3,1166,1171
E01026110,1,1,19,5,1413,1439
E01026111,0,1,11,5,1546,1563
E01026112,0,2,20,2,1166,1190
E01026057,0,8,11,9,1892,1920
E01026075,2,1,9,8,2103,2123
E01026098,1,11,4,27,1936,1979
E01026102,0,1,20,17,2319,2357
E01026149,3,3,21,6,1598,1631
E01026150,4,6,10,4,1440,1464
E01026166,1,10,12,17,1179,1219
E01026168,2,7,19,1,1393,1422
E01026153,11,21,37,89,2313,2471
E01026155,17,10,17,62,1505,1611
E01026157,6,14,7,29,1297,1353
E01026165,2,7,9,7,1351,1376
E01026125,10,30,24,75,1425,1564
E01026144,9,5,15,36,1438,1503
E01026147,14,9,36,45,2197,2301
E01026148,7,11,30,18,1701,1767
E01026151,4,14,15,16,1793,1842
E01026164,2,3,23,34,1398,1460
E01026167,3,10,35,31,1438,1517
E01026122,20,28,39,101,1702,1890
E01026123,20,32,36,57,2146,2291
E01026124,20,17,16,45,1429,1527
E01026126,21,47,37,93,1480,1678
E01026152,18,11,31,3,1480,1543
E01026154,3,9,11,21,1364,1408
E01026156,3,1,17,35,1207,1263
E01026132,14,53,64,113,2512,2756
E01026143,13,24,49,65,2062,2213
E01026145,3,9,23,21,1472,1528
E01026146,2,11,49,55,1859,1976
E01026134,4,22,17,27,1463,1533
E01026176,4,23,48,42,1555,1672
E01026177,14,24,47,83,1716,1884
E01026178,7,16,18,35,1594,1670
E01026127,1,7,11,12,1355,1386
E01026128,5,29,24,19,2569,2646
E01026129,1,21,20,22,1707,1771
E01026131,0,6,10,6,1367,1389
E01026133,8,71,64,117,3171,3431
E01026135,1,0,10,14,1632,1657
E01026136,1,3,15,23,1392,1434
E01026174,5,12,22,20,1337,1396
E01026130,18,13,11,14,1272,1328
E01026158,3,12,14,19,1420,1468
E01026159,0,10,15,15,1451,1491
E01026160,7,5,14,14,1312,1352
E01026162,11,17,7,6,1444,1485
E01026163,0,13,12,15,1322,1362
E01026161,3,7,9,4,1359,1382
E01026170,0,6,10,11,1422,1449
E01026172,2,8,16,13,1384,1423
E01026173,9,11,13,19,1510,1562
E01026175,4,13,32,28,1746,1823
E01026137,7,2,6,11,1199,1225
E01026138,3,3,20,47,1406,1479
E01026139,6,3,11,5,1155,1180
E01026140,1,6,5,16,1232,1260
E01026141,0,5,10,22,1453,1490
E01026142,1,0,12,7,1249,1269
E01026169,0,5,16,24,1583,1628
E01026171,2,3,9,5,1423,1442
E01026186,2,9,10,27,1508,1556
E01026187,4,19,26,22,1861,1932
E01026189,0,4,25,13,1712,1754
E01026203,0,4,9,6,1750,1769
E01026204,3,2,5,4,1651,1665
E01026206,0,1,11,8,1872,1892
E01026182,0,1,12,9,1403,1425
E01026193,2,14,11,10,1402,1439
E01026199,2,2,17,22,2267,2310
E01026225,0,7,5,3,1591,1606
E01026226,4,1,6,7,1841,1859
E01032990,8,8,25,18,2287,2346
E01032994,1,3,9,4,1278,1295
E01026184,0,5,26,6,1835,1872
E01026185,0,1,5,11,1783,1800
E01026188,7,3,24,17,2117,2168
E01026190,0,3,9,2,1477,1491
E01026237,0,2,7,11,1087,1107
E01026238,0,5,16,2,1320,1343
E01026191,2,3,9,6,1669,1689
E01026205,0,2,8,8,1443,1461
E01026211,1,1,8,4,1909,1923
E01026212,0,5,8,15,1550,1578
E01026213,1,0,7,1,1684,1693
E01026192,2,7,18,4,1165,1196
E01026194,0,3,15,9,1860,1887
E01026195,1,0,19,19,1891,1930
E01026196,7,0,4,6,1497,1514
E01026180,3,1,8,2,1450,1464
E01026183,6,8,18,7,2520,2559
E01026210,1,3,8,6,2243,2261
E01026224,3,5,10,2,1701,1721
E01026179,4,1,16,4,1306,1331
E01026197,0,2,11,1,1358,1372
E01026198,2,5,20,10,1418,1455
E01026223,2,3,16,10,2058,2089
E01026209,1,0,12,6,2091,2110
E01026221,2,1,14,4,2303,2324
E01026222,3,7,11,9,1797,1827
E01026227,0,2,29,24,1337,1392
E01026230,0,3,11,7,1210,1231
E01026231,0,9,26,20,2574,2629
E01026232,3,11,19,29,2156,2218
E01026235,0,8,17,16,1553,1594
E01026228,1,1,11,17,1459,1489
E01026229,2,1,8,30,1502,1543
E01026233,4,1,12,8,1692,1717
E01026234,20,9,16,23,2632,2700
E01026236,1,1,4,19,1133,1158
E01026200,2,3,10,14,1537,1566
E01026201,0,1,14,8,1977,2000
E01026202,4,4,3,5,1771,1787
E01026207,0,3,11,8,1194,1216
E01026208,1,1,10,20,1597,1629
E01026220,2,5,8,19,2259,2293
E01032988,0,9,8,21,1351,1389
E01032989,5,6,16,33,1298,1358
E01032993,7,10,10,26,1380,1433
E01026214,3,0,7,6,1141,1157
E01026215,5,0,7,6,1085,1103
E01026218,0,1,6,7,1136,1150
E01026219,0,5,15,16,1185,1221
E01032991,4,2,9,20,1398,1433
E01032992,1,4,6,13,1323,1347
E01026242,0,6,6,1,1457,1470
E01026243,1,4,16,5,1309,1335
E01026244,0,2,7,13,1317,1339
E01026247,3,4,7,9,1904,1927
E01026276,0,2,13,11,2343,2369
E01026246,5,4,20,23,2299,2351
E01026248,3,3,12,10,2242,2270
E01026257,0,2,11,8,1865,1886
E01026250,0,5,10,36,1737,1788
E01026251,1,6,6,18,1786,1817
E01026252,0,1,21,14,1705,1741
E01026253,1,6,18,11,1728,1764
E01026281,0,2,16,3,1296,1317
E01026282,1,0,17,11,1708,1737
E01026283,0,5,16,8,1697,1726
E01026285,0,0,9,0,1430,1439
E01026286,0,0,8,6,1259,1273
E01026241,5,2,23,13,1918,1961
E01026258,1,2,11,23,1714,1751
E01026259,2,0,13,7,1690,1712
E01026260,3,11,15,27,1936,1992
E01026266,2,17,35,36,1912,2002
E01026273,3,4,17,8,1656,1688
E01026274,0,5,21,23,1883,1932
E01026275,7,5,25,36,1935,2008
E01032995,7,10,32,43,1299,1391
E01032996,1,0,10,2,1345,1358
E01026268,3,6,26,15,1921,1971
E01026269,4,9,22,11,2144,2190
E01026270,5,18,36,8,1835,1902
E01026271,5,5,26,27,1716,1779
E01026272,5,3,14,26,1190,1238
E01026254,3,4,14,12,1743,1776
E01026255,4,3,14,8,1943,1972
E01026256,3,3,14,14,1592,1626
E01026277,1,12,14,6,1630,1663
E01026278,0,5,18,12,1372,1407
E01026279,1,6,4,6,1367,1384
E01026262,1,5,8,15,1510,1539
E01026263,4,8,12,28,1942,1994
E01026264,0,6,23,12,1505,1546
E01026265,0,2,7,13,1340,1362
E01026267,9,6,36,47,2724,2822
E01026245,2,4,11,26,2093,2136
E01026249,1,0,17,7,1846,1871
E01026280,0,8,17,12,2502,2539
E01026239,1,6,13,9,1763,1792
E01026240,1,20,14,23,2361,2419
E01026284,1,10,21,5,1961,1998
E01026313,0,15,5,16,1500,1536
E01026314,4,1,8,8,1273,1294
E01026329,2,8,23,14,1840,1887
E01026333,0,3,8,7,2504,2522
E01026291,0,2,15,12,1923,1952
E01026340,1,4,16,5,2174,2200
E01026355,0,3,11,12,2357,2383
E01026365,0,1,17,14,2277,2309
E01026325,0,2,20,19,1474,1515
E01026326,2,5,8,24,1503,1542
E01026327,1,4,17,10,1304,1336
E01026328,0,9,23,14,1413,1459
E01026352,4,10,14,69,1163,1260
E01026353,4,9,22,51,1519,1605
E01026354,4,12,14,70,1091,1191
E01026320,7,9,23,55,1689,1783
E01026321,2,9,6,29,1260,1306
E01026322,6,3,4,22,1069,1104
E01026323,4,8,17,50,1763,1842
E01026324,6,5,8,39,2184,2242
E01026308,2,18,22,29,1413,1484
E01026309,0,7,16,15,1529,1567
E01026310,0,3,18,9,1205,1235
E01026311,0,3,16,34,1584,1637
E01026312,1,7,14,18,1369,1409
E01026317,6,30,21,74,1931,2062
E01026318,3,28,22,49,1824,1926
E01026319,2,21,19,18,2028,2088
E01026343,2,19,22,28,1737,1808
E01026344,1,4,12,21,1465,1503
E01026345,0,2,12,29,1533,1576
E01026292,7,5,7,2,1401,1422
E01026293,5,6,8,20,2018,2057
E01026294,1,4,11,19,1619,1654
E01026316,2,2,12,12,2389,2417
E01026332,2,3,19,6,2194,2224
E01026290,0,6,12,3,2237,2258
E01026341,0,2,2,4,1471,1479
E01026342,1,3,10,4,1441,1459
E01026361,2,11,18,10,2592,2633
E01026315,1,1,15,11,2056,2084
E01026331,0,5,7,7,2405,2424
E01026338,4,0,7,0,1226,1237
E01026339,2,7,6,10,1182,1207
E01026299,3,11,11,12,1657,1694
E01026300,0,11,11,12,1482,1516
E01026301,6,3,13,22,1587,1631
E01026302,1,5,9,5,1194,1214
E01026296,0,14,14,13,1508,1549
E01026297,0,2,11,18,1316,1347
E01026298,3,13,16,18,1766,1816
E01032997,0,2,16,2,1211,1231
E01032998,3,4,26,39,1217,1289
E01032999,0,1,10,10,1148,1169
E01026330,2,5,20,12,2196,2235
E01026360,1,5,12,11,2124,2153
E01026362,1,4,19,8,1726,1758
E01026363,3,3,12,11,1293,1322
E01026364,0,6,17,5,1703,1731
E01026334,0,0,9,18,1559,1586
E01026335,0,11,22,31,1491,1555
E01026336,0,7,25,3,1553,1588
E01026337,0,5,10,18,1501,1534
E01026303,0,1,9,9,1374,1393
E01026304,2,3,16,7,1426,1454
E01026305,0,7,6,2,1358,1373
E01026306,1,1,13,17,1511,1543
E01026307,1,1,6,5,1275,1288
E01026287,7,7,13,18,1403,1448
E01026288,7,6,17,38,1564,1632
E01026289,2,5,18,26,1982,2033
E01026346,7,2,14,24,1136,1183
E01026347,0,1,23,22,1611,1657
E01026348,0,3,9,22,1145,1179
E01026349,4,2,15,21,1522,1564
E01026350,2,13,27,41,1538,1621
E01026351,11,11,16,45,1392,1475
E01026356,2,3,4,11,1443,1463
E01026357,1,1,17,4,1403,1426
E01026358,2,3,10,15,1391,1421
E01026359,0,8,19,13,1559,1599
E01026367,0,8,11,10,1612,1641
E01026368,0,0,8,4,1581,1593
E01026387,4,6,19,22,2613,2664
E01026416,2,1,14,9,1280,1306
E01032683,0,1,7,2,2211,2221
E01026380,0,8,13,18,1793,1832
E01026401,3,1,3,25,1546,1578
E01026402,0,3,6,22,1794,1825
E01026403,0,1,5,22,1333,1361
E01026407,0,0,4,7,1372,1383
E01026408,0,1,5,0,1319,1325
E01026389,3,11,14,17,1636,1681
E01026390,0,5,8,5,1797,1815
E01026391,0,16,13,22,1870,1921
E01026392,1,6,15,5,2951,2978
E01026415,0,1,8,4,1044,1057
E01026378,0,1,14,21,1666,1702
E01026379,1,3,14,12,1613,1643
E01026381,3,0,10,25,1645,1683
E01026382,6,14,22,30,1593,1665
E01026383,4,17,22,18,1124,1185
E01026384,1,8,21,34,1703,1767
E01026385,0,0,6,4,1144,1154
E01026386,2,2,9,21,1339,1373
E01026399,1,5,9,10,1452,1477
E01026411,0,1,16,2,2433,2452
E01026374,0,8,11,10,1420,1449
E01026375,0,7,17,12,1549,1585
E01026376,0,1,15,12,1774,1802
E01026377,0,15,18,10,2152,2195
E01026388,1,2,12,9,2116,2140
E01026404,1,0,6,5,2210,2222
E01026409,0,0,7,3,1158,1168
E01026410,1,1,10,3,1607,1622
E01026372,2,6,9,18,2429,2464
E01026412,3,0,25,15,1627,1670
E01026413,2,4,17,32,2193,2248
E01026414,1,0,14,2,1669,1686
E01026396,0,0,1,2,1226,1229
E01026397,7,9,27,24,2291,2358
E01026398,1,1,4,7,1476,1489
E01026400,0,0,12,10,1697,1719
E01026393,0,3,13,20,1392,1428
E01026394,0,4,11,26,1824,1865
E01026395,0,0,5,14,1398,1417
E01026405,12,4,16,30,1318,1380
E01026406,3,8,28,44,1185,1268
E01026366,1,2,13,3,2038,2057
E01026369,0,7,3,9,1077,1096
E01026370,0,13,7,17,2055,2092
E01026371,2,4,19,17,1191,1233
E01026373,0,5,14,3,2064,2086
E01026971,3,13,20,15,1676,1727
E01026979,1,5,6,3,1383,1398
E01026980,1,2,16,5,1555,1579
E01026982,4,30,37,25,1876,1972
E01026969,1,4,27,22,1590,1644
E01026970,2,2,17,2,1681,1704
E01026972,2,5,13,21,1787,1828
E01026976,3,8,19,18,1299,1347
E01026981,0,5,17,5,1176,1203
E01026983,2,7,11,4,1083,1107
E01026957,1,13,22,23,1483,1542
E01026958,6,7,29,20,1751,1813
E01026977,2,2,15,7,1883,1909
E01026978,0,1,9,8,1424,1442
E01026962,3,1,7,3,1377,1391
E01026973,1,7,10,21,1383,1422
E01026974,1,1,10,6,1121,1139
E01026975,12,8,25,2,1309,1356
E01026984,2,6,19,22,1666,1715
E01026985,0,0,10,3,1471,1484
E01026949,4,5,14,8,1269,1300
E01026950,1,12,39,8,1490,1550
E01026951,0,5,8,8,1249,1270
E01026952,0,0,14,6,1159,1179
E01026959,6,4,20,8,1377,1415
E01026960,8,24,13,28,1433,1506
E01026961,3,26,21,26,1216,1292
E01026965,6,14,17,18,979,1034
E01026966,2,23,8,25,1335,1393
E01026967,1,33,22,17,1651,1724
E01026968,1,28,32,21,1292,1374
E01026953,1,12,15,26,1291,1345
E01026954,2,15,24,14,1312,1367
E01026955,0,6,17,20,1410,1453
E01026956,0,42,18,28,1859,1947
E01026963,4,36,37,27,1222,1326
E01032963,4,56,29,35,1455,1579
E01032964,8,96,35,65,1517,1721
E01032965,4,99,46,27,1195,1371
E01032966,3,165,34,76,1425,1703
E01032967,5,180,34,56,1409,1684
E01027005,0,3,30,11,2056,2100
E01027026,4,1,11,16,1937,1969
E01027030,2,2,10,4,1757,1775
E01027000,5,4,13,7,1476,1505
E01027001,8,4,28,20,1463,1523
E01027002,0,12,7,16,1686,1721
E01027003,4,11,14,13,1393,1435
E01027022,1,7,17,17,1754,1796
E01026994,0,5,8,1,995,1009
E01026999,0,0,15,7,1737,1759
E01027006,1,6,30,14,1835,1886
E01032968,11,146,117,129,2901,3304
E01026998,0,7,5,18,1719,1749
E01027015,1,1,11,11,1245,1269
E01027016,0,2,16,12,1483,1513
E01027021,0,9,16,6,1813,1844
E01027027,2,6,15,33,2354,2410
E01026997,4,11,17,59,1692,1783
E01027018,0,7,25,27,1405,1464
E01027019,4,6,20,13,1478,1521
E01027020,0,4,16,15,1175,1210
E01027023,0,7,25,21,1994,2047
E01026987,0,3,10,9,1179,1201
E01026989,1,7,20,46,1377,1451
E01026990,0,39,57,69,2464,2629
E01027012,0,23,29,37,1658,1747
E01027014,0,14,42,40,2118,2214
E01026986,17,13,53,74,2741,2898
E01026988,3,9,23,37,1500,1572
E01026991,0,2,11,20,1536,1569
E01026992,0,9,15,61,1821,1906
E01027010,3,3,2,21,1148,1177
E01027007,2,28,12,55,1312,1409
E01027008,0,7,31,33,1877,1948
E01027009,2,11,26,45,1412,1496
E01027013,1,15,38,22,1733,1809
E01027011,2,2,10,25,1860,1899
E01027017,0,1,13,17,1420,1451
E01027024,2,5,17,26,1671,1721
E01027025,0,13,18,4,1605,1640
E01026993,0,5,12,5,1930,1952
E01027004,1,0,9,16,1827,1853
E01027028,1,7,38,29,2054,2129
E01027029,3,4,19,22,1532,1580
E01027033,2,6,16,8,1778,1810
E01027043,1,3,14,12,1951,1981
E01027050,4,3,12,25,1868,1912
E01027031,3,1,19,18,2082,2123
E01027044,4,8,22,14,2011,2059
E01027046,2,7,16,17,1254,1296
E01027047,0,5,13,9,1259,1286
E01027048,2,17,37,102,2000,2158
E01027049,5,5,8,16,961,995
E01027032,1,3,13,8,1844,1869
E01027045,2,3,5,5,1883,1898
E01027075,5,8,20,17,2051,2101
E01027076,1,4,28,30,2094,2157
E01027077,2,12,17,26,1924,1981
E01027057,5,1,21,21,1695,1743
E01027074,2,14,17,14,2136,2183
E01027078,4,3,12,6,2091,2116
E01027051,2,18,16,31,1688,1755
E01027052,2,1,14,10,1395,1422
E01027053,7,4,14,15,1485,1525
E01027054,1,6,4,13,1219,1243
E01027055,1,9,15,5,1109,1139
E01027056,2,5,12,14,1524,1557
E01027038,3,14,26,2,1577,1622
E01027039,0,20,25,18,1742,1805
E01027040,1,12,19,13,1572,1617
E01027041,0,9,45,16,1547,1617
E01027042,3,10,25,35,1801,1874
E01027034,1,22,22,21,1586,1652
E01027035,1,8,19,5,1353,1386
E01027037,3,20,28,29,2125,2205
E01033244,3,29,36,29,2300,2397
E01033245,1,2,6,10,990,1009
E01027061,0,31,24,26,1696,1777
E01027062,6,53,49,33,2104,2245
E01027063,4,12,34,32,1738,1820
E01027064,1,15,9,18,1569,1612
E01027072,0,3,31,10,1605,1649
E01027073,0,25,11,20,1977,2033
E01027058,3,5,31,31,1428,1498
E01027059,5,14,41,8,1664,1732
E01027060,26,26,35,25,1666,1778
E01027065,10,13,34,45,1651,1753
E01027069,1,12,26,17,1485,1541
E01027066,0,41,24,62,2091,2218
E01027067,2,18,20,18,1526,1584
E01027068,7,48,43,93,2716,2907
E01027070,3,20,15,23,1580,1641
E01027071,1,2,9,21,1451,1484
E01027090,12,3,9,6,1432,1462
E01027103,4,3,8,11,1603,1629
E01027129,1,16,17,11,2140,2185
E01027094,1,10,25,10,1506,1552
E01027095,0,12,14,26,1399,1451
E01027107,2,7,19,9,1232,1269
E01027108,1,5,4,5,1298,1313
E01027109,2,6,22,8,1230,1268
E01032969,1,12,25,14,1235,1287
E01032970,1,16,30,23,1412,1482
E01032971,0,5,31,24,1015,1075
E01027123,0,3,12,8,1572,1595
E01027124,3,6,16,40,2117,2182
E01027125,7,10,9,13,1768,1807
E01027126,0,12,39,16,2043,2110
E01027079,10,7,15,60,1663,1755
E01027080,3,6,23,47,1883,1962
E01027087,6,6,16,110,1042,1180
E01027088,27,4,20,148,1089,1288
E01027089,5,31,17,130,1898,2081
E01027081,23,30,29,51,1317,1450
E01027082,8,36,23,37,1489,1593
E01027083,10,8,27,40,1330,1415
E01027127,2,12,26,34,1795,1869
E01027128,14,32,28,89,1557,1720
E01027105,21,70,59,174,1779,2103
E01027106,6,37,35,165,1692,1935
E01027111,33,34,39,114,1877,2097
E01027112,18,48,42,85,1923,2116
E01027104,5,38,48,150,2094,2335
E01027110,5,39,57,51,1579,1731
E01027113,27,33,23,61,2028,2172
E01027115,3,13,16,39,1104,1175
E01027116,17,48,42,226,1845,2178
E01027117,32,40,22,162,1145,1401
E01027096,5,12,16,63,1096,1192
E01027097,2,10,8,73,1274,1367
E01027098,1,1,17,28,1171,1218
E01027099,10,3,16,62,1373,1464
E01027122,10,7,4,24,1137,1182
E01027100,7,25,27,73,1468,1600
E01027114,5,30,31,41,1488,1595
E01027130,4,40,24,60,1697,1825
E01027131,3,43,32,44,1890,2012
E01027084,2,2,11,16,1431,1462
E01027085,4,10,20,22,1231,1287
E01027086,5,11,27,57,1569,1669
E01027120,1,11,26,30,1274,1342
E01027121,19,16,8,104,1308,1455
E01027091,1,4,15,20,1827,1867
E01027092,0,1,16,9,1476,1502
E01027101,4,26,29,31,2332,2422
E01027102,4,6,14,21,1613,1658
E01027119,0,7,22,14,1665,1708
E01032972,0,5,12,3,1419,1439
E01032973,9,15,37,26,1612,1699
E01032974,2,8,14,5,1258,1287
E01027145,2,32,29,128,1211,1402
E01027148,7,12,22,55,1357,1453
E01027149,12,28,30,32,1355,1457
E01027232,17,181,69,338,1935,2540
E01027218,8,22,27,33,1473,1563
E01027219,8,25,31,32,1607,1703
E01027221,14,39,24,45,1622,1744
E01027222,0,12,11,26,1218,1267
E01027143,7,5,10,29,1244,1295
E01027144,1,17,15,30,1441,1504
E01027146,9,15,29,48,1394,1495
E01027147,3,53,47,104,1464,1671
E01027195,34,209,92,122,1118,1575
E01027245,14,136,49,53,1367,1619
E01027247,10,126,66,79,1284,1565
E01027248,12,162,83,77,1200,1534
E01027249,6,161,107,76,1476,1826
E01027174,8,46,36,94,1133,1317
E01027175,15,178,61,70,1215,1539
E01027178,4,218,95,62,1668,2047
E01027200,5,150,104,80,1127,1466
E01027246,19,200,76,64,1495,1854
E01027171,11,37,47,57,1286,1438
E01027172,6,48,62,75,1388,1579
E01027182,4,61,32,158,1173,1428
E01027183,1,26,20,61,1258,1366
E01027196,8,201,48,325,956,1538
E01027197,13,86,76,77,1150,1402
E01027198,6,212,82,135,1126,1561
E01027199,17,160,55,98,1070,1400
E01027190,10,16,38,26,1441,1531
E01027191,16,115,69,97,1484,1781
E01027193,7,19,17,26,1365,1434
E01027194,4,19,12,19,1293,1347
E01027192,1,77,49,73,1188,1388
E01027229,13,82,68,99,1303,1565
E01027230,3,110,72,103,1254,1542
E01027231,10,100,78,126,1477,1791
E01027179,4,86,41,141,1595,1867
E01027180,21,69,26,62,1364,1542
E01027181,2,24,25,45,1558,1654
E01027140,5,97,41,111,988,1242
E01027142,3,106,43,71,1144,1367
E01027176,5,87,26,60,1330,1508
E01027177,18,149,73,39,1264,1543
E01027168,23,159,99,91,1296,1668
E01027169,7,60,66,93,1418,1644
E01027170,12,108,96,130,1212,1558
E01027173,4,95,86,174,1252,1611
E01027136,11,67,45,68,1652,1843
E01027186,5,62,44,62,1587,1760
E01027188,11,83,78,154,1483,1809
E01027220,1,32,23,38,1226,1320
E01027208,5,19,31,26,1384,1465
E01027209,3,19,22,7,1144,1195
E01027211,7,9,16,14,1334,1380
E01027212,9,29,27,51,1292,1408
E01027184,19,44,41,69,1388,1561
E01027185,19,107,66,80,1228,1500
E01027187,7,49,38,111,1120,1325
E01027189,3,44,63,67,1444,1621
E01027137,17,98,48,87,1119,1369
E01027138,12,38,44,88,1306,1488
E01027139,3,98,32,133,1218,1484
E01027141,2,55,27,161,1211,1456
E01027259,11,97,41,305,1114,1568
E01027239,24,161,59,352,1091,1687
E01027241,10,164,118,197,1252,1741
E01027242,11,106,72,198,1188,1575
E01027243,6,85,69,45,1341,1546
E01027244,11,230,132,62,1189,1624
E01027213,12,56,39,66,1368,1541
E01027214,17,49,41,20,1418,1545
E01027216,2,23,25,57,1507,1614
E01027240,25,85,70,78,1071,1329
E01027207,12,15,13,23,1310,1373
E01027210,1,23,22,35,1060,1141
E01027215,0,16,21,26,1398,1461
E01027217,14,19,37,37,2026,2133
E01027255,13,28,29,87,1190,1347
E01027256,5,14,29,57,1388,1493
E01027258,15,40,21,129,1226,1431
E01027260,16,39,20,198,1149,1422
E01027152,11,101,44,108,1474,1738
E01027153,23,229,91,350,1314,2007
E01027154,12,172,55,114,1404,1757
E01032978,43,314,49,123,846,1375
E01032979,9,261,96,110,824,1300
E01027132,2,176,67,169,1609,2023
E01027133,16,101,63,124,1404,1708
E01027134,7,72,70,247,1370,1766
E01027135,6,55,47,75,1605,1788
E01027155,26,183,82,497,1403,2191
E01027225,30,85,78,197,1263,1653
E01027227,16,104,71,321,1065,1577
E01027228,55,142,55,212,1442,1906
E01027151,16,118,63,220,1206,1623
E01027236,8,23,37,69,1446,1583
E01027237,5,112,46,184,1665,2012
E01027238,10,126,88,119,1605,1948
E01027223,49,107,75,162,1590,1983
E01027224,33,122,110,221,1238,1724
E01027226,11,85,68,247,1366,1777
E01027257,17,51,26,70,1403,1567
E01027233,3,75,64,65,1117,1324
E01027234,21,63,31,85,1200,1400
E01027235,12,103,78,53,1216,1462
E01027252,14,77,79,62,1315,1547
E01027156,10,65,32,55,1095,1257
E01027159,4,33,22,20,1194,1273
E01027160,9,51,70,84,1612,1826
E01027161,0,66,59,47,1385,1557
E01027158,10,36,40,58,1320,1464
E01027201,22,43,34,80,1904,2083
E01027202,3,11,11,19,1510,1554
E01032980,15,117,71,104,1130,1437
E01032981,12,53,82,79,1289,1515
E01027250,8,24,17,57,1265,1371
E01027253,3,54,46,84,1642,1829
E01027254,8,29,32,125,1572,1766
E01032975,13,35,70,80,1522,1720
E01032976,12,16,31,44,1148,1251
E01032977,15,72,70,130,1493,1780
E01027162,20,54,56,110,1316,1556
E01027163,3,12,54,60,1278,1407
E01027164,5,47,38,87,1336,1513
E01027165,2,51,30,54,1196,1333
E01027166,7,43,37,76,1450,1613
E01027167,16,25,31,55,1279,1406
E01027203,7,53,37,121,1401,1619
E01027204,11,51,41,36,1569,1708
E01027205,11,45,57,230,1916,2259
E01027206,21,59,85,215,2567,2947
E01027282,0,6,34,10,1584,1634
E01027283,1,2,19,13,1567,1602
E01027285,1,4,18,9,1677,1709
E01027286,0,1,13,4,1528,1546
E01027287,1,1,9,15,1611,1637
E01027273,1,1,21,18,1712,1753
E01027274,7,3,34,40,1490,1574
E01027275,1,0,15,16,1404,1436
E01027308,2,3,22,18,1550,1595
E01027263,0,3,12,5,1765,1785
E01027279,0,14,27,26,1576,1643
E01027284,1,2,14,10,1969,1996
E01027294,2,8,19,18,1828,1875
E01032982,3,38,23,96,1117,1277
E01032983,9,38,41,104,1335,1527
E01032984,5,35,49,140,1371,1600
E01032985,1,2,12,18,1519,1552
E01027262,2,1,11,20,1575,1609
E01027277,3,4,23,6,1797,1833
E01027289,1,7,18,3,1646,1675
E01027300,2,4,10,7,1383,1406
E01027303,4,7,9,21,1420,1461
E01027297,1,9,16,15,1640,1681
E01027298,1,7,12,15,1267,1302
E01027299,4,3,21,32,1428,1488
E01027301,1,9,31,36,2078,2155
E01027302,2,0,32,22,1384,1440
E01027291,1,13,11,13,1446,1484
E01027292,2,2,4,1,1140,1149
E01027293,0,1,4,4,1190,1199
E01027304,0,2,13,3,1725,1743
E01027305,2,6,9,16,1853,1886
E01027261,4,2,15,16,1991,2028
E01027295,4,4,25,15,2128,2176
E01027306,5,8,8,9,1686,1716
E01027276,3,7,45,33,2429,2517
E01027280,3,16,29,41,2327,2416
E01027281,6,12,17,30,1631,1696
E01027307,0,7,15,27,1993,2042
E01027265,0,4,22,15,1440,1481
E01027266,1,3,15,14,1322,1355
E01027270,3,9,19,18,1607,1656
E01027271,2,6,22,8,1530,1568
E01027272,0,2,12,10,1557,1581
E01027264,2,6,15,13,1430,1466
E01027267,2,3,10,15,1153,1183
E01027268,1,2,11,8,1243,1265
E01027269,2,3,13,17,1428,1463
E01027288,2,11,28,12,2063,2116
E01027290,7,29,54,42,2082,2214
E01027296,1,6,22,12,1957,1998
E01027326,2,5,24,6,1448,1485
E01027327,6,17,38,11,1408,1480
E01027328,4,1,20,6,1313,1344
E01027338,10,3,25,16,2209,2263
E01027330,8,140,75,187,1257,1667
E01027331,1,122,110,57,1102,1392
E01027332,5,44,23,240,1184,1496
E01027333,11,108,49,307,1867,2342
E01027334,7,185,106,61,1016,1375
E01027343,3,68,29,92,1288,1480
E01027344,8,30,14,110,1217,1379
E01027345,2,64,27,118,1160,1371
E01027346,2,39,47,111,1278,1477
E01027347,2,90,37,115,1696,1940
E01027313,4,82,33,718,797,1634
E01027314,12,106,55,448,1310,1931
E01027315,27,109,84,154,1881,2255
E01027316,7,74,55,285,1080,1501
E01027339,3,80,62,14,1188,1347
E01027340,8,87,67,61,1261,1484
E01027341,16,119,51,27,1317,1530
E01027342,10,76,51,43,1277,1457
E01027349,18,71,76,134,1284,1583
E01027350,1,64,47,87,1254,1453
E01027351,1,56,69,75,1360,1561
E01027352,4,71,60,173,1142,1450
E01027309,5,58,23,104,1307,1497
E01027310,3,161,144,52,1145,1505
E01027311,0,66,50,97,1110,1323
E01027312,7,59,56,95,1201,1418
E01027317,1,59,43,39,1367,1509
E01027318,1,68,80,7,1331,1487
E01027319,6,36,41,50,1397,1530
E01027320,7,151,99,95,1785,2137
E01027321,4,66,31,102,1373,1576
E01027322,4,9,19,15,1114,1161
E01027323,0,3,22,9,1448,1482
E01027324,0,5,14,3,1164,1186
E01027325,2,4,15,7,1530,1558
E01027329,5,2,25,16,1699,1747
E01027353,6,4,23,16,1682,1731
E01027335,1,4,8,15,1446,1474
E01027336,4,4,35,39,1399,1481
E01027337,1,9,21,10,1749,1790
E01027348,4,7,34,11,1996,2052
E01027354,7,6,27,9,2329,2378
E01027355,1,4,14,16,1622,1657
E01027979,0,0,5,4,1507,1516
E01027980,0,3,16,2,1534,1555
E01027981,15,1,12,25,1507,1560
E01027983,2,4,10,24,1475,1515
E01027970,1,8,10,24,1363,1406
E01027971,2,0,5,2,1378,1387
E01027982,4,1,2,8,1426,1441
E01027984,4,8,16,15,1451,1494
E01027966,1,6,9,3,1387,1406
E01027986,5,1,9,2,1321,1338
E01027987,1,6,19,12,1775,1813
E01027990,0,5,11,9,1806,1831
E01027967,6,6,15,31,1610,1668
E01027972,7,8,11,28,2185,2239
E01027977,0,13,16,14,1887,1930
E01027978,4,10,24,50,1750,1838
E01027985,0,5,16,36,1799,1856
E01027964,3,10,12,18,1504,1547
E01027965,4,6,13,13,1409,1445
E01027968,0,13,22,8,1205,1248
E01027974,2,2,11,16,1639,1670
E01027976,5,6,5,4,1588,1608
E01027969,1,0,10,3,1391,1405
E01027975,0,6,15,17,1625,1663
E01027988,1,3,8,19,1557,1588
E01027989,1,1,7,10,1579,1598
E01027991,0,1,11,9,1232,1253
E01027992,2,8,24,41,2145,2220
E01027949,2,2,4,11,1540,1559
E01027951,1,2,17,27,1548,1595
E01027953,0,4,17,12,1463,1496
E01027954,0,6,8,2,1631,1647
E01027973,0,15,16,36,1648,1715
E01027952,2,10,19,29,1815,1875
E01027955,0,7,9,6,1243,1265
E01027956,0,9,11,3,1477,1500
E01027958,5,3,18,4,1402,1432
E01027947,3,8,11,13,1648,1683
E01027948,3,7,18,27,1812,1867
E01027950,1,4,34,17,1943,1999
E01027957,0,7,13,11,1232,1263
E01027959,4,5,14,24,1444,1491
E01027995,2,6,20,17,1529,1574
E01027996,0,3,16,14,2004,2037
E01027997,1,6,9,5,1643,1664
E01027998,1,9,18,13,1793,1834
E01027960,1,3,6,8,1631,1649
E01027961,1,5,13,4,1826,1849
E01027962,1,1,12,2,1482,1498
E01027963,1,5,4,1,1746,1757
E01027945,3,5,5,12,1682,1707
E01027946,1,0,5,10,1435,1451
E01027993,0,1,15,8,1502,1526
E01027994,2,2,9,0,1414,1427
E01027929,0,24,37,39,2316,2416
E01027931,10,34,30,43,1898,2015
E01027934,1,14,7,13,1344,1379
E01027935,4,3,9,6,1253,1275
E01027936,0,0,5,10,1470,1485
E01027927,1,15,24,38,1977,2055
E01027928,4,20,15,20,1819,1878
E01027932,0,17,38,37,2072,2164
E01027933,2,12,22,26,1417,1479
E01027937,0,1,12,6,1329,1348
E01027925,1,2,14,9,1836,1862
E01027938,1,2,8,0,1314,1325
E01027940,1,2,11,6,1309,1329
E01027943,0,4,19,3,1354,1380
E01027944,0,2,11,5,1513,1531
E01027926,0,4,13,14,1419,1450
E01027930,2,17,33,32,1477,1561
E01027939,1,8,29,11,1467,1516
E01027941,0,9,23,4,1262,1298
E01027942,0,6,14,14,1319,1353
E01028000,1,2,16,11,2202,2232
E01028024,6,7,25,22,1779,1839
E01028025,5,1,13,17,1474,1510
E01028026,0,0,20,12,1498,1530
E01028027,1,1,5,29,1444,1480
E01028028,2,2,4,12,1569,1589
E01027999,0,14,6,2,2263,2285
E01028005,2,2,16,8,1864,1892
E01028031,0,1,1,0,1091,1093
E01028032,0,1,5,5,1363,1374
E01028035,2,6,14,5,2262,2289
E01028023,3,3,11,7,2259,2283
E01028034,0,26,20,12,2359,2417
E01028036,17,100,92,126,2774,3109
E01028001,3,0,9,0,1280,1292
E01028002,6,1,10,5,1400,1422
E01028003,0,3,3,2,1372,1380
E01028004,2,2,6,10,1509,1529
E01028029,0,0,2,12,1162,1176
E01028030,0,0,3,2,1291,1296
E01028013,0,11,15,6,1791,1823
E01028014,3,2,12,9,1486,1512
E01028015,1,8,14,29,1439,1491
E01028016,1,1,7,2,1325,1336
E01028046,2,8,9,16,1522,1557
E01028047,19,8,16,37,2129,2209
E01028048,0,6,13,29,1615,1663
E01028049,6,5,14,32,1657,1714
E01028050,2,11,13,24,1857,1907
E01028008,1,3,26,26,1340,1396
E01028009,2,1,9,19,1368,1399
E01028010,3,2,11,19,1336,1371
E01028011,0,5,4,49,1534,1592
E01028012,1,6,10,15,1325,1357
E01028022,3,1,22,12,1469,1507
E01028055,2,12,13,12,1475,1514
E01028056,1,2,5,15,1228,1251
E01028058,3,5,21,12,1775,1816
E01028059,5,9,22,7,1779,1822
E01028017,0,2,9,11,1278,1300
E01028018,1,1,8,17,1443,1470
E01028019,0,0,13,1,1431,1445
E01028020,1,3,26,20,1793,1843
E01028021,3,3,10,8,1484,1508
E01028057,3,12,12,20,1203,1250
E01028065,3,14,36,14,1665,1732
E01028066,8,7,23,19,1645,1702
E01028068,8,29,32,54,1684,1807
E01028060,10,14,15,38,1620,1697
E01028061,0,3,7,13,1464,1487
E01028062,11,8,21,22,1875,1937
E01028067,0,5,12,12,1484,1513
E01028040,0,2,4,2,1012,1020
E01028041,2,2,2,3,1063,1072
E01028043,3,2,10,13,1422,1450
E01028063,0,6,13,12,1748,1779
E01028064,3,10,15,42,1408,1478
E01028006,3,10,14,112,1232,1371
E01028007,2,2,5,9,1096,1114
E01028033,6,42,23,14,2211,2296
E01028037,8,2,20,2,1629,1661
E01028038,1,5,6,0,1438,1450
E01028039,0,0,8,0,1155,1163
E01028042,3,4,14,17,1398,1436
E01028044,7,5,15,10,1489,1526
E01028045,1,10,25,21,1856,1913
E01028051,0,12,19,10,1483,1524
E01028052,6,9,21,31,1597,1664
E01028053,0,12,11,7,1484,1514
E01028054,2,6,10,32,1437,1487
E01028092,17,0,8,7,1289,1321
E01028093,0,0,10,2,994,1006
E01028107,0,2,7,0,1556,1565
E01028108,1,2,15,14,1453,1485
E01028114,0,3,4,5,1503,1515
E01028110,1,0,22,20,1418,1461
E01028111,1,0,15,3,1409,1428
E01028112,0,4,11,6,1526,1547
E01028113,1,2,23,15,1450,1491
E01028109,1,1,19,10,1666,1697
E01028115,5,5,5,10,1476,1501
E01028116,1,6,11,19,1522,1559
E01028117,1,0,7,29,1497,1534
E01028118,0,3,4,5,1627,1639
E01028102,0,6,21,15,1328,1370
E01028103,0,6,17,5,1119,1147
E01028104,0,3,8,9,1426,1446
E01028122,0,5,23,17,1539,1584
E01028123,2,12,32,15,1840,1901
E01028124,3,13,27,31,1454,1528
E01028087,21,18,21,132,1406,1598
E01028088,27,15,24,179,1227,1472
E01028089,9,7,18,163,1144,1341
E01028090,9,22,23,44,1284,1382
E01028091,7,4,31,196,1239,1477
E01028125,6,10,11,25,1580,1632
E01028126,1,10,21,11,1401,1444
E01028127,4,13,24,14,1641,1696
E01028134,1,6,29,8,1422,1466
E01028076,14,34,36,160,995,1239
E01028077,34,17,48,219,1138,1456
E01028078,20,26,47,157,1343,1593
E01028079,20,15,42,245,1043,1365
E01028084,18,15,27,72,1665,1797
E01028128,9,5,13,42,1673,1742
E01028129,4,25,33,42,1395,1499
E01028130,7,14,52,13,1671,1757
E01028131,0,11,25,28,1427,1491
E01028132,3,21,16,26,991,1057
E01028133,3,11,31,39,1373,1457
E01028073,16,28,22,86,1376,1528
E01028074,46,48,38,223,1255,1610
E01028075,33,30,48,126,1424,1661
E01028085,91,36,54,137,1707,2025
E01028086,26,24,23,87,1355,1515
E01028080,12,13,50,71,1640,1786
E01028081,6,8,15,27,1112,1168
E01028082,11,11,14,33,1188,1257
E01028083,8,29,38,88,1142,1305
E01028097,6,7,31,52,1350,1446
E01028098,18,45,42,53,1601,1759
E01028099,5,26,23,30,1424,1508
E01028100,6,5,41,56,1575,1683
E01028101,0,21,28,41,1337,1427
E01028069,1,9,32,18,1123,1183
E01028070,0,1,15,11,1118,1145
E01028094,19,28,36,99,1590,1772
E01028095,7,12,14,15,1404,1452
E01028096,19,13,23,47,1715,1817
E01028135,6,2,18,41,1336,1403
E01028136,9,10,23,55,1617,1714
E01028137,22,32,47,161,2211,2473
E01028138,4,2,20,22,1157,1205
E01028139,12,12,30,47,1342,1443
E01028105,4,7,20,11,1196,1238
E01028106,3,0,10,10,1435,1458
E01028119,26,42,67,412,1628,2175
E01028120,1,19,30,115,1424,1589
E01028121,13,23,65,225,1148,1474
E01033412,4,14,26,33,2301,2378
E01033413,1,4,23,19,2157,2204
E01028189,2,16,36,78,2168,2300
E01028198,2,9,18,46,1322,1397
E01028199,2,4,13,19,1419,1457
E01028200,4,16,33,89,1474,1616
E01028201,0,3,6,33,1117,1159
E01028150,0,2,6,6,1341,1355
E01028151,0,5,11,1,1149,1166
E01028152,0,0,8,24,1506,1538
E01028153,0,2,28,9,1256,1295
E01028154,1,1,17,13,1690,1722
E01028213,2,5,38,16,1811,1872
E01028143,10,9,28,27,1219,1293
E01028205,5,13,15,15,1218,1266
E01028206,3,21,26,23,1389,1462
E01028207,0,20,19,49,1232,1320
E01028208,0,12,23,31,1044,1110
E01028173,0,23,27,8,975,1033
E01028174,4,21,48,14,1475,1562
E01028175,6,21,55,44,1672,1798
E01028209,0,25,29,31,1359,1444
E01028144,7,9,42,44,1477,1579
E01028165,1,32,39,25,1376,1473
E01028166,2,42,33,59,1569,1705
E01028167,9,25,51,66,1685,1836
E01028179,2,22,36,103,1288,1451
E01028180,3,37,27,43,1364,1474
E01028181,10,17,28,51,1256,1362
E01028182,6,42,40,164,1341,1593
E01028183,5,15,24,25,1183,1252
E01028148,1,7,21,8,1953,1990
E01028149,2,8,27,18,1568,1623
E01028178,3,12,25,99,2025,2164
E01028176,5,24,30,71,1412,1542
E01028177,0,8,25,32,1487,1552
E01028214,5,18,33,62,1346,1464
E01028215,8,19,26,82,1212,1347
E01028216,0,13,17,44,1216,1290
E01028217,16,18,47,57,1199,1337
E01028218,1,24,12,60,1405,1502
E01028193,10,28,43,59,1214,1354
E01028194,0,36,70,34,1348,1488
E01028195,4,39,36,34,1283,1396
E01028196,2,21,29,32,1344,1428
E01028197,1,31,28,24,1295,1379
E01028204,1,17,30,31,1260,1339
E01028172,7,8,25,10,1092,1142
E01028190,14,29,35,44,1472,1594
E01028202,9,30,33,14,1370,1456
E01028203,4,11,32,12,1332,1391
E01028212,1,30,63,39,1493,1626
E01028168,2,14,32,38,1235,1321
E01028169,8,9,15,6,1418,1456
E01028170,0,4,32,25,1377,1438
E01028171,10,11,20,26,1393,1460
E01028191,1,34,51,17,1721,1824
E01028192,0,15,44,11,1486,1556
E01028160,8,24,39,64,1384,1519
E01028161,4,87,59,128,1218,1496
E01028162,0,29,53,34,1380,1496
E01028163,0,30,29,72,1351,1482
E01028211,5,46,53,35,1233,1372
E01028155,0,20,34,72,1288,1414
E01028156,5,22,27,92,1162,1308
E01028157,2,20,39,190,1048,1299
E01028158,2,28,61,26,1442,1559
E01028159,7,28,46,102,1118,1301
E01028164,5,25,33,27,1195,1285
E01028210,4,14,44,12,1308,1382
E01028184,3,20,31,80,1032,1166
E01028185,6,22,41,22,1761,1852
E01028186,2,13,49,21,1430,1515
E01028187,3,14,61,24,1318,1420
E01028188,7,25,40,25,1348,1445
E01028142,4,24,39,25,1877,1969
E01028146,0,63,48,37,1355,1503
E01028147,4,93,81,18,861,1057
E01032622,0,19,27,92,1216,1354
E01028224,2,2,4,7,1451,1466
E01028257,0,1,15,5,1604,1625
E01028258,2,6,5,2,1636,1651
E01028259,1,2,15,5,1472,1495
E01028223,0,0,5,5,1025,1035
E01028225,4,3,8,2,1564,1581
E01028226,1,7,13,4,1459,1484
E01028260,3,5,8,4,1642,1662
E01028251,0,9,13,17,1606,1645
E01028252,1,1,32,24,1886,1944
E01028253,0,2,23,8,1651,1684
E01028277,2,3,5,2,1195,1207
E01028278,0,8,16,14,1373,1411
E01028271,1,1,17,6,1644,1669
E01028279,1,3,8,5,1365,1382
E01028280,0,2,13,0,1325,1340
E01028281,1,12,22,7,1432,1474
E01028283,2,8,25,20,1798,1853
E01028242,1,2,17,4,1480,1504
E01028250,1,1,13,9,1447,1471
E01028272,0,3,13,15,1635,1666
E01028273,0,3,14,11,1455,1483
E01028229,2,6,14,16,1404,1442
E01028232,1,3,14,12,1483,1513
E01028267,1,7,16,19,1904,1947
E01028282,0,1,8,6,1125,1140
E01033392,1,11,32,23,2173,2240
E01028237,1,0,7,6,1547,1561
E01028238,1,2,22,18,1541,1584
E01028239,0,5,14,15,1564,1598
E01028240,2,1,14,21,1441,1479
E01028241,5,7,11,20,2240,2283
E01028243,3,8,19,20,1793,1843
E01028227,1,4,21,29,1310,1365
E01028228,2,8,5,20,1154,1189
E01028247,8,27,31,69,1548,1683
E01028268,14,9,27,53,1655,1758
E01028269,3,9,13,21,1405,1451
E01028284,9,8,28,30,1589,1664
E01028233,6,18,20,39,1800,1883
E01028234,2,10,22,3,1689,1726
E01028274,4,13,19,15,1349,1400
E01028275,3,3,30,17,1551,1604
E01028276,1,16,28,10,1503,1558
E01028230,1,1,13,26,1391,1432
E01028231,0,6,13,29,1382,1430
E01028244,5,16,8,51,1406,1486
E01028245,6,2,5,13,1286,1312
E01028246,3,4,23,43,1611,1684
E01028248,2,5,27,34,1408,1476
E01028249,1,7,15,19,1312,1354
E01028235,4,4,10,7,1547,1572
E01028236,3,6,15,22,1678,1724
E01028262,1,2,14,7,1472,1496
E01028264,1,9,25,15,1861,1911
E01028254,0,2,11,27,1338,1378
E01028256,2,7,35,25,1537,1606
E01028261,2,20,20,30,1660,1732
E01028263,2,5,26,7,1567,1607
E01028219,3,5,7,42,1332,1389
E01028220,2,7,21,34,1727,1791
E01028222,3,6,16,25,1512,1562
E01028255,4,3,13,24,1272,1316
E01028270,0,4,18,42,1445,1509
E01033389,1,8,16,31,1273,1329
E01033390,11,8,27,70,1432,1548
E01033391,1,1,9,8,1160,1179
E01028301,2,2,14,21,1889,1928
E01028302,1,0,4,2,1576,1583
E01028338,1,1,7,3,1587,1599
E01028339,0,12,7,7,1769,1795
E01028340,3,1,5,2,1490,1501
E01028341,2,10,6,11,1588,1617
E01028313,1,5,11,10,1964,1991
E01028314,0,5,28,21,2620,2674
E01028321,2,1,9,1,1561,1574
E01028322,0,2,15,9,1938,1964
E01028323,0,7,16,2,1625,1650
E01028303,0,3,7,6,1511,1527
E01028312,2,2,13,13,2225,2255
E01028337,2,0,11,4,1512,1529
E01028349,4,3,9,1,1487,1504
E01028350,0,0,6,6,1159,1171
E01028315,0,1,8,3,1436,1448
E01028316,1,8,13,14,1448,1484
E01028317,0,1,13,6,1619,1639
E01028353,2,2,18,30,2719,2771
E01028295,1,3,14,7,1980,2005
E01028297,6,0,25,1,1902,1934
E01028327,3,3,21,17,1555,1599
E01028328,4,3,13,8,1672,1700
E01028329,1,6,11,16,1654,1688
E01028296,0,6,10,12,1302,1330
E01028298,1,3,12,9,1573,1598
E01028299,0,1,6,7,1267,1281
E01028300,1,4,7,3,1563,1578
E01028342,3,3,8,9,1485,1508
E01028343,2,2,20,7,2026,2057
E01028344,2,2,10,3,1403,1420
E01028294,2,12,14,26,1677,1731
E01028304,0,10,27,16,1413,1466
E01028305,1,8,23,28,1314,1374
E01028306,2,9,16,23,1564,1614
E01028307,0,4,22,11,1227,1264
E01028310,8,7,26,60,1582,1683
E01028311,1,18,20,34,1442,1515
E01028345,4,6,20,13,2110,2153
E01028346,5,3,19,8,2098,2133
E01028347,11,3,25,24,1471,1534
E01028348,3,13,5,11,1445,1477
E01028292,3,14,33,36,2238,2324
E01028293,6,13,28,20,1839,1906
E01028333,1,5,10,10,1318,1344
E01028334,3,5,19,32,1524,1583
E01028335,14,17,36,25,1623,1715
E01028308,0,6,17,10,1575,1608
E01028309,1,7,17,11,1366,1402
E01028318,4,9,35,26,1494,1568
E01028319,3,3,27,12,1874,1919
E01028320,9,2,12,13,1648,1684
E01028285,0,4,8,9,1205,1226
E01028286,0,3,4,6,1237,1250
E01028287,1,13,10,16,1410,1450
E01028288,0,5,19,13,1464,1501
E01028289,1,1,14,11,1299,1326
E01028290,4,4,9,19,1419,1455
E01028291,2,5,19,13,1510,1549
E01028325,1,3,9,7,1185,1205
E01028326,0,3,7,9,1255,1274
E01028336,0,2,9,8,1103,1122
E01028352,1,6,20,9,1178,1214
E01033393,4,10,35,53,2088,2190
E01033394,4,1,13,4,1256,1278
E01028330,1,3,17,16,1593,1630
E01028331,15,142,101,104,1889,2251
E01028332,2,3,32,14,1682,1733
E01028351,0,15,6,5,1238,1264
E01028371,5,31,37,43,2652,2768
E01028403,3,7,36,15,2129,2190
E01028411,1,1,20,10,2045,2077
E01028357,3,7,12,5,1461,1488
E01028358,1,4,21,23,1280,1329
E01028359,3,3,15,16,1659,1696
E01028360,4,7,33,30,1725,1799
E01028361,0,8,25,15,1356,1404
E01028362,3,2,30,13,1367,1415
E01028393,1,3,8,25,1100,1137
E01028394,5,3,25,14,1444,1491
E01028395,2,6,28,34,1370,1440
E01028413,7,6,26,30,1600,1669
E01028414,7,3,19,37,1516,1582
E01028415,3,10,23,13,1510,1559
E01028354,3,5,47,76,1424,1555
E01028355,2,16,33,85,1380,1516
E01028384,8,19,42,80,1579,1728
E01028385,5,7,56,89,1594,1751
E01028386,7,11,30,63,1531,1642
E01028396,2,12,30,62,1431,1537
E01028398,4,9,33,126,1268,1440
E01028399,13,10,38,100,1217,1378
E01028416,3,20,44,105,1393,1565
E01028417,10,15,35,138,1367,1565
E01028418,13,16,54,72,1351,1506
E01028356,8,5,41,143,1296,1493
E01028375,25,13,78,114,1568,1798
E01028376,13,12,23,121,1415,1584
E01028377,10,50,64,209,1622,1955
E01028397,11,11,36,95,1590,1743
E01028363,37,24,34,230,1164,1489
E01028364,23,21,30,330,1383,1787
E01028365,11,18,38,245,1346,1658
E01028391,7,17,23,222,1696,1965
E01028392,30,19,73,245,1580,1947
E01028372,6,9,37,156,980,1188
E01028373,16,9,18,134,1227,1404
E01028374,17,12,43,98,1146,1316
E01028400,10,11,33,127,1431,1612
E01028401,11,23,43,140,1091,1308
E01028366,0,3,15,10,1299,1327
E01028367,6,5,18,19,1426,1474
E01028368,1,1,11,7,1471,1491
E01028369,1,8,21,13,1424,1467
E01028370,1,12,20,8,1403,1444
E01028402,2,2,11,11,1862,1888
E01028419,0,9,21,21,2387,2438
E01028420,0,2,10,7,1360,1379
E01028404,5,6,23,22,1542,1598
E01028405,6,6,51,45,1835,1943
E01028406,8,5,33,74,1530,1650
E01028407,6,4,23,62,1930,2025
E01028379,7,0,14,20,1596,1637
E01028412,0,1,19,35,1828,1883
E01028421,5,3,26,36,2151,2221
E01028380,3,4,16,9,1206,1238
E01028381,4,4,11,8,1315,1342
E01028382,0,6,14,12,1403,1435
E01028383,0,4,11,7,1059,1081
E01028378,3,5,40,10,1936,1994
E01028387,6,8,33,18,1681,1746
E01028408,13,18,37,130,2441,2639
E01028388,0,6,9,19,1643,1677
E01028389,0,2,10,15,1420,1447
E01028390,1,3,12,21,1573,1610
E01028409,3,4,12,23,1259,1301
E01028410,1,1,14,24,1240,1280
E01013998,4,1,8,1,1315,1329
E01014051,0,3,11,6,1695,1715
E01014052,0,1,4,12,1479,1496
E01014096,0,1,8,0,1494,1503
E01014041,3,0,13,6,1493,1515
E01014042,0,1,4,5,1652,1662
E01014043,0,0,4,3,1118,1125
E01014044,3,1,10,2,1457,1473
E01014045,2,3,11,8,1547,1571
E01014046,3,0,2,2,1443,1450
E01014047,0,1,12,10,1416,1439
E01014048,3,2,14,34,1403,1456
E01013999,0,3,7,34,1444,1488
E01014017,2,0,7,7,1459,1475
E01014024,1,1,5,1,1278,1286
E01014025,6,5,7,7,1385,1410
E01014055,2,0,3,4,1574,1583
E01014097,1,4,3,2,1305,1315
E01014000,0,1,6,6,1383,1396
E01014001,1,2,4,6,1421,1434
E01014002,1,0,7,1,1388,1397
E01014003,1,11,10,10,1480,1512
E01014004,0,0,7,4,1408,1419
E01014005,1,1,17,6,1527,1552
E01014015,0,3,11,5,1620,1639
E01014008,0,2,9,4,1581,1596
E01014009,0,0,6,3,1489,1498
E01014033,0,2,12,14,1701,1729
E01014034,3,9,16,38,1445,1511
E01014056,0,0,6,19,1516,1541
E01014006,2,3,11,7,1556,1579
E01014012,0,3,4,7,1662,1676
E01014013,4,4,18,2,1908,1936
E01014016,1,1,16,10,1482,1510
E01014100,0,0,5,3,1539,1547
E01014101,1,5,5,7,1057,1075
E01014022,5,4,6,8,2028,2051
E01014023,0,4,5,16,1735,1760
E01014081,0,6,11,5,1419,1441
E01014082,1,2,5,12,1872,1892
E01014027,0,0,12,7,1234,1253
E01014028,0,4,4,8,1429,1445
E01014029,1,1,8,11,1493,1514
E01014030,1,2,23,27,1335,1388
E01014083,0,1,4,8,1593,1606
E01014084,6,3,9,21,1503,1542
E01014085,1,2,10,6,1401,1420
E01014087,5,3,7,13,1443,1471
E01014088,0,0,5,12,1397,1414
E01014089,1,3,12,7,1453,1476
E01013987,10,6,16,34,1561,1627
E01013988,20,10,12,47,1775,1864
E01014007,2,2,8,8,1710,1730
E01014095,5,6,18,29,1436,1494
E01013986,3,3,17,60,1619,1702
E01013989,2,15,12,98,1439,1566
E01014010,25,4,15,56,1526,1626
E01014011,6,13,18,38,1438,1513
E01014086,8,7,25,29,1379,1448
E01014092,5,7,38,34,1724,1808
E01014075,12,5,14,5,1667,1703
E01014076,13,10,20,28,2110,2181
E01014077,1,4,6,3,1541,1555
E01014078,2,1,13,13,1432,1461
E01014090,2,6,16,19,1456,1499
E01014091,2,7,11,26,1452,1498
E01014093,1,1,15,15,1409,1441
E01014094,1,0,15,25,1484,1525
E01014068,0,1,8,12,1451,1472
E01014070,6,0,9,11,2221,2247
E01014072,3,8,20,12,2018,2061
E01014073,14,9,20,39,1856,1938
E01014074,4,0,11,7,1572,1594
E01013996,1,1,11,10,1522,1545
E01013997,2,2,27,8,1944,1983
E01014079,0,1,15,12,1586,1614
E01014080,2,2,8,9,1361,1382
E01013992,7,0,6,1,1420,1434
E01013993,0,0,17,5,1576,1598
E01013994,3,3,14,8,1540,1568
E01013995,0,7,19,4,1679,1709
E01014071,0,1,18,5,1424,1448
E01013990,4,3,15,2,1726,1750
E01013991,0,2,7,3,1320,1332
E01014014,0,2,11,1,1797,1811
E01014054,1,1,9,2,1341,1354
E01014035,7,6,15,42,1671,1741
E01014036,1,3,13,18,1538,1573
E01014037,0,2,3,7,1455,1467
E01014038,3,17,7,16,1422,1465
E01014039,0,4,16,16,1755,1791
E01014040,1,1,4,9,1584,1599
E01014018,1,2,19,5,1470,1497
E01014019,0,0,11,2,1547,1560
E01014020,0,3,10,2,1553,1568
E01014021,0,0,5,1,1442,1448
E01014026,2,3,16,8,2087,2116
E01014059,3,1,13,8,1983,2008
E01014060,0,1,13,7,1576,1597
E01014069,2,2,5,7,1843,1859
E01014098,0,1,6,4,1558,1569
E01014099,1,6,14,9,1773,1803
E01014061,0,2,6,6,1534,1548
E01014062,1,7,11,11,1592,1622
E01014063,0,0,7,2,1768,1777
E01014064,1,5,25,11,1558,1600
E01014065,3,0,5,7,1449,1464
E01014066,0,1,6,14,1102,1123
E01014067,0,1,7,2,1438,1448
E01014031,0,1,12,7,1547,1567
E01014032,3,0,8,9,1618,1638
E01014049,1,1,10,8,1578,1598
E01014050,0,1,9,4,1745,1759
E01014053,0,0,10,10,1770,1790
E01014057,3,0,14,7,1677,1701
E01014058,2,1,12,5,1569,1589
E01028853,0,1,15,6,1481,1503
E01028854,1,3,11,18,1486,1519
E01028855,0,2,11,10,1488,1511
E01028856,0,2,14,11,1214,1241
E01028857,0,3,6,10,1705,1724
E01028826,0,1,20,13,1621,1655
E01028827,0,2,13,14,1508,1537
E01028844,65,8,15,33,1872,1993
E01028845,2,6,9,14,1908,1939
E01028838,1,0,6,3,1430,1440
E01028839,0,1,5,12,1305,1323
E01028840,0,0,3,1,1300,1304
E01028841,0,0,9,4,1529,1542
E01028850,2,1,10,7,2213,2233
E01028851,1,1,15,1,1636,1654
E01028852,0,0,10,3,1641,1654
E01028830,0,5,8,16,1428,1457
E01028831,0,4,8,1,1518,1531
E01028836,1,1,14,6,1463,1485
E01028837,0,0,3,5,1460,1468
E01028832,2,3,13,24,1601,1643
E01028833,1,0,8,11,1453,1473
E01028834,0,0,13,20,1528,1561
E01028835,3,1,12,4,1441,1461
E01028828,0,1,4,4,1677,1686
E01028829,0,1,2,1,1307,1311
E01028842,7,8,11,5,1589,1620
E01028847,0,1,15,8,1445,1469
E01028859,1,7,8,10,1631,1657
E01028843,1,1,5,5,1720,1732
E01028846,0,1,4,11,1735,1751
E01028848,5,0,2,2,1635,1644
E01028849,0,2,13,23,1923,1961
E01028858,0,7,13,31,2072,2123
E01028891,0,4,11,28,1658,1701
E01028892,0,1,3,8,1385,1397
E01028894,4,1,12,3,1514,1534
E01028895,0,0,2,8,1697,1707
E01028896,4,2,10,6,2050,2072
E01028897,0,2,7,8,1443,1460
E01028880,6,10,10,12,1595,1633
E01028881,1,0,13,13,1235,1262
E01028882,1,1,12,14,1526,1554
E01028893,2,1,10,6,1514,1533
E01028899,3,1,9,4,1504,1521
E01028864,3,0,8,10,1456,1477
E01028865,1,1,10,2,1712,1726
E01028866,4,1,14,26,1288,1333
E01028867,1,0,6,5,1285,1297
E01028872,6,3,9,39,1573,1630
E01028873,1,4,23,11,1754,1793
E01028874,1,0,3,9,1313,1326
E01028875,0,4,17,25,2455,2501
E01028876,3,2,13,20,1695,1733
E01028877,0,0,3,6,1289,1298
E01028878,0,0,3,11,1551,1565
E01028879,0,0,6,18,1533,1557
E01028886,1,7,18,11,1651,1688
E01028887,1,9,3,11,1356,1380
E01028889,1,27,11,13,1349,1401
E01028890,1,4,13,11,1372,1401
E01028868,1,1,7,2,1552,1563
E01028869,1,8,7,3,1426,1445
E01028871,0,8,3,2,1197,1210
E01028885,11,55,64,66,2694,2890
E01028860,0,3,14,3,1867,1887
E01028862,4,0,6,2,1575,1587
E01028863,0,2,13,1,1387,1403
E01028888,0,4,12,6,1619,1641
E01028898,4,1,4,6,1409,1424
E01028861,1,0,4,4,1229,1238
E01028870,2,0,11,8,1540,1561
E01028883,1,3,7,9,1632,1652
E01028884,0,1,15,21,1485,1522
E01028910,2,1,9,18,1512,1542
E01028911,0,0,4,7,1284,1295
E01028912,0,3,10,21,1145,1179
E01028920,0,2,9,4,1264,1279
E01028921,5,1,4,16,1551,1577
E01028925,3,0,5,41,1416,1465
E01028926,0,2,14,8,1361,1385
E01028902,0,3,4,3,1087,1097
E01028903,2,0,5,11,1253,1271
E01028904,0,2,11,20,1453,1486
E01028905,5,5,8,27,1704,1749
E01028909,2,3,10,12,1400,1427
E01033528,1,1,13,27,2503,2545
E01028906,3,3,9,11,1217,1243
E01028907,5,4,14,13,1697,1733
E01028908,1,20,19,21,1438,1499
E01028916,0,0,8,4,1532,1544
E01028917,3,12,28,50,1418,1511
E01028924,2,0,12,15,1609,1638
E01028913,0,1,9,5,1531,1546
E01028918,1,0,22,7,1445,1475
E01028919,0,0,4,8,1367,1379
E01028927,0,4,4,17,1031,1056
E01028928,0,0,0,9,1527,1536
E01028914,1,0,8,5,1065,1079
E01028915,0,0,3,4,1356,1363
E01028922,4,0,4,12,1267,1287
E01028923,2,1,9,1,1566,1579
E01028929,7,5,12,11,1429,1464
E01028969,0,9,8,33,1432,1482
E01028970,1,1,6,10,1318,1336
E01028971,1,2,18,8,2089,2118
E01028978,1,1,20,5,1512,1539
E01028979,3,0,13,7,1212,1235
E01028933,1,2,21,9,1578,1611
E01028934,0,4,11,11,1589,1615
E01028956,2,1,8,13,1514,1538
E01028957,6,8,12,15,1596,1637
E01028958,3,2,6,12,1816,1839
E01028932,6,1,11,21,1859,1898
E01028981,2,3,14,6,1596,1621
E01028982,1,1,13,2,1595,1612
E01028983,1,2,21,7,1980,2011
E01028930,0,5,12,12,1641,1670
E01028931,2,4,29,20,1948,2003
E01028944,4,5,19,44,1591,1663
E01028945,6,10,24,47,1958,2045
E01028965,2,1,8,11,1415,1437
E01028966,2,1,12,14,1235,1264
E01028967,2,1,14,11,1545,1573
E01028968,0,3,12,7,1341,1363
E01028988,0,1,17,19,1627,1664
E01028989,0,2,22,9,1688,1721
E01028946,6,8,39,71,2185,2309
E01028972,4,2,5,32,1668,1711
E01028973,4,5,24,23,1889,1945
E01028987,4,1,25,50,1991,2071
E01028941,14,17,22,124,1712,1889
E01028942,10,14,25,60,1371,1480
E01028943,14,14,27,80,1987,2122
E01028951,1,2,13,21,1491,1528
E01028953,3,6,6,25,1461,1501
E01028947,0,3,9,23,1409,1444
E01028948,2,1,22,16,1422,1463
E01028949,2,0,8,16,1463,1489
E01028985,0,0,4,12,1298,1314
E01028938,3,2,22,12,1623,1662
E01028939,0,1,20,14,1505,1540
E01028984,4,1,16,10,1359,1390
E01028986,0,0,7,16,1492,1515
E01028940,0,3,16,22,1569,1610
E01028952,3,1,11,46,1656,1717
E01028962,9,4,14,18,1620,1665
E01028963,0,0,2,4,1667,1673
E01028964,2,2,17,37,1615,1673
E01028974,5,11,46,114,1579,1755
E01028935,0,0,3,9,1477,1489
E01028936,1,5,13,8,2059,2086
E01028937,0,2,6,6,1490,1504
E01028959,2,7,13,10,2501,2533
E01028954,6,0,6,3,1251,1266
E01028955,4,0,9,10,1067,1090
E01028975,1,5,1,29,1741,1777
E01028976,2,3,7,12,1745,1769
E01028977,0,0,5,9,1923,1937
E01028950,6,2,19,14,2277,2318
E01028960,0,0,11,9,1302,1322
E01028961,3,11,17,270,1390,1691
E01028980,0,1,18,5,2151,2175
E01028991,0,0,11,11,1216,1238
E01028992,2,1,9,15,1558,1585
E01033529,0,1,5,1,1035,1042
E01033530,4,2,4,1,1996,2007
E01028990,0,1,1,4,1201,1207
E01028997,2,1,9,10,2261,2283
E01028998,11,5,22,14,2336,2388
E01028993,0,1,11,7,1521,1540
E01029004,5,0,2,5,1033,1045
E01029013,1,3,10,41,1620,1675
E01029014,1,6,9,9,1192,1217
E01029015,1,0,10,7,1381,1399
E01028994,1,4,12,17,1271,1305
E01029003,4,2,6,3,2302,2317
E01029005,1,0,8,7,1231,1247
E01029016,0,4,11,10,1348,1373
E01029006,5,1,13,6,1594,1619
E01029007,1,5,3,10,1120,1139
E01029009,0,0,6,5,1133,1144
E01029010,0,9,16,13,1352,1390
E01029011,0,1,8,6,1458,1473
E01029012,4,1,12,7,1894,1918
E01033526,0,1,15,10,985,1011
E01033527,0,1,9,6,1229,1245
E01028995,1,6,7,8,1538,1560
E01028996,1,1,11,3,1302,1318
E01028999,0,0,2,6,1552,1560
E01029000,0,0,3,6,1132,1141
E01029001,0,0,10,12,1946,1968
E01029002,0,1,9,10,1300,1320
E01014257,0,5,8,18,1441,1472
E01014258,0,10,21,21,1465,1517
E01014259,1,6,22,14,1419,1462
E01014260,3,9,8,25,1293,1338
E01014264,1,9,27,25,1863,1925
E01014357,4,8,17,17,1526,1572
E01014358,10,12,35,35,1325,1417
E01014359,6,33,30,63,1697,1829
E01014360,6,15,34,70,1886,2011
E01014261,4,43,27,24,1306,1404
E01014262,0,21,9,15,1314,1359
E01014263,2,35,30,25,1607,1699
E01014333,0,6,17,8,1429,1460
E01014334,9,6,12,18,1383,1428
E01014331,3,22,17,24,1472,1538
E01014332,1,3,8,12,1649,1673
E01014335,3,6,31,13,1668,1721
E01014336,4,11,20,44,1532,1611
E01014337,1,6,20,8,1680,1715
E01014354,12,26,48,344,1342,1772
E01014355,10,21,51,637,1202,1921
E01014356,7,23,53,369,1313,1765
E01014361,23,43,43,385,1094,1588
E01014241,10,19,32,31,1509,1601
E01014242,6,17,26,42,1374,1465
E01014243,3,9,24,53,1326,1415
E01014244,5,43,56,101,1368,1573
E01014245,8,9,34,119,1579,1749
E01014248,18,45,40,91,1280,1474
E01014214,2,0,16,5,1432,1455
E01014215,1,1,18,5,1495,1520
E01014216,0,0,5,7,1394,1406
E01014265,1,2,15,12,1508,1538
E01014267,4,31,36,63,2249,2383
E01014272,1,2,19,9,1417,1448
E01014246,33,26,33,42,1470,1604
E01014266,7,7,34,31,1135,1214
E01014268,14,23,28,37,1991,2093
E01014270,31,16,21,31,1442,1541
E01014271,17,17,31,57,1403,1525
E01014247,17,29,24,135,1532,1737
E01014250,12,32,22,134,937,1137
E01014251,28,63,74,214,1471,1850
E01014252,9,27,32,73,1541,1682
E01014255,61,53,119,751,1046,2030
E01014269,8,46,49,140,1386,1629
E01014324,7,12,9,38,1387,1453
E01014325,2,2,28,18,1285,1335
E01014326,2,5,20,42,1414,1483
E01014249,69,112,67,613,875,1736
E01014253,20,13,48,114,1356,1551
E01014254,67,119,92,532,762,1572
E01014256,25,79,70,244,1203,1621
E01014210,6,8,21,26,1429,1490
E01014211,3,27,32,10,1412,1484
E01014212,1,12,22,4,1272,1311
E01014213,2,13,12,11,1200,1238
E01014217,3,9,21,15,1387,1435
E01014323,3,16,31,30,1194,1274
E01014327,11,20,25,35,1361,1452
E01014328,23,34,42,165,1177,1441
E01014329,9,22,38,59,1404,1532
E01014330,89,84,63,309,1050,1595
E01014218,7,11,29,20,1444,1511
E01014219,3,3,14,20,1232,1272
E01014225,2,5,22,16,1431,1476
E01014226,1,10,11,15,1419,1456
E01014228,0,2,6,5,1298,1311
E01014230,4,12,25,8,1445,1494
E01014281,77,134,97,612,832,1752
E01014285,43,79,80,708,1299,2209
E01014286,57,75,57,669,599,1457
E01014287,24,59,76,539,1010,1708
E01014231,38,63,36,181,1170,1488
E01014282,29,111,37,382,1126,1685
E01014283,27,104,69,807,1034,2041
E01014284,22,88,43,504,813,1470
E01033216,21,53,54,173,2094,2395
E01014220,2,15,23,18,1579,1637
E01014221,2,23,35,35,1493,1588
E01014222,2,21,32,14,1458,1527
E01014223,5,32,23,19,1534,1613
E01014224,5,22,26,10,1541,1604
E01014229,3,35,37,11,1692,1778
E01014288,13,19,26,164,1374,1596
E01014289,19,15,28,235,1270,1567
E01014290,26,25,39,296,1139,1525
E01014291,5,27,31,133,1197,1393
E01014292,28,35,33,146,1380,1622
E01014294,14,14,21,163,1115,1327
E01014293,33,47,41,230,1327,1678
E01014295,11,18,20,55,1602,1706
E01014339,30,45,27,103,1454,1659
E01014340,10,45,45,182,1610,1892
E01014345,24,59,40,184,1411,1718
E01014274,13,38,43,44,1699,1837
E01014275,1,29,28,61,1304,1423
E01014276,5,39,34,32,1463,1573
E01014277,5,16,17,21,1499,1558
E01014279,7,15,28,82,1600,1732
E01014273,3,8,16,133,1120,1280
E01014278,5,3,16,57,1273,1354
E01014280,3,2,8,11,1289,1313
E01014297,1,6,18,38,1242,1305
E01014296,4,2,24,24,1369,1423
E01014298,3,12,32,41,1505,1593
E01014300,2,13,16,25,1371,1427
E01014302,5,17,19,83,1698,1822
E01014338,13,18,21,134,1301,1487
E01014341,10,43,15,177,1515,1760
E01014342,4,10,23,98,1381,1516
E01014343,10,33,35,65,1627,1770
E01014344,3,21,33,172,1283,1512
E01014363,0,2,7,7,1334,1350
E01014364,0,8,9,30,1449,1496
E01014365,2,2,17,5,1452,1478
E01014369,4,3,17,13,1261,1298
E01014299,4,15,11,11,1390,1431
E01014301,0,14,12,41,1686,1753
E01014303,0,8,12,33,1543,1596
E01014304,0,0,7,32,1419,1458
E01014362,5,5,8,4,1398,1420
E01014233,0,16,26,20,1349,1411
E01014234,6,26,23,22,1507,1584
E01014239,5,9,22,10,1438,1484
E01014240,3,11,27,13,1475,1529
E01014308,0,5,15,16,1632,1668
E01014309,1,28,20,157,1079,1285
E01014311,3,13,13,43,1291,1363
E01014313,0,13,10,22,1523,1568
E01014321,1,13,16,17,1378,1425
E01014366,7,49,44,21,1778,1899
E01014367,4,31,29,28,1368,1460
E01014368,2,17,18,27,1533,1597
E01014305,15,24,27,661,668,1395
E01014306,9,17,30,492,871,1419
E01014307,14,22,22,735,590,1383
E01014312,3,3,18,189,1212,1425
E01014346,6,12,13,23,1523,1577
E01014348,6,8,16,23,1313,1366
E01014349,2,6,13,9,1399,1429
E01014353,13,10,17,114,1556,1710
E01014310,2,14,19,199,1828,2062
E01014314,1,3,22,99,1288,1413
E01014316,2,7,26,38,1493,1566
E01014317,1,23,35,39,1459,1557
E01014322,4,26,42,188,1402,1662
E01014235,3,24,17,24,1519,1587
E01014236,12,44,35,153,2100,2344
E01014237,9,13,22,9,1539,1592
E01014238,19,36,16,32,1422,1525
E01014315,2,2,9,13,1305,1331
E01014318,1,7,12,14,1414,1448
E01014319,6,8,17,22,1457,1510
E01014320,1,5,22,54,1209,1291
E01014347,1,1,14,27,1370,1413
E01014350,0,3,16,20,1331,1370
E01014351,1,10,11,38,1525,1585
E01014352,10,11,11,38,1316,1386
E01014171,1,9,20,5,1384,1419
E01014172,0,2,10,6,1389,1407
E01014173,4,6,9,11,1520,1550
E01014174,1,0,9,16,1601,1627
E01014112,0,1,8,27,1637,1673
E01014131,3,5,13,73,2148,2242
E01014132,0,1,3,6,1070,1080
E01014135,0,0,12,9,1214,1235
E01014175,0,1,11,4,1124,1140
E01014176,3,7,10,23,1452,1495
E01014177,3,1,6,26,1348,1384
E01014178,8,10,18,31,1447,1514
E01014111,1,5,15,50,1479,1550
E01014167,12,12,18,64,1843,1949
E01014168,6,7,19,57,1300,1389
E01014170,1,7,11,31,1432,1482
E01014125,1,28,34,16,1484,1563
E01014126,0,9,19,15,1416,1459
E01014127,0,34,52,28,1612,1726
E01014128,3,31,29,35,2037,2135
E01014169,1,54,57,27,1598,1737
E01014129,1,8,19,20,981,1029
E01014130,1,10,12,37,1353,1413
E01014179,2,1,3,15,1171,1192
E01014180,0,10,20,22,1282,1334
E01014189,2,26,29,36,1444,1537
E01014190,7,4,14,35,1642,1702
E01014102,1,20,31,194,1577,1823
E01014103,2,6,15,155,1057,1235
E01014138,2,17,45,104,1318,1486
E01014140,8,51,71,161,1172,1463
E01014205,1,16,19,117,1229,1382
E01014206,6,21,32,91,1172,1322
E01014207,10,24,22,98,1137,1291
E01014208,13,4,23,5,1181,1226
E01014209,19,20,17,109,1293,1458
E01014137,19,21,32,154,1307,1533
E01014139,19,54,44,219,1060,1396
E01014141,9,58,82,195,2455,2799
E01014142,9,61,61,291,980,1402
E01014143,4,29,46,226,1181,1486
E01014136,1,4,8,13,1613,1639
E01014148,0,3,15,11,1464,1493
E01014149,0,1,10,3,1075,1089
E01014202,5,13,30,72,2269,2389
E01014203,1,5,10,50,1476,1542
E01014204,2,13,31,42,1893,1981
E01014104,10,31,48,159,1452,1700
E01014105,25,27,77,288,1518,1935
E01014113,16,59,45,547,968,1635
E01014114,1,10,17,117,1311,1456
E01014133,2,14,33,101,1663,1813
E01014134,2,5,26,18,1257,1308
E01014144,1,7,21,69,1432,1530
E01014145,8,30,49,111,1570,1768
E01014185,3,23,22,28,1565,1641
E01014186,0,8,25,17,1384,1434
E01014187,0,17,13,11,1430,1471
E01014188,7,13,21,20,1477,1538
E01014150,7,11,25,59,1542,1644
E01014151,0,8,31,8,1457,1504
E01014152,1,4,27,13,1262,1307
E01014153,4,7,37,28,1685,1761
E01014154,1,6,21,35,1618,1681
E01014155,12,8,32,52,1544,1648
E01014181,26,20,40,354,1563,2003
E01014182,17,9,15,128,1096,1265
E01014183,17,7,17,147,1371,1559
E01014184,8,3,28,41,1418,1498
E01014146,2,4,35,33,2138,2212
E01014147,2,13,38,43,1984,2080
E01014156,8,9,39,82,2022,2160
E01014157,8,7,32,156,1303,1506
E01014158,4,13,32,56,1456,1561
E01014124,1,9,21,19,1634,1684
E01014163,9,30,40,50,1330,1459
E01014164,13,4,32,25,1573,1647
E01014165,3,27,44,46,1299,1419
E01014166,2,24,29,28,1498,1581
E01014191,2,94,65,158,1423,1742
E01014192,5,61,30,61,1286,1443
E01014193,1,52,24,69,1540,1686
E01014194,0,17,35,64,1404,1520
E01014195,20,16,23,99,1289,1447
E01014196,2,39,33,71,1398,1543
E01014119,2,6,25,31,1594,1658
E01014120,0,13,51,16,1676,1756
E01014121,0,2,8,11,1367,1388
E01014122,1,6,24,25,1510,1566
E01014123,1,6,23,17,1485,1532
E01014106,0,33,35,27,1489,1584
E01014107,0,7,12,16,1145,1180
E01014108,1,43,40,20,1363,1467
E01014109,1,39,26,18,1109,1193
E01014110,0,39,30,15,1415,1499
E01014197,6,8,36,30,1443,1523
E01014198,0,9,38,8,1036,1091
E01014199,7,18,51,33,1564,1673
E01014200,0,12,26,4,1265,1307
E01014201,0,6,27,14,1257,1304
E01014159,0,2,12,6,1211,1231
E01014160,1,3,22,59,1233,1318
E01014161,0,3,20,9,1114,1146
E01014162,0,10,23,54,1547,1634
E01014115,1,16,26,54,1244,1341
E01014116,0,12,27,26,1598,1663
E01014117,8,8,15,34,1120,1185
E01014118,2,2,40,18,1153,1215
E01029368,0,0,6,12,1208,1226
E01029369,0,0,8,15,1227,1250
E01029370,4,2,5,5,1377,1393
E01029371,7,4,23,7,1509,1550
E01029402,1,5,7,10,1962,1985
E01029372,1,1,16,5,1335,1358
E01029373,5,13,16,45,2227,2306
E01029401,1,4,13,26,1561,1605
E01029403,0,0,14,5,1485,1504
E01029404,0,0,22,21,1453,1496
E01029345,0,3,14,11,1628,1656
E01029346,1,8,16,17,1657,1699
E01029347,0,1,9,7,1415,1432
E01029348,0,8,12,12,1719,1751
E01029374,1,5,16,32,2295,2349
E01029383,0,5,17,5,1543,1570
E01029385,0,3,5,15,1456,1479
E01029388,0,12,7,7,1349,1375
E01029390,3,2,22,15,1082,1124
E01029384,3,4,7,30,1892,1936
E01029386,0,0,7,8,1421,1436
E01029387,1,7,14,17,1439,1478
E01029389,1,6,23,11,1604,1645
E01029379,2,12,14,30,1709,1767
E01029398,0,1,11,3,1667,1682
E01029399,1,4,13,8,1563,1589
E01029400,0,1,7,24,1674,1706
E01029354,1,9,30,30,1478,1548
E01029355,1,2,20,5,1543,1571
E01029356,0,6,23,13,1455,1497
E01029357,0,1,8,20,1325,1354
E01029358,0,2,10,10,1294,1316
E01029349,0,1,3,8,1268,1280
E01029350,7,3,9,9,1498,1526
E01029351,1,1,17,7,1477,1503
E01029352,0,0,10,7,1334,1351
E01029393,0,4,20,16,1631,1671
E01029380,0,2,5,8,1524,1539
E01029381,0,1,7,13,1485,1506
E01029382,0,1,17,13,1614,1645
E01029391,0,2,18,8,1638,1666
E01029392,0,4,13,22,1924,1963
E01029375,14,10,30,42,2408,2504
E01029376,3,13,14,19,1925,1974
E01029377,2,6,17,15,1409,1449
E01029378,2,6,18,28,1647,1701
E01029353,0,7,12,15,1369,1403
E01029364,4,2,10,44,1541,1601
E01029365,0,2,16,10,1502,1530
E01029366,2,4,18,26,1637,1687
E01029367,0,10,17,29,2122,2178
E01029359,0,9,14,19,1577,1619
E01029360,0,21,15,65,1437,1538
E01029361,2,8,29,14,1494,1547
E01029362,0,13,24,12,1516,1565
E01029363,1,0,10,2,1391,1404
E01029394,4,1,11,1,1445,1462
E01029395,0,7,13,14,1543,1577
E01029396,1,4,14,13,1680,1712
E01029397,0,7,31,22,2668,2728
E01029405,0,0,5,7,1623,1635
E01029406,4,0,3,3,1220,1230
E01029422,5,6,12,24,1304,1351
E01029423,1,1,13,21,1533,1569
E01029467,0,4,3,9,2036,2052
E01029430,0,0,11,5,1477,1493
E01029431,0,1,7,3,1611,1622
E01029432,3,1,4,12,1455,1475
E01029433,16,0,4,8,1580,1608
E01029459,3,2,8,16,1545,1574
E01029460,3,3,10,22,1694,1732
E01029461,6,6,19,17,1892,1940
E01029462,2,6,8,24,1605,1645
E01029443,5,1,11,21,1639,1677
E01029444,4,1,6,13,1566,1590
E01029463,0,4,12,16,1229,1261
E01029464,0,3,10,21,1539,1573
E01029465,3,1,15,9,1475,1503
E01029466,11,7,9,96,1437,1560
E01029454,6,5,11,37,1579,1638
E01029455,0,9,11,36,1771,1827
E01029456,0,9,3,13,1494,1519
E01029457,0,1,14,24,1331,1370
E01029458,5,2,11,19,1458,1495
E01029411,0,1,5,0,1281,1287
E01029412,0,6,13,23,1309,1351
E01029424,1,1,7,6,1014,1029
E01029425,7,55,43,59,2196,2360
E01029473,1,1,6,1,1405,1414
E01029474,1,4,11,19,1172,1207
E01029434,10,18,55,116,1368,1567
E01029435,12,30,25,127,1302,1496
E01029436,4,46,51,192,1566,1859
E01029437,8,28,64,166,2051,2317
E01029438,7,12,17,31,1445,1512
E01029426,21,24,45,504,1153,1747
E01029427,8,43,52,256,1162,1521
E01029428,0,8,37,135,1404,1584
E01029429,7,25,32,401,885,1350
E01029445,17,36,59,515,1305,1932
E01029446,7,13,30,165,1515,1730
E01029447,13,34,48,942,702,1739
E01029448,11,30,53,400,1166,1660
E01029468,2,11,46,25,1571,1655
E01029469,5,12,17,37,1775,1846
E01029470,12,7,22,66,1455,1562
E01029471,4,29,25,47,1667,1772
E01029472,1,4,28,30,1568,1631
E01029407,12,36,38,420,948,1454
E01029408,34,71,64,554,1395,2118
E01029409,13,51,47,515,1055,1681
E01029410,5,54,27,478,992,1556
E01032896,9,46,23,102,912,1092
E01032897,4,6,26,16,1121,1173
E01032898,10,44,29,291,882,1256
E01029418,1,17,20,41,2027,2106
E01029419,3,16,18,25,1485,1547
E01029420,0,9,16,25,1682,1732
E01029413,0,13,38,55,1382,1488
E01029414,2,15,19,186,1436,1658
E01029415,11,18,21,102,1470,1622
E01029416,1,8,18,78,1140,1245
E01029417,0,2,15,26,1175,1218
E01029449,1,4,15,30,1600,1650
E01029450,7,4,36,28,1427,1502
E01029451,6,10,26,13,1690,1745
E01029452,11,9,25,20,1509,1574
E01029453,6,28,25,33,1414,1506
E01029439,1,0,24,12,1408,1445
E01029440,0,4,11,14,1264,1293
E01029441,0,5,13,14,1481,1513
E01029442,0,2,14,47,1279,1342
E01029480,7,6,20,7,1769,1809
E01029481,0,2,4,3,1873,1882
E01029482,0,44,3,15,1582,1644
E01029498,1,2,8,5,1783,1799
E01029477,6,10,12,6,1513,1547
E01029478,0,9,14,2,1557,1582
E01029479,5,22,52,53,2686,2818
E01029509,1,7,9,22,1640,1679
E01029486,1,4,11,2,1401,1419
E01029507,1,7,14,7,1661,1690
E01029508,0,14,17,12,2270,2313
E01029515,0,5,12,13,1793,1823
E01029492,1,1,31,25,1948,2006
E01029499,1,2,10,6,1739,1758
E01029501,1,7,8,23,1500,1539
E01029526,5,11,31,23,1534,1604
E01032899,2,14,23,3,1482,1524
E01032900,2,3,40,41,1969,2055
E01029483,2,5,12,40,1494,1553
E01029484,0,6,18,45,1727,1796
E01029485,1,5,11,31,1447,1495
E01029500,3,6,9,24,1698,1740
E01029520,6,8,21,41,1503,1579
E01029524,1,8,19,18,1654,1700
E01029525,10,4,21,10,1702,1747
E01029487,1,4,23,16,1591,1635
E01029493,0,1,27,6,1937,1971
E01029494,0,9,8,16,1520,1553
E01029495,0,3,22,27,1606,1658
E01029497,3,4,16,12,1940,1975
E01029491,5,2,15,25,1727,1774
E01029511,1,8,18,13,1561,1601
E01029512,6,12,27,30,1843,1918
E01029518,3,14,53,61,2575,2706
E01029519,3,12,42,67,2000,2124
E01029516,1,1,12,11,1913,1938
E01029517,2,1,7,4,1634,1648
E01029530,0,17,17,34,1675,1743
E01029531,1,4,3,9,1704,1721
E01029475,0,3,15,12,2007,2037
E01029476,0,0,7,5,1372,1384
E01029489,0,4,6,2,1583,1595
E01029490,1,2,15,14,1426,1458
E01029505,1,2,12,24,1532,1571
E01029506,0,5,8,9,1819,1841
E01029496,0,0,19,9,1882,1910
E01029527,0,4,4,4,1270,1282
E01029528,0,6,13,10,1265,1294
E01029529,0,3,15,6,1257,1281
E01029513,8,14,24,234,1084,1364
E01029514,0,9,20,265,1262,1556
E01029521,1,8,5,51,1624,1689
E01029522,5,7,13,18,1594,1637
E01029523,0,1,6,17,1522,1546
E01029488,12,95,88,75,2062,2332
E01029502,4,4,14,19,1651,1692
E01029503,2,1,13,7,1562,1585
E01029504,0,9,17,34,1474,1534
E01029562,1,2,9,4,1337,1353
E01029565,0,3,10,12,1235,1260
E01029581,0,0,14,6,1557,1577
E01029582,2,0,15,11,1801,1829
E01029586,0,0,4,8,1211,1223
E01029587,0,1,20,10,1213,1244
E01029561,0,2,14,1,1460,1477
E01029563,1,5,4,3,1378,1391
E01029564,2,6,17,8,1313,1346
E01029588,11,6,20,13,1490,1540
E01029540,1,6,11,4,1408,1430
E01029541,0,0,20,10,1543,1573
E01029542,6,4,8,2,1316,1336
E01029543,0,4,6,5,1287,1302
E01029595,0,4,5,10,1215,1234
E01029597,0,6,17,12,1446,1481
E01029536,1,9,14,12,1481,1517
E01029544,6,1,15,44,1296,1362
E01029545,5,6,5,35,1508,1559
E01029546,1,1,10,96,1326,1434
E01029596,1,1,6,7,1145,1160
E01029532,5,6,25,13,1420,1469
E01029533,2,4,10,7,1503,1526
E01029534,0,6,7,9,1496,1518
E01029535,0,6,16,2,1390,1414
E01029556,1,7,11,16,2475,2510
E01029537,1,2,17,19,1532,1571
E01029538,0,12,15,21,1702,1750
E01029539,0,12,23,31,1499,1565
E01029552,0,12,12,28,1427,1479
E01029558,1,7,16,21,1622,1667
E01029547,3,9,15,26,1402,1455
E01029548,4,4,12,13,1442,1475
E01029559,0,5,13,12,1398,1428
E01029560,0,5,19,7,1568,1599
E01029568,2,2,6,33,1421,1464
E01029583,0,10,20,26,1396,1452
E01029584,2,12,15,24,1137,1190
E01029585,1,6,20,35,1402,1464
E01029609,3,17,26,23,1597,1666
E01029611,1,10,20,41,1540,1612
E01029577,1,7,10,18,1516,1552
E01029579,0,2,8,19,1614,1643
E01029580,2,8,25,47,1348,1430
E01029610,1,4,21,7,1288,1321
E01029612,8,4,10,8,1217,1247
E01029553,13,13,20,26,1361,1433
E01029554,7,4,13,38,1141,1203
E01029566,0,4,25,34,1169,1232
E01029567,8,11,22,28,1548,1617
E01029598,24,21,46,91,1614,1796
E01029599,7,4,23,59,1348,1441
E01029555,10,17,26,79,1640,1772
E01029578,12,9,25,64,1501,1611
E01029602,25,53,56,215,1571,1920
E01029603,6,17,25,157,1276,1481
E01029604,10,23,49,96,1484,1662
E01029576,48,259,140,895,3118,4460
E01029593,10,0,22,18,1735,1785
E01029594,1,8,25,8,1790,1832
E01029557,0,2,16,4,1232,1254
E01029573,11,3,16,17,1451,1498
E01029574,2,0,10,2,1361,1375
E01029575,0,2,8,7,1001,1018
E01029549,6,6,20,36,1616,1684
E01029551,9,6,19,39,1543,1616
E01029591,0,14,11,58,1428,1511
E01029600,7,5,17,28,1366,1423
E01029605,4,3,8,25,1224,1264
E01029607,4,11,26,47,1328,1416
E01029589,12,9,16,66,1106,1209
E01029590,3,3,3,43,1301,1353
E01029601,13,18,32,121,1300,1484
E01029606,3,14,27,32,1423,1499
E01029608,20,20,12,138,1290,1480
E01033257,15,12,37,123,2312,2499
E01029569,0,2,6,12,1421,1441
E01029570,6,1,24,49,2388,2468
E01029571,1,0,14,13,1347,1375
E01029572,6,8,15,25,1610,1664
E01029655,1,5,18,7,1941,1972
E01029656,2,1,25,35,1760,1823
E01029657,3,0,11,24,1751,1789
E01029658,4,9,16,13,1290,1332
E01029659,0,1,7,0,1376,1384
E01029660,1,7,21,15,2005,2049
E01029621,4,8,21,16,1430,1479
E01029646,2,1,7,15,1408,1433
E01029647,4,6,32,26,2142,2210
E01029648,0,4,16,24,1450,1494
E01029617,1,4,22,44,1604,1675
E01029618,2,3,23,16,1496,1540
E01029668,0,4,10,8,1236,1258
E01029669,0,4,9,10,1267,1290
E01029670,0,12,17,18,1532,1579
E01029620,0,1,15,15,1255,1286
E01029622,4,2,11,19,1484,1520
E01029623,0,2,16,17,1161,1196
E01029624,4,1,15,18,1479,1517
E01029625,0,5,8,3,1108,1124
E01029641,0,5,13,17,1646,1681
E01029642,3,7,16,8,1479,1513
E01029638,3,3,30,13,1961,2010
E01029639,4,5,7,37,1371,1424
E01029640,0,5,16,24,1438,1483
E01029643,0,4,12,5,1480,1501
E01029644,1,2,14,17,1414,1448
E01029616,1,11,23,18,1422,1475
E01029619,1,11,28,32,1811,1883
E01029636,0,4,19,37,1380,1440
E01029637,4,125,130,184,2115,2558
E01029632,8,7,24,55,1722,1816
E01029633,4,9,33,23,1658,1727
E01029634,7,12,19,17,1359,1414
E01029635,0,25,50,27,1641,1743
E01029613,3,4,14,19,1344,1384
E01029614,12,13,53,108,1544,1730
E01029615,10,4,29,15,1158,1216
E01029627,6,5,41,36,1327,1415
E01029626,1,11,12,8,1411,1443
E01029628,4,5,11,17,1155,1192
E01029629,0,1,11,35,1171,1218
E01029630,0,10,16,51,1377,1454
E01029631,8,10,23,59,1343,1443
E01029654,1,4,36,25,2180,2246
E01029661,14,27,43,65,1841,1990
E01029663,0,8,21,45,1382,1456
E01029665,4,31,36,92,1647,1810
E01029662,30,32,46,122,2049,2279
E01029664,2,7,47,45,1494,1595
E01029666,2,25,50,58,1421,1556
E01029671,1,1,13,14,1461,1490
E01029673,13,17,20,95,1514,1659
E01029676,0,2,13,9,1033,1057
E01029679,0,5,12,24,1413,1454
E01029680,6,4,19,10,1497,1536
E01029645,0,7,11,21,1994,2033
E01029667,6,10,23,33,2153,2225
E01029672,18,5,23,133,1389,1568
E01029674,1,2,9,20,1817,1849
E01029675,0,3,11,3,1459,1476
E01029677,1,2,8,7,1296,1314
E01029678,0,3,9,24,1716,1752
E01029649,1,2,10,7,1138,1158
E01029650,2,0,9,12,1504,1527
E01029651,15,1,9,14,1506,1545
E01029652,7,2,29,30,1662,1730
E01029653,0,0,24,9,1232,1265
E01029702,0,9,12,21,1488,1530
E01029703,0,6,10,30,1503,1549
E01029704,0,3,8,6,1369,1386
E01029705,3,4,10,13,1436,1466
E01029681,0,10,11,2,1184,1207
E01029682,2,1,15,6,1627,1651
E01029683,0,2,19,34,1257,1312
E01029748,0,12,6,16,1324,1358
E01029749,0,13,18,15,1596,1642
E01029740,1,3,23,26,1622,1675
E01029744,2,11,29,32,2282,2356
E01029745,13,7,11,36,1619,1686
E01029746,6,3,20,6,1498,1533
E01029753,6,5,9,8,1277,1305
E01029756,2,2,21,31,1723,1779
E01029733,2,2,13,12,1925,1954
E01029739,0,2,14,21,1573,1610
E01029741,0,1,15,13,1676,1705
E01029754,8,3,5,5,1309,1330
E01029755,3,1,17,17,1368,1406
E01029695,1,0,11,11,1979,2002
E01029696,1,2,18,12,1475,1508
E01029697,0,34,27,35,1518,1614
E01029698,1,11,14,6,1501,1533
E01029747,0,2,14,6,1431,1453
E01029690,9,28,21,75,1417,1550
E01029718,3,21,30,68,1840,1962
E01029743,1,7,8,11,1369,1396
E01029751,9,17,12,33,1492,1563
E01029719,2,10,21,26,1500,1559
E01029720,4,33,15,33,1545,1630
E01029721,3,19,26,41,1535,1624
E01029750,2,11,40,40,1465,1558
E01029752,0,15,37,16,1220,1288
E01029687,3,8,14,15,1830,1870
E01029710,1,4,13,3,1413,1434
E01029711,4,4,11,16,1479,1514
E01029712,6,4,14,8,1885,1917
E01029713,2,1,18,4,1555,1580
E01029692,8,21,43,107,1413,1592
E01029693,49,88,36,380,1143,1696
E01029722,22,26,37,113,1457,1655
E01029725,10,76,83,174,1901,2244
E01029689,3,25,35,48,1560,1671
E01029691,8,28,13,41,1123,1213
E01029694,19,46,30,109,1241,1445
E01029699,27,40,46,85,1768,1966
E01029701,43,32,60,147,1658,1940
E01029686,12,2,15,48,1344,1421
E01029700,4,7,17,54,1194,1276
E01029723,18,13,19,78,1458,1586
E01029724,10,9,10,52,1690,1771
E01029732,8,29,35,134,2217,2423
E01029714,1,13,22,22,1531,1589
E01029736,4,3,20,103,1455,1585
E01029737,10,17,27,42,1481,1577
E01029738,7,21,14,19,1317,1378
E01029742,2,13,12,15,2038,2080
E01029715,9,24,33,12,1553,1631
E01029716,5,24,25,38,1500,1592
E01029717,2,71,53,10,1643,1779
E01029727,4,6,32,25,1485,1552
E01029728,3,9,21,14,1382,1429
E01029684,14,10,4,50,1410,1488
E01029685,4,9,14,38,1503,1568
E01029730,6,2,10,15,1049,1082
E01029731,2,5,17,80,1533,1637
E01029757,3,4,18,45,1534,1604
E01029758,14,2,20,43,1456,1535
E01029759,8,6,20,55,1626,1715
E01029760,15,3,17,50,1485,1570
E01029688,2,2,16,16,2239,2275
E01029706,1,1,6,7,1532,1547
E01029707,0,1,14,3,1438,1456
E01029708,1,1,12,6,1889,1909
E01029709,0,0,8,9,1466,1483
E01029726,1,15,17,41,1649,1723
E01029729,2,20,27,28,1527,1604
E01029734,10,31,44,63,2094,2242
E01029735,1,21,42,60,2221,2345
E01029797,0,2,8,2,1541,1553
E01029806,3,2,14,6,1474,1499
E01029808,1,3,15,7,1398,1424
E01029809,0,3,8,3,1444,1458
E01029810,1,2,13,15,1353,1384
E01029767,1,0,5,0,1634,1640
E01029769,0,0,8,8,1648,1664
E01029770,0,0,2,10,1913,1925
E01029802,1,1,8,5,1794,1809
E01029763,1,2,21,5,1601,1630
E01029764,0,1,14,6,1827,1848
E01029765,0,7,8,1,1374,1390
E01029766,3,9,17,5,1476,1510
E01029774,0,1,17,21,1941,1980
E01029768,2,0,2,6,1364,1374
E01029771,1,0,9,5,1626,1641
E01029772,0,0,4,6,1742,1752
E01029773,1,0,8,4,1525,1538
E01029804,1,5,20,30,1707,1763
E01029807,3,3,5,6,1126,1143
E01029811,4,2,17,7,1527,1557
E01029812,4,7,22,30,1946,2009
E01029814,3,2,13,23,1644,1685
E01029792,1,5,15,14,2360,2395
E01029793,1,1,6,2,1618,1628
E01029805,0,0,10,8,1701,1719
E01029813,1,1,14,14,2135,2165
E01029815,0,0,11,2,1513,1526
E01029816,0,0,7,13,1416,1436
E01029801,0,0,6,7,1827,1840
E01029803,0,2,3,7,1786,1798
E01029817,0,1,4,3,1840,1848
E01029762,1,2,6,11,1571,1591
E01029775,2,0,4,4,1524,1534
E01029776,0,0,7,6,1802,1815
E01029777,1,3,14,7,1507,1532
E01029779,0,3,25,9,1579,1616
E01029780,3,10,15,11,1598,1637
E01029794,0,7,10,24,1380,1421
E01029818,3,1,9,4,1514,1531
E01029819,1,1,13,5,1650,1670
E01029761,2,0,10,7,1358,1377
E01029782,3,1,13,15,2004,2036
E01029795,0,1,11,3,1647,1662
E01029796,0,0,4,0,1476,1480
E01029781,1,0,7,1,1515,1524
E01029783,0,1,11,2,1402,1416
E01029786,0,2,9,4,1448,1463
E01029787,1,1,11,48,1655,1716
E01029778,1,0,7,9,1703,1720
E01029789,1,0,5,3,1020,1029
E01029798,0,7,21,5,1665,1698
E01029799,1,0,2,8,1830,1841
E01029800,1,8,8,5,1534,1556
E01029784,0,3,17,8,2173,2201
E01029785,1,2,8,3,1795,1809
E01029788,1,3,5,1,1346,1356
E01029790,0,1,8,10,1936,1955
E01029791,0,1,8,8,1372,1389
E01029846,4,1,13,8,1241,1267
E01029847,0,1,8,7,1326,1342
E01029848,1,1,9,14,1206,1231
E01029852,0,2,13,8,1720,1743
E01029853,0,7,20,26,1668,1721
E01029854,1,3,5,12,1492,1513
E01029835,6,7,17,13,1618,1661
E01029836,4,7,15,17,1235,1278
E01029849,2,4,12,19,1433,1470
E01029850,0,7,10,19,1274,1310
E01029851,1,18,46,49,2018,2132
E01029820,7,3,26,25,1497,1558
E01029821,0,2,8,4,1456,1470
E01029822,4,9,25,24,1514,1576
E01029824,4,7,24,22,1775,1832
E01029841,1,10,12,7,1421,1451
E01029823,1,3,8,7,1464,1483
E01029831,7,1,18,11,1457,1494
E01029832,0,3,11,6,1616,1636
E01029834,1,5,10,20,1505,1541
E01029844,1,3,14,10,1216,1244
E01029833,2,9,17,22,1643,1693
E01029837,3,4,16,17,1551,1591
E01029838,1,13,14,20,1520,1568
E01029839,1,8,6,13,1207,1235
E01029825,1,11,6,3,1317,1338
E01029826,0,4,12,2,1528,1546
E01029827,0,8,23,15,1411,1457
E01029828,1,8,8,8,1303,1328
E01029830,0,5,7,12,1166,1190
E01029840,2,8,23,23,1304,1360
E01029842,0,6,26,17,1305,1354
E01029843,0,0,20,1,1476,1497
E01029845,0,2,14,1,1096,1113
E01029859,8,15,37,14,1772,1846
E01029855,4,6,30,14,1489,1543
E01029856,0,9,13,6,1437,1465
E01029857,2,13,10,30,1363,1418
E01029858,0,28,19,18,1525,1590
E01029865,1,30,36,32,1577,1676
E01029860,1,3,12,6,1307,1329
E01029861,0,2,6,7,1333,1348
E01029862,1,3,10,23,1303,1340
E01029863,4,5,7,21,1716,1753
E01029864,3,13,18,44,1527,1605
E01029829,5,13,11,7,1959,1995
E01029867,1,15,17,9,1633,1675
E01029868,1,12,8,11,1398,1430
E01029869,2,11,19,4,1582,1618
E01032901,3,18,23,23,1540,1607
E01032902,1,7,11,12,1321,1352
E01031035,0,2,15,22,1938,1977
E01031036,1,1,4,2,1519,1527
E01031037,0,3,4,5,1488,1500
E01031038,6,6,15,17,1973,2017
E01031039,0,4,8,4,1676,1692
E01031040,0,7,13,6,1747,1773
E01031016,0,2,11,3,1555,1571
E01031025,2,13,7,33,1546,1601
E01031026,1,1,16,15,1581,1614
E01031031,4,3,16,11,2549,2583
E01031032,0,1,10,27,1301,1339
E01031009,2,2,17,33,2138,2192
E01031010,0,3,14,22,1714,1753
E01031011,1,10,11,22,1922,1966
E01031012,1,1,3,1,1436,1442
E01031013,0,2,6,15,1020,1043
E01031014,2,1,7,13,1181,1204
E01031015,3,2,21,2,1375,1403
E01031023,5,18,18,32,1505,1578
E01031024,1,3,13,28,1572,1617
E01031033,0,1,12,19,1819,1851
E01031034,7,8,21,5,1838,1879
E01031005,1,4,9,11,1404,1429
E01031008,2,4,7,10,1330,1353
E01031017,0,2,11,18,1252,1283
E01031018,3,1,4,4,1125,1137
E01031029,1,5,9,27,1461,1503
E01031030,0,1,12,24,2198,2235
E01031019,1,13,24,17,1654,1709
E01031020,1,6,12,10,1495,1524
E01031021,0,9,25,18,1520,1572
E01031022,2,7,16,11,1640,1676
E01031041,0,5,27,11,1668,1711
E01031042,0,3,14,8,1708,1733
E01031006,0,8,23,12,1428,1471
E01031007,0,1,14,10,1193,1218
E01031027,0,6,17,29,1420,1472
E01031028,0,3,20,23,1820,1866
E01031110,5,3,16,79,1422,1525
E01031111,0,1,11,79,1031,1122
E01031112,1,4,13,20,1598,1636
E01031113,1,2,11,36,1416,1466
E01031114,8,7,17,39,1436,1507
E01031073,1,21,18,43,1801,1884
E01031074,0,22,18,16,1494,1550
E01031075,1,10,23,27,1585,1646
E01032890,4,26,12,31,2168,2241
E01031100,5,7,15,110,1220,1357
E01031101,9,13,2,121,1297,1442
E01031102,6,13,13,66,1266,1364
E01031103,5,6,18,75,1229,1333
E01031104,1,2,9,48,1387,1447
E01031081,5,11,32,38,1607,1693
E01031082,5,13,12,14,1342,1386
E01031083,3,4,10,8,1527,1552
E01031084,1,11,12,18,2185,2227
E01031085,0,10,5,26,1334,1375
E01031043,9,16,20,199,1403,1647
E01031044,8,11,17,93,1551,1680
E01031045,1,15,15,165,1533,1729
E01031046,16,23,26,708,955,1728
E01031047,18,60,40,578,1238,1934
E01031057,4,28,24,57,1453,1566
E01031058,5,8,15,16,1409,1453
E01031059,1,12,20,81,1356,1470
E01031060,9,18,20,62,1333,1442
E01031061,2,13,19,52,1435,1521
E01031090,2,12,20,20,1393,1447
E01031091,4,10,12,33,1396,1455
E01031092,0,6,24,8,1428,1466
E01031093,2,4,14,16,1312,1348
E01031094,3,15,7,11,1126,1162
E01031048,1,12,9,54,1189,1265
E01031049,7,30,31,173,2017,2258
E01031050,0,40,27,103,1668,1838
E01031051,0,3,4,75,1293,1375
E01031115,22,21,33,535,1151,1762
E01031116,0,6,22,46,1616,1690
E01031117,4,0,17,65,1416,1502
E01031118,4,20,21,26,1131,1202
E01031119,26,33,23,590,959,1631
E01031052,9,21,30,148,1304,1512
E01031053,3,16,11,42,1369,1441
E01031054,3,2,21,57,1486,1569
E01031055,12,11,16,115,1500,1654
E01031056,2,1,18,40,1439,1500
E01031120,6,0,5,32,1352,1395
E01031121,0,1,8,50,1144,1203
E01031122,3,5,14,54,1406,1482
E01031123,2,3,9,46,1200,1260
E01031124,15,5,22,89,1406,1537
E01031105,1,7,19,16,1391,1434
E01031106,5,1,6,52,1373,1437
E01031107,1,3,6,42,1106,1158
E01031108,9,5,12,92,1271,1389
E01031109,0,6,7,46,1564,1623
E01031062,0,1,17,21,1198,1237
E01031063,0,5,9,26,1270,1310
E01031064,0,21,15,11,1155,1202
E01031065,0,4,20,12,1489,1525
E01031066,0,4,15,8,1365,1392
E01031067,3,2,21,32,1429,1487
E01031068,1,2,3,14,1672,1692
E01031069,6,0,4,63,1403,1476
E01031070,0,7,7,19,1458,1491
E01031095,2,27,13,19,1186,1247
E01031096,14,22,30,121,1193,1380
E01031097,7,3,12,31,1600,1653
E01031098,49,30,30,467,917,1493
E01031099,51,72,48,444,1655,2270
E01031086,9,14,28,69,1753,1873
E01031087,27,22,31,128,2003,2211
E01031088,16,31,18,141,1736,1942
E01031089,6,4,8,59,1370,1447
E01031077,15,14,27,64,1328,1448
E01031078,20,18,37,180,1822,2077
E01031079,11,23,10,119,1313,1476
E01031080,13,18,25,103,1464,1623
E01032588,7,14,17,148,1196,1382
E01031129,4,3,7,21,1113,1148
E01031159,3,12,18,50,1559,1642
E01031160,0,11,16,22,2085,2134
E01031182,25,36,36,334,1979,2410
E01032891,8,47,30,182,1417,1684
E01032892,5,19,12,78,1972,2086
E01031137,2,25,17,53,1070,1167
E01031138,6,16,12,81,1081,1196
E01031139,0,21,33,125,1665,1844
E01031140,3,15,26,118,1207,1369
E01031141,6,100,66,150,1477,1799
E01031142,9,97,118,72,1376,1672
E01031171,2,43,37,47,1376,1505
E01031172,6,52,47,38,1524,1667
E01031173,14,79,55,83,1627,1858
E01031174,4,131,95,316,1178,1724
E01031151,3,14,12,102,1430,1561
E01031152,3,13,12,42,1034,1104
E01031153,2,14,20,23,1397,1456
E01031154,1,13,25,42,1670,1751
E01031181,9,11,21,77,1695,1813
E01031130,5,94,45,195,1425,1764
E01031131,7,128,78,322,1107,1642
E01031132,6,100,51,155,1630,1942
E01031133,7,60,45,111,1366,1589
E01031167,4,42,43,44,1245,1378
E01031168,17,102,107,109,2431,2766
E01031169,17,75,65,261,1585,2003
E01031170,10,66,49,134,1354,1613
E01031125,1,11,14,46,1400,1472
E01031127,4,20,34,35,1487,1580
E01031164,3,17,20,26,1937,2003
E01031165,0,12,17,22,1544,1595
E01032893,18,30,37,192,1595,1872
E01032894,1,26,38,89,1208,1362
E01032895,7,8,30,52,1343,1440
E01031155,1,10,19,73,1305,1408
E01031156,7,20,26,43,1370,1466
E01031157,4,37,41,188,1686,1956
E01031158,0,11,18,20,1036,1085
E01031143,5,17,10,85,1409,1526
E01031144,7,45,26,42,1168,1288
E01031145,4,33,45,67,1377,1526
E01031146,2,23,38,82,1380,1525
E01031161,0,10,17,52,1927,2006
E01031162,5,15,38,44,1625,1727
E01031163,7,12,26,35,1463,1543
E01031179,3,15,27,81,1604,1730
E01031180,1,26,39,53,1899,2018
E01031134,2,13,16,33,1621,1685
E01031135,2,6,22,78,1499,1607
E01031136,1,13,25,50,1630,1719
E01031175,8,8,7,62,1375,1460
E01031176,9,25,35,62,1359,1490
E01031177,12,26,46,78,1280,1442
E01031178,3,18,14,45,1318,1398
E01031147,4,9,14,27,1522,1576
E01031148,0,12,21,35,1662,1730
E01031149,2,8,10,6,1460,1486
E01031150,1,5,9,14,1130,1159
E01031166,0,7,9,21,1871,1908
E01031213,2,9,20,39,1788,1858
E01031243,7,8,11,46,1888,1960
E01031244,1,1,17,27,1815,1861
E01031195,4,4,25,8,2233,2274
E01031202,1,3,7,8,1538,1557
E01031203,2,0,14,11,1480,1507
E01031204,4,0,10,3,1301,1318
E01031239,2,6,18,16,1528,1570
E01031240,2,3,19,1,1339,1364
E01031241,1,5,16,9,1402,1433
E01031242,8,3,25,18,1458,1512
E01031219,4,3,8,20,1472,1507
E01031220,2,1,17,15,1494,1529
E01031221,0,6,24,11,1491,1532
E01031222,3,1,14,24,1957,1999
E01031223,2,1,14,6,1324,1347
E01031224,0,0,7,9,1128,1144
E01031197,1,2,3,6,1190,1202
E01031198,0,2,10,6,1265,1283
E01031199,1,0,19,9,1447,1476
E01031200,0,4,10,18,1551,1583
E01031201,2,2,12,2,1548,1566
E01031210,1,1,9,8,1239,1258
E01031211,1,1,13,11,1048,1074
E01031183,1,3,18,22,1604,1648
E01031184,4,4,15,11,1485,1519
E01031185,1,4,13,9,1343,1370
E01031186,1,1,6,12,1526,1546
E01031187,7,4,18,19,1838,1886
E01031188,1,1,20,12,2194,2228
E01031208,1,0,13,22,2032,2068
E01031217,1,3,10,6,1181,1201
E01031218,3,3,13,13,1168,1200
E01031249,1,2,12,10,1176,1201
E01031250,2,0,8,5,1461,1476
E01031251,3,2,11,12,1171,1199
E01031252,1,6,18,10,1330,1365
E01031253,1,1,6,2,1512,1522
E01031228,1,4,13,23,1548,1589
E01031229,4,11,20,76,1711,1822
E01031230,12,5,39,42,2308,2406
E01031231,8,15,46,59,2018,2146
E01031236,11,8,26,28,1532,1605
E01031238,5,8,28,20,1272,1333
E01031225,2,5,14,28,1592,1641
E01031227,4,7,19,36,1941,2007
E01033250,6,10,33,45,1300,1394
E01033251,8,0,36,25,1085,1154
E01033252,2,3,10,16,1260,1291
E01031232,14,10,44,198,2174,2440
E01031233,1,4,19,15,1583,1622
E01031234,3,2,29,38,1684,1756
E01031235,1,3,23,47,1744,1818
E01031237,3,4,14,20,1380,1421
E01031189,1,4,8,15,1518,1546
E01031190,3,1,6,6,1734,1750
E01031191,2,2,16,7,1824,1851
E01031192,1,2,23,12,1866,1904
E01031248,0,5,25,5,2137,2172
E01031194,4,12,35,43,2318,2412
E01031205,0,4,5,20,1556,1585
E01031206,2,2,17,8,1447,1476
E01031207,3,1,11,6,1238,1259
E01031247,1,2,24,15,2245,2287
E01031196,0,6,30,21,2345,2402
E01031212,3,14,38,28,2565,2648
E01031245,0,1,10,4,1204,1219
E01031246,1,0,3,10,1075,1089
E01031193,0,3,9,2,2129,2143
E01031209,1,0,24,15,2076,2116
E01031214,0,0,17,5,1805,1827
E01031215,1,4,17,17,1697,1736
E01031216,3,2,4,15,1451,1475
E01031254,11,5,21,35,1436,1508
E01031255,2,1,10,23,1451,1487
E01031256,5,6,28,40,1546,1625
E01031257,1,7,20,57,1349,1434
E01031258,3,4,30,71,1403,1511
E01031296,4,1,26,44,1570,1645
E01031297,5,5,35,82,1822,1949
E01031298,3,2,10,28,1611,1654
E01031299,0,7,12,26,1379,1424
E01031300,2,6,20,31,1657,1716
E01031303,8,9,25,38,1418,1498
E01031304,4,1,9,18,1473,1505
E01031305,2,1,11,19,1488,1521
E01031306,15,4,17,27,1431,1494
E01031307,2,5,22,34,1382,1445
E01031281,1,5,14,26,1439,1485
E01031282,1,1,13,25,1429,1469
E01031283,5,2,14,18,1239,1278
E01031284,0,4,18,34,1176,1232
E01031277,8,5,18,52,1474,1557
E01031278,7,1,34,106,1313,1461
E01031279,5,3,17,22,1312,1359
E01031280,5,1,20,39,1248,1313
E01031301,3,3,8,34,1372,1420
E01031302,7,0,19,47,949,1022
E01031308,61,81,83,731,2540,3496
E01031273,10,26,34,42,1214,1326
E01031274,17,19,33,91,1344,1504
E01031275,16,18,41,80,1097,1252
E01031276,11,11,41,76,1403,1542
E01031272,22,30,57,126,1571,1806
E01031285,20,23,33,97,1913,2086
E01031286,9,3,24,69,1358,1463
E01031287,5,6,15,104,1431,1561
E01031288,17,9,24,129,1531,1710
E01031289,20,6,43,58,1398,1525
E01033253,19,15,32,163,1217,1446
E01033256,12,11,41,93,1108,1265
E01031309,8,12,50,107,1549,1726
E01031310,14,8,27,98,1197,1344
E01031311,4,6,30,51,1269,1360
E01031312,15,7,32,64,1074,1192
E01031313,5,6,29,75,1243,1358
E01031314,16,21,11,96,1194,1338
E01031290,8,8,30,83,1537,1666
E01031291,13,18,61,140,1331,1563
E01031292,19,9,30,118,1319,1495
E01031293,15,19,56,139,1450,1679
E01031294,8,13,34,84,1442,1581
E01031295,20,5,17,114,1026,1182
E01031271,16,17,59,79,1578,1749
E01031332,39,28,40,326,965,1398
E01031333,53,23,39,420,818,1353
E01031334,8,11,47,154,1302,1522
E01031335,28,18,31,154,1244,1475
E01031336,18,29,87,181,1828,2143
E01031337,2,13,43,82,1362,1502
E01031321,13,8,20,46,1245,1332
E01031322,0,17,38,88,1719,1862
E01031323,7,13,37,99,1432,1588
E01031324,12,16,33,65,1895,2021
E01031325,2,4,32,68,1296,1402
E01033254,29,9,30,117,1255,1440
E01033255,14,6,42,68,1529,1659
E01031315,64,26,79,347,1685,2201
E01031316,22,8,25,70,1320,1445
E01031317,7,6,19,71,1407,1510
E01031318,40,5,36,433,1406,1920
E01031319,15,16,46,135,1784,1996
E01031320,37,7,32,128,1216,1420
E01031261,29,16,54,201,1247,1547
E01031262,13,20,41,170,1186,1430
E01031263,28,33,73,266,1468,1868
E01031264,9,10,42,159,1479,1699
E01031265,18,23,38,225,1135,1439
E01031266,14,27,73,248,1586,1948
E01031259,2,10,27,183,1148,1370
E01031260,1,2,7,23,1155,1188
E01031267,2,4,7,29,1734,1776
E01031268,0,12,50,72,2598,2732
E01031269,10,3,11,10,1629,1663
E01031327,32,12,26,200,1261,1531
E01031328,40,14,41,284,1829,2208
E01031329,40,12,79,367,2063,2561
E01031330,27,11,18,188,1242,1486
E01031331,28,5,22,185,1546,1786
E01009417,15,27,26,87,1338,1493
E01009418,1,28,42,91,1309,1471
E01009419,12,13,17,87,1193,1322
E01009433,5,45,29,126,1554,1759
E01009415,2,7,33,110,1486,1638
E01009422,4,20,18,68,1802,1912
E01009423,1,44,47,75,1510,1677
E01009425,2,20,26,76,1569,1693
E01009416,25,28,68,219,2329,2669
E01009420,5,19,15,78,1420,1537
E01009426,7,6,10,104,1322,1449
E01009429,10,9,16,71,1391,1497
E01009431,4,11,26,88,1454,1583
E01009421,34,10,14,205,1372,1635
E01009424,5,19,47,79,1370,1520
E01009427,24,22,27,189,1232,1494
E01009428,4,21,23,106,1490,1644
E01009430,24,17,39,124,1427,1631
E01009468,4,12,15,67,1415,1513
E01009445,8,69,71,56,1478,1682
E01009446,9,76,74,161,2112,2432
E01009447,1,31,38,139,1392,1601
E01009448,5,52,33,54,1487,1631
E01009452,10,37,63,88,1459,1657
E01009455,1,47,43,56,1176,1323
E01009432,2,49,47,80,1330,1508
E01009435,17,43,50,162,1554,1826
E01009437,4,50,42,135,1554,1785
E01009444,0,11,23,70,1434,1538
E01009454,3,28,25,48,1407,1511
E01009221,0,46,41,67,1329,1483
E01009464,9,43,22,106,1205,1385
E01009465,4,50,36,176,1115,1381
E01009467,15,81,50,126,1287,1559
E01009220,2,75,63,69,1351,1560
E01009222,4,118,87,49,1318,1576
E01009224,6,81,20,79,1283,1469
E01009233,2,51,65,33,1383,1534
E01009449,2,26,68,108,1625,1829
E01009451,5,27,41,80,1278,1431
E01009453,2,29,43,99,1294,1467
E01009466,7,13,17,49,1546,1632
E01009471,3,20,50,138,1606,1817
E01009135,10,92,39,222,1087,1450
E01009469,21,67,20,231,1098,1437
E01009470,15,22,22,187,1193,1439
E01009472,20,44,48,126,1421,1659
E01009473,13,55,52,187,1288,1595
E01009474,5,37,43,97,1418,1600
E01009127,18,119,83,112,1239,1571
E01009128,6,97,45,52,1174,1374
E01009130,12,82,70,34,1307,1505
E01009131,3,87,53,65,1240,1448
E01009133,2,124,66,56,1244,1492
E01009134,1,148,54,56,1330,1589
E01009137,5,119,97,94,1291,1606
E01009434,6,23,24,81,1433,1567
E01009436,9,27,10,103,1292,1441
E01009438,12,12,20,83,1323,1450
E01009440,2,30,21,83,1444,1580
E01009450,1,18,23,60,1533,1635
E01009223,12,69,44,119,1283,1527
E01009225,5,125,39,124,1347,1640
E01009227,10,145,43,156,1264,1618
E01009228,1,99,48,126,1383,1657
E01009121,19,283,159,250,1595,2306
E01009122,11,122,74,68,1351,1626
E01009129,5,131,66,79,1347,1628
E01009132,10,90,71,54,1335,1560
E01009136,14,138,76,137,1286,1651
E01009457,5,24,31,107,1352,1519
E01009459,4,46,21,128,1450,1649
E01009461,26,28,21,127,1130,1332
E01009463,11,9,29,143,1301,1493
E01009235,28,184,55,287,1053,1607
E01009243,11,160,53,230,1064,1518
E01009245,9,156,70,314,904,1453
E01009246,10,197,56,184,1134,1581
E01009247,16,184,55,258,991,1504
E01009226,5,97,62,74,1248,1486
E01009229,6,112,47,161,1252,1578
E01009230,4,97,41,88,1282,1512
E01009231,7,143,68,201,1460,1879
E01009001,5,114,82,77,1251,1529
E01009003,4,94,55,131,1396,1680
E01009456,5,22,55,50,1558,1690
E01009458,0,63,33,130,1259,1485
E01009460,9,82,46,112,1403,1652
E01009462,2,43,52,100,1483,1680
E01009234,11,139,50,125,1195,1520
E01009236,5,159,65,215,1107,1551
E01009244,7,119,35,167,1108,1436
E01009248,0,151,61,136,1419,1767
E01009403,10,163,94,110,1129,1506
E01009404,2,159,57,122,1212,1552
E01009405,9,141,64,126,1066,1406
E01009406,3,160,96,146,1243,1648
E01009407,22,200,117,174,1204,1717
E01009439,7,26,38,55,1258,1384
E01009441,3,32,46,24,1340,1445
E01009442,8,32,27,88,1317,1472
E01009443,3,22,17,59,1119,1220
E01009123,1,211,90,115,1020,1437
E01009124,28,357,148,87,987,1607
E01009125,21,189,79,307,1161,1757
E01009232,9,186,62,231,1083,1571
E01009002,14,182,116,123,1035,1470
E01009006,8,71,86,79,1278,1522
E01009007,4,165,98,185,1152,1604
E01033632,23,289,160,186,1628,2286
E01009237,18,216,85,390,759,1468
E01009238,22,182,70,475,883,1632
E01009240,23,245,70,415,827,1580
E01009241,15,341,81,620,650,1707
E01009242,28,276,61,812,609,1786
E01009005,10,87,48,81,1110,1336
E01009009,7,93,61,97,1214,1472
E01009098,23,118,104,139,1707,2091
E01009100,21,190,125,222,1506,2064
E01009105,8,76,49,77,1403,1613
E01009126,18,174,49,174,997,1412
E01009408,20,265,115,281,1030,1711
E01009409,3,233,105,180,1120,1641
E01009410,11,263,95,320,1091,1780
E01009008,5,66,55,138,1220,1484
E01009011,17,105,60,170,1408,1760
E01009012,11,91,66,135,1154,1457
E01009102,5,115,52,159,1160,1491
E01009104,6,152,131,176,1120,1585
E01009096,3,97,84,32,1435,1651
E01009097,6,132,136,38,1728,2040
E01009099,19,113,133,20,1492,1777
E01009101,8,85,89,32,1402,1616
E01009103,7,115,105,13,1296,1536
E01009106,11,37,52,14,1237,1351
E01008915,14,230,74,564,492,1374
E01009411,16,273,114,309,1106,1818
E01009412,5,303,106,515,824,1753
E01009413,20,317,115,391,812,1655
E01009414,15,338,149,485,925,1912
E01008998,48,275,109,477,918,1827
E01008999,43,259,97,446,735,1580
E01009000,12,204,121,305,1068,1710
E01009013,18,218,149,205,1312,1902
E01009400,9,226,99,320,798,1452
E01009401,15,314,133,490,716,1668
E01033630,32,222,117,143,625,1139
E01033646,16,229,115,292,972,1624
E01009049,44,381,51,872,283,1631
E01009056,35,564,129,940,358,2026
E01009263,35,388,122,557,527,1629
E01009264,33,276,83,253,770,1415
E01009265,82,225,97,864,484,1752
E01009051,21,286,35,1099,180,1621
E01009053,8,252,52,975,194,1481
E01009054,22,210,40,1269,113,1654
E01009058,23,207,30,1288,120,1668
E01009061,41,206,39,1469,61,1816
E01009239,23,297,92,594,869,1875
E01009266,116,276,99,787,433,1711
E01009269,56,279,88,686,426,1535
E01009270,88,454,150,995,279,1966
E01009271,42,359,61,756,304,1522
E01009273,86,354,75,882,206,1603
E01009050,35,533,67,862,329,1826
E01009057,56,497,107,1167,237,2064
E01009059,28,550,88,948,186,1800
E01009060,38,295,46,1102,116,1597
E01033621,69,715,129,1595,366,2874
E01009268,125,168,37,967,220,1517
E01009272,27,411,107,556,300,1401
E01009274,88,501,116,1200,238,2143
E01009349,54,446,114,774,291,1679
E01009351,43,324,79,1003,244,1693
E01009354,28,345,88,813,197,1471
E01008899,21,340,53,508,315,1237
E01008901,14,425,84,842,321,1686
E01008916,12,192,67,1049,211,1531
E01033636,52,315,57,2763,198,3385
E01009079,21,353,148,131,976,1629
E01009080,9,219,86,187,612,1113
E01009081,49,159,106,207,780,1301
E01009083,14,245,103,279,847,1488
E01009275,41,277,67,992,199,1576
E01009350,15,343,57,958,189,1562
E01009352,63,297,69,1162,124,1715
E01009353,27,251,55,1181,101,1615
E01009355,54,419,74,868,160,1575
E01033635,126,537,140,1783,303,2889
E01008905,5,165,29,1442,60,1701
E01008907,52,440,86,886,211,1675
E01009047,31,363,72,1189,149,1804
E01009048,45,441,75,974,227,1762
E01009062,40,267,68,1270,84,1729
E01008909,34,711,118,492,278,1633
E01033628,37,545,65,1572,211,2430
E01033637,45,713,125,1716,239,2838
E01009084,25,92,56,872,697,1742
E01009085,13,63,65,1371,465,1977
E01009087,3,63,39,398,1011,1514
E01009089,26,52,44,701,704,1527
E01009090,15,100,53,1084,605,1857
E01009201,46,475,144,375,680,1720
E01009202,52,412,135,407,497,1503
E01009203,135,1412,242,379,669,2837
E01009082,30,198,56,251,876,1411
E01009086,20,139,55,931,736,1881
E01009480,30,150,55,840,681,1756
E01009481,7,144,56,1495,587,2289
E01009486,43,141,49,1357,428,2018
E01009487,31,100,46,1619,409,2205
E01009088,12,109,57,180,1252,1610
E01009091,17,105,80,187,1165,1554
E01009305,11,105,141,80,1273,1610
E01009307,11,53,97,55,1313,1529
E01009309,4,66,96,45,1207,1418
E01009304,9,58,74,49,1617,1807
E01009306,1,53,94,51,1351,1550
E01009308,18,121,139,61,1604,1943
E01009310,5,91,99,43,1623,1861
E01009348,46,708,183,395,637,1969
E01009358,76,556,84,1013,324,2053
E01009359,106,461,137,1007,257,1968
E01009360,73,861,191,757,553,2435
E01009361,79,557,192,820,461,2109
E01009478,32,176,105,906,616,1835
E01009479,53,247,88,1524,294,2206
E01009482,49,187,30,1324,131,1721
E01009484,42,192,58,1287,176,1755
E01009485,17,158,45,1415,200,1835
E01008906,12,280,67,1270,151,1780
E01008911,71,886,138,290,224,1609
E01009347,41,765,161,311,488,1766
E01033559,19,130,65,209,840,1263
E01033638,59,691,77,546,377,1750
E01008910,69,725,99,659,260,1812
E01008913,56,728,140,223,334,1481
E01008914,87,987,172,558,911,2715
E01033561,82,533,124,948,1252,2939
E01033617,121,201,100,1427,1113,2962
E01009194,73,322,55,2191,205,2846
E01009483,30,120,46,1568,87,1851
E01009488,37,164,79,1378,505,2163
E01009489,8,201,48,1634,110,2001
E01009491,49,111,41,1430,163,1794
E01009192,24,180,60,2385,100,2749
E01009199,92,317,113,499,394,1415
E01009204,84,732,186,330,461,1793
E01033644,53,316,92,2334,203,2998
E01009151,68,322,115,1146,356,2007
E01009152,61,272,117,1308,405,2163
E01009153,77,494,148,591,837,2147
E01009345,43,647,182,625,880,2377
E01009346,72,296,90,1022,202,1682
E01009092,9,177,121,264,1104,1675
E01009093,18,120,122,124,1219,1603
E01009094,11,144,91,237,951,1434
E01009298,6,109,130,199,1134,1578
E01009311,21,136,113,262,1126,1658
E01009511,8,192,52,361,873,1486
E01009475,53,275,83,1245,416,2072
E01009476,97,192,88,1144,368,1889
E01009477,20,170,105,762,635,1692
E01009490,50,138,79,1045,615,1927
E01009492,20,89,70,1136,439,1754
E01009095,13,122,65,606,894,1700
E01009507,25,140,87,566,733,1551
E01009508,21,119,79,335,994,1548
E01009509,23,147,70,796,711,1747
E01009510,14,128,97,289,1078,1606
E01009297,14,25,65,57,1445,1606
E01009299,5,141,96,138,1257,1637
E01009300,22,148,191,153,1289,1803
E01009301,8,80,87,43,1386,1604
E01009303,7,52,66,24,1330,1479
E01009195,32,232,99,1985,252,2600
E01009197,64,239,61,1060,255,1679
E01009198,72,242,70,1209,168,1761
E01033647,37,120,79,913,249,1398
E01033649,38,159,56,1280,268,1801
E01009138,79,205,60,878,424,1646
E01009139,71,206,53,544,709,1583
E01009140,61,248,109,756,741,1915
E01009145,133,238,101,840,669,1981
E01009147,80,167,64,610,762,1683
E01009512,3,111,71,95,1336,1616
E01009514,4,109,78,216,1103,1510
E01009516,2,47,62,236,1065,1412
E01009517,3,96,74,149,1387,1709
E01009325,39,200,68,1133,357,1797
E01009342,52,118,87,1142,339,1738
E01009343,73,228,98,1016,291,1706
E01033642,163,351,69,2206,316,3105
E01008986,65,266,110,492,868,1801
E01008987,10,240,104,202,984,1540
E01008988,62,233,85,506,1151,2037
E01008989,61,236,120,340,985,1742
E01008990,28,35,61,361,686,1171
E01008991,38,49,40,637,751,1515
E01008882,32,105,105,627,878,1747
E01008896,35,92,91,482,875,1575
E01008898,47,118,79,585,845,1674
E01009326,40,174,75,1194,436,1919
E01009341,58,155,93,793,459,1558
E01009513,21,150,105,578,866,1720
E01008881,13,89,70,491,936,1599
E01008897,26,108,77,534,941,1686
E01009515,12,65,36,370,1081,1564
E01009518,13,44,28,282,1241,1608
E01009521,11,47,51,337,1194,1640
E01009302,6,38,49,16,1398,1507
E01009314,15,49,32,107,1383,1586
E01009321,17,109,94,106,1514,1840
E01009322,8,94,68,117,1099,1386
E01009323,12,52,42,150,1215,1471
E01009329,113,210,64,1866,88,2341
E01009334,72,158,54,1475,130,1889
E01009337,115,150,23,1352,148,1788
E01009338,53,123,44,1217,132,1569
E01009380,99,188,48,1233,132,1700
E01009362,126,476,153,312,249,1316
E01009363,126,189,82,863,294,1554
E01009364,168,421,89,402,258,1338
E01009365,153,306,103,923,234,1719
E01009379,88,418,89,704,370,1669
E01009312,5,35,31,146,1359,1576
E01009324,16,37,35,83,1470,1641
E01009519,7,31,40,78,1363,1519
E01009520,2,55,34,236,1425,1752
E01009066,40,39,54,489,886,1508
E01009070,33,46,53,255,1291,1678
E01009252,45,39,55,356,1043,1538
E01009260,81,12,23,664,755,1535
E01009261,54,85,76,401,991,1607
E01008984,89,198,125,633,1045,2090
E01008994,39,106,97,225,1228,1695
E01008996,229,322,101,604,315,1571
E01008997,48,170,88,407,732,1445
E01009065,17,57,70,254,1318,1716
E01009067,11,23,66,84,1296,1480
E01009068,21,53,73,154,1242,1543
E01009069,19,60,78,112,1295,1564
E01009072,18,42,54,168,1317,1599
E01008885,7,27,38,243,993,1308
E01008886,17,59,73,170,1245,1564
E01008888,13,36,39,197,1373,1658
E01009313,8,25,38,208,1292,1571
E01009368,95,188,46,1030,109,1468
E01009371,107,116,89,1335,130,1777
E01009397,165,167,66,1257,104,1759
E01033650,133,181,47,2083,152,2596
E01008883,37,103,125,623,928,1816
E01008884,30,173,109,775,783,1870
E01008887,14,66,52,307,1039,1478
E01008889,13,98,89,536,1039,1775
E01008982,51,103,82,483,756,1475
E01008992,62,47,86,430,1175,1800
E01009283,44,55,67,288,1022,1476
E01033631,134,143,166,1147,3375,4965
E01009249,16,107,78,138,1247,1586
E01009250,13,73,69,115,1345,1615
E01009251,20,91,51,203,1134,1499
E01009253,12,95,58,173,1202,1540
E01009255,26,129,111,159,1128,1553
E01009257,37,140,102,159,1084,1522
E01009315,25,28,41,97,1403,1594
E01009316,9,47,59,171,1361,1647
E01009317,2,66,67,75,1460,1670
E01009318,2,19,41,75,1396,1533
E01009319,8,32,55,105,1434,1634
E01009320,6,50,19,178,1291,1544
E01009372,88,38,20,1575,101,1822
E01009373,69,88,35,1590,56,1838
E01009396,122,53,46,1842,90,2153
E01033643,125,264,83,2369,254,3095
E01009367,222,156,57,1032,175,1642
E01009375,314,224,48,1175,171,1932
E01009377,257,202,72,645,194,1370
E01009383,43,114,50,991,254,1452
E01009399,194,110,50,1078,158,1590
E01009366,469,174,95,591,252,1581
E01009374,179,241,73,460,194,1147
E01009376,294,237,114,717,312,1674
E01033648,156,296,125,1594,544,2715
E01009073,58,295,182,137,942,1614
E01009074,50,300,160,213,949,1672
E01009254,18,147,90,172,1131,1558
E01009256,15,103,101,193,1153,1565
E01009258,26,150,99,111,1140,1526
E01009071,13,59,59,209,1275,1615
E01009075,26,152,87,328,1041,1634
E01009078,41,107,78,329,878,1433
E01033562,78,149,122,663,1492,2504
E01009183,48,32,39,696,789,1604
E01009186,40,72,77,435,1077,1701
E01033645,505,335,103,1949,593,3485
E01008890,46,102,83,449,1054,1734
E01008891,16,38,44,146,1316,1560
E01008892,11,115,117,583,701,1527
E01008893,18,60,45,346,1247,1716
E01008894,16,89,42,245,1020,1412
E01008895,15,67,79,244,1417,1822
E01009015,26,92,60,369,1189,1736
E01009014,55,142,98,973,755,2023
E01009018,21,51,91,382,1128,1673
E01009026,26,70,81,540,861,1578
E01009028,45,54,86,640,965,1790
E01009029,26,61,80,560,821,1548
E01009182,121,202,107,578,616,1624
E01009184,42,77,110,238,1139,1606
E01009187,44,51,76,189,1212,1572
E01009188,20,44,98,260,1101,1523
E01009384,72,202,118,266,676,1334
E01009385,20,97,77,322,781,1297
E01009185,23,68,45,425,1073,1634
E01009389,41,62,42,1335,281,1761
E01009390,53,77,97,555,782,1564
E01009394,76,52,51,805,746,1730
E01008918,13,169,136,145,1263,1726
E01008920,4,96,45,55,1189,1389
E01008921,11,79,53,55,1228,1426
E01008931,10,174,101,126,1028,1439
E01009259,22,210,119,108,1148,1607
E01008919,21,118,56,234,1148,1577
E01009064,17,125,64,197,1074,1477
E01009077,56,111,83,299,1157,1706
E01009291,21,77,106,146,1187,1537
E01009500,24,132,102,101,1177,1536
E01009284,69,147,87,710,1274,2287
E01009286,30,56,106,223,1797,2212
E01009289,34,58,86,271,1648,2097
E01009290,34,37,75,235,1619,2000
E01033634,61,120,149,951,2773,4054
E01009017,49,63,66,1132,359,1669
E01009043,67,83,76,1085,660,1971
E01009044,53,43,40,1159,329,1624
E01009045,35,85,61,925,606,1712
E01009046,43,30,61,784,882,1800
E01009395,45,130,72,990,444,1681
E01009016,9,56,73,334,1087,1559
E01009022,18,116,62,563,990,1749
E01009023,15,69,34,656,899,1673
E01009030,40,40,42,740,613,1475
E01009281,21,50,59,72,1227,1429
E01009292,53,85,47,285,1178,1648
E01009294,27,114,84,167,1445,1837
E01009295,41,111,68,358,1192,1770
E01009280,6,46,59,170,1036,1317
E01009282,13,99,80,234,1222,1648
E01009288,20,46,36,242,890,1234
E01009293,15,46,80,308,1067,1516
E01009296,17,101,68,297,1016,1499
E01008924,13,47,61,70,1236,1427
E01009501,33,81,78,99,1273,1564
E01009502,15,63,84,79,1267,1508
E01009503,15,62,109,100,1255,1541
E01009505,28,97,81,104,1352,1662
E01008917,7,80,51,49,1148,1335
E01008923,6,107,98,21,1115,1347
E01008925,5,37,33,34,1192,1301
E01008927,10,114,99,18,1149,1390
E01008928,16,110,96,56,1207,1485
E01009019,27,108,108,333,1035,1611
E01009020,22,61,70,355,1003,1511
E01009021,9,81,77,271,1182,1620
E01009024,8,93,108,286,1128,1623
E01009025,26,82,66,299,1041,1514
E01009033,14,86,112,484,1074,1770
E01009175,6,46,96,217,1105,1470
E01009177,15,62,62,314,1125,1578
E01009178,15,55,98,254,1172,1594
E01009179,18,58,49,432,1163,1720
E01009189,16,66,71,301,1042,1496
E01008933,28,68,84,558,818,1556
E01008934,33,44,49,540,739,1405
E01009031,29,35,44,637,910,1655
E01009037,22,20,48,336,1194,1620
E01009176,39,49,108,631,823,1650
E01008929,12,101,88,73,1205,1479
E01008930,19,131,88,70,1190,1498
E01009495,19,72,66,41,1027,1225
E01033629,24,185,150,66,2168,2593
E01008953,32,115,67,254,1096,1564
E01008963,3,53,81,174,1060,1371
E01008964,17,55,64,185,1152,1473
E01008965,12,36,58,226,1197,1529
E01008966,27,123,62,358,1118,1688
E01009032,10,20,50,838,876,1794
E01009034,62,35,33,762,799,1691
E01009035,32,40,60,748,932,1812
E01009036,39,18,40,632,785,1514
E01009494,29,106,136,121,1234,1626
E01009496,28,42,39,90,1282,1481
E01009497,12,110,70,166,1409,1767
E01009504,30,31,21,122,1267,1471
E01009506,39,36,47,153,1219,1494
E01008967,22,70,76,344,1175,1687
E01008968,7,49,84,203,1364,1707
E01008970,17,121,76,306,1021,1541
E01008981,11,34,49,256,1188,1538
E01008932,12,73,70,258,1131,1544
E01008935,17,96,101,295,1166,1675
E01008936,23,37,57,435,1016,1568
E01008938,26,86,72,273,1136,1593
E01008939,10,89,75,223,1146,1543
E01008951,10,36,54,43,1284,1427
E01008952,6,53,61,194,1281,1595
E01008955,3,43,51,84,1352,1533
E01008956,11,18,61,37,1386,1513
E01008957,13,130,82,118,1315,1658
E01008950,9,38,51,79,1254,1431
E01008954,27,23,46,72,1189,1357
E01008958,16,43,88,41,1366,1554
E01009493,82,150,90,320,828,1470
E01008937,30,63,63,289,981,1426
E01008940,10,95,96,132,1205,1538
E01008941,13,46,92,231,1140,1522
E01008944,5,84,76,92,1459,1716
E01008959,14,51,72,56,1566,1759
E01008960,15,39,44,67,1441,1606
E01008961,8,48,50,78,1311,1495
E01008962,10,234,101,74,1488,1907
E01008942,19,46,75,91,1368,1599
E01008943,8,110,76,110,1154,1458
E01008969,15,46,63,206,1316,1646
E01008971,24,80,92,238,1257,1691
E01008972,26,145,129,148,1342,1790
E01008973,26,95,89,151,1545,1906
E01008974,36,125,166,393,2161,2881
E01008975,12,37,45,48,1407,1549
E01009172,9,76,76,84,1175,1420
E01009173,24,125,92,98,1394,1733
E01009174,5,53,80,43,1074,1255
E01009498,7,77,88,72,1392,1636
E01009499,7,110,75,227,1321,1740
E01009205,16,26,48,49,1392,1531
E01009206,6,24,72,88,1434,1624
E01009211,4,23,39,38,1338,1442
E01009218,4,24,39,77,1383,1527
E01009219,13,84,96,44,1327,1564
E01008976,35,124,66,82,1234,1541
E01008978,30,151,144,54,1014,1393
E01008979,9,106,70,32,1388,1605
E01008980,15,156,92,29,1334,1626
E01008945,6,63,78,169,1519,1835
E01008946,9,31,49,57,1339,1485
E01008947,5,41,48,62,1236,1392
E01008948,9,16,15,63,1356,1459
E01008949,6,8,29,19,1200,1262
E01008977,10,70,76,54,1364,1574
E01009109,14,133,136,50,1035,1368
E01009119,15,37,39,45,1303,1439
E01009120,6,41,73,45,1273,1438
E01009162,5,65,66,48,1418,1602
E01009207,12,45,40,32,1530,1659
E01009208,5,24,43,31,1428,1531
E01009209,14,72,88,68,1886,2128
E01009213,3,48,46,61,1328,1486
E01009155,10,56,68,23,1199,1356
E01009157,8,83,93,48,1278,1510
E01009160,15,107,81,26,1357,1586
E01009161,2,47,68,17,1278,1412
E01033633,7,133,139,35,2039,2353
E01009117,34,216,165,101,1544,2060
E01009210,14,127,81,74,1559,1855
E01009212,0,54,67,68,1489,1678
E01009214,4,72,119,26,1431,1652
E01009215,12,120,77,28,1413,1650
E01009108,8,33,44,45,1211,1341
E01009111,3,40,50,20,1274,1387
E01009112,6,52,67,36,1347,1508
E01009116,16,16,28,80,1286,1426
E01009118,6,71,76,52,1264,1469
E01009107,33,184,151,72,1301,1741
E01009110,11,91,89,48,1326,1565
E01009113,1,119,82,62,1254,1518
E01009114,24,90,90,35,1332,1571
E01009115,16,54,97,36,1214,1417
E01009158,3,109,110,65,1610,1897
E01009163,9,70,61,21,1291,1452
E01009165,1,55,64,36,1196,1352
E01009169,4,49,35,20,1572,1680
E01009159,5,51,45,71,1603,1775
E01009164,7,39,74,16,1348,1484
E01009167,1,29,60,26,1434,1550
E01009171,0,52,65,7,1473,1597
E01009166,11,46,60,54,1148,1319
E01009168,5,25,32,18,1409,1489
E01009170,0,11,23,7,1442,1483
E01009216,11,76,76,36,1792,1991
E01009217,2,14,30,20,1564,1630
E01009039,32,42,53,468,1110,1705
E01009040,20,27,48,433,1219,1747
E01009041,18,21,43,379,1200,1661
E01009042,7,21,31,158,1162,1379
E01032589,19,34,21,488,849,1411
E01009262,101,174,45,1066,370,1756
E01009267,136,132,31,1070,387,1756
E01009276,59,204,45,939,371,1618
E01009278,47,234,62,1011,375,1729
E01009279,61,190,54,916,307,1528
E01032591,96,140,39,1073,297,1645
E01008995,90,491,148,343,744,1816
E01033557,72,114,94,573,1206,2059
E01033624,59,189,106,194,485,1033
E01033626,69,195,95,272,438,1069
E01033640,69,479,148,225,375,1296
E01009378,143,359,137,527,899,2065
E01033567,34,66,52,542,478,1172
E01033615,50,58,56,348,507,1019
E01033616,46,201,68,187,510,1012
E01009143,65,525,130,202,497,1419
E01009146,91,406,162,402,862,1923
E01033564,84,119,55,389,584,1231
E01033639,57,566,173,335,672,1803
E01009141,69,752,132,188,619,1760
E01033565,10,58,35,207,711,1021
E01033618,38,34,48,310,761,1191
E01033619,7,171,66,215,675,1134
E01033627,35,228,96,199,520,1078
E01033620,49,70,37,413,451,1020
E01033622,59,107,104,440,1003,1713
E01033623,35,159,67,204,655,1120
E01033625,120,71,61,584,858,1694
E01009200,83,430,114,726,359,1712
E01009327,116,192,35,1187,103,1633
E01009328,96,190,41,1947,92,2366
E01009331,77,239,58,1613,158,2145
E01009332,121,246,113,801,425,1706
E01009333,47,158,69,1238,142,1654
E01009335,115,148,27,1452,140,1882
E01009344,72,293,67,1037,146,1615
E01009339,102,134,40,1039,206,1521
E01009340,61,151,105,1394,997,2708
E01009382,70,73,25,1538,130,1836
E01009391,19,92,45,1268,198,1622
E01009392,60,44,37,1430,203,1774
E01009393,37,76,57,1287,188,1645
E01033641,96,185,101,2454,460,3296
E01009589,11,48,51,225,1090,1425
E01032536,24,58,54,344,1417,1897
E01032537,5,55,51,379,1460,1950
E01032538,7,60,111,344,1658,2180
E01009590,16,13,12,75,1272,1388
E01009591,18,46,45,211,1220,1540
E01009593,33,41,28,357,1195,1654
E01009598,50,20,16,422,1111,1619
E01009604,26,50,75,352,956,1459
E01009605,5,130,63,86,1215,1499
E01009607,18,168,75,72,1162,1495
E01009608,13,87,58,218,1205,1581
E01009610,18,59,42,168,1177,1464
E01009564,49,186,65,636,721,1657
E01009575,34,72,60,487,657,1310
E01009606,46,79,45,350,958,1478
E01009609,56,99,43,431,960,1589
E01009524,21,18,27,66,1372,1504
E01009525,50,34,23,295,1033,1435
E01009527,7,33,45,90,1435,1610
E01009594,22,21,33,95,1206,1377
E01009577,9,217,65,47,955,1293
E01009579,21,273,67,61,1259,1681
E01009581,13,206,79,59,1212,1569
E01009584,10,88,34,33,1257,1422
E01009585,12,206,55,21,768,1062
E01009709,1,327,60,22,655,1065
E01009576,6,71,37,113,1348,1575
E01009578,17,25,37,248,1098,1425
E01009582,15,103,35,144,1443,1740
E01009583,15,75,37,350,1131,1608
E01009586,6,55,20,76,1514,1671
E01009565,87,181,22,1257,168,1715
E01009566,99,262,55,539,626,1581
E01009567,89,183,52,1017,497,1838
E01009568,79,148,59,1182,320,1788
E01009523,10,1,19,33,1469,1532
E01009526,7,8,12,62,1526,1615
E01009528,3,11,26,58,1497,1595
E01009531,15,8,15,36,1465,1539
E01009587,39,86,48,469,893,1535
E01009624,40,67,42,387,1092,1628
E01009625,70,109,80,754,1333,2346
E01009626,17,70,28,437,1086,1638
E01009622,8,46,84,156,1488,1782
E01009623,22,60,59,256,1126,1523
E01009627,33,58,38,279,1153,1561
E01009628,15,68,31,264,1133,1511
E01009599,4,66,28,74,1068,1240
E01009663,18,88,16,207,1109,1438
E01009710,13,38,25,160,1157,1393
E01009711,11,38,44,124,1194,1411
E01009522,7,37,29,149,1212,1434
E01009529,4,45,25,98,1369,1541
E01009530,5,11,11,43,1315,1385
E01009645,11,42,37,129,1255,1474
E01009569,70,137,64,552,486,1309
E01009570,100,169,49,1054,430,1802
E01009571,76,220,59,689,579,1623
E01009572,84,345,95,797,855,2176
E01009573,84,120,29,934,377,1544
E01009574,82,172,85,842,419,1600
E01009655,44,117,70,248,1374,1853
E01009656,30,118,57,207,1192,1604
E01009659,35,217,63,265,1144,1724
E01009662,69,80,39,568,684,1440
E01009664,28,71,72,190,1150,1511
E01009643,8,16,23,107,1345,1499
E01009644,13,14,21,130,1479,1657
E01009647,18,75,47,298,1313,1751
E01009648,5,24,22,153,1341,1545
E01009652,12,15,18,83,1318,1446
E01009653,6,15,31,79,1443,1574
E01009613,2,46,18,182,1061,1309
E01009657,9,47,29,271,1316,1672
E01009712,21,64,29,246,1237,1597
E01009714,29,39,33,159,1279,1539
E01009716,24,54,38,235,1392,1743
E01009580,23,37,32,185,936,1213
E01009713,15,42,40,142,1158,1397
E01009715,23,66,49,338,901,1377
E01009717,21,60,19,282,1076,1458
E01009718,45,159,55,105,1323,1687
E01009629,85,212,108,886,1467,2758
E01009630,18,107,61,242,1257,1685
E01009631,19,87,54,114,1055,1329
E01009632,42,175,51,224,1150,1642
E01009650,34,121,55,188,1202,1600
E01009614,11,48,28,226,1144,1457
E01009654,20,45,65,208,1426,1764
E01009658,53,41,15,349,1051,1509
E01009660,55,113,31,701,873,1773
E01009646,13,2,32,102,1375,1524
E01009692,2,3,18,42,1209,1274
E01009693,6,9,12,66,1407,1500
E01009694,1,5,16,68,1338,1428
E01009695,0,3,23,31,1489,1546
E01009696,7,16,12,40,1441,1516
E01009704,12,5,20,58,1380,1475
E01009705,2,8,20,63,1366,1459
E01009636,80,438,76,524,1152,2270
E01009637,84,187,75,845,297,1488
E01009638,62,452,85,396,508,1503
E01009639,93,214,52,1077,310,1746
E01009640,63,324,92,566,826,1871
E01009641,97,438,105,542,1693,2875
E01009697,5,8,12,21,1408,1454
E01009698,4,6,11,54,1451,1526
E01009703,10,60,54,162,2305,2591
E01009706,1,15,10,28,1437,1491
E01009649,17,41,28,149,1183,1418
E01009684,9,37,33,64,1262,1405
E01009685,3,37,24,73,1505,1642
E01009686,10,23,22,125,1494,1674
E01009687,18,51,43,106,1189,1407
E01009615,43,126,52,271,1286,1778
E01009616,31,77,40,256,1155,1559
E01009617,19,57,42,195,959,1272
E01009618,7,29,32,168,1290,1526
E01009620,7,46,26,131,1256,1466
E01009621,12,126,37,111,1080,1366
E01009633,40,286,45,327,1083,1781
E01009634,21,182,42,344,1052,1641
E01009635,87,357,118,746,1899,3207
E01009661,40,166,57,399,1162,1824
E01009674,16,35,29,42,1468,1590
E01009699,4,29,22,28,1347,1430
E01009700,13,93,42,27,1439,1614
E01009701,9,28,22,24,1436,1519
E01009702,18,131,34,37,1224,1444
E01009688,31,89,52,258,1049,1479
E01009689,13,66,39,167,1190,1475
E01009690,14,46,27,251,1133,1471
E01009691,2,54,32,180,1092,1360
E01009548,146,134,69,432,1492,2273
E01009553,34,150,52,412,1451,2099
E01009642,252,295,112,563,1544,2766
E01009651,27,288,79,109,1145,1648
E01009676,2,39,23,72,1346,1482
E01009681,6,12,24,50,1194,1286
E01009682,8,21,12,88,1402,1531
E01009683,0,73,30,61,1190,1354
E01009532,11,23,15,61,1228,1338
E01009535,10,12,14,122,1172,1330
E01009536,8,13,14,156,1281,1472
E01009543,23,15,21,505,1197,1761
E01009707,13,29,42,243,1542,1869
E01009708,12,50,23,236,1165,1486
E01009554,10,15,31,116,1149,1321
E01009555,12,12,13,102,1313,1452
E01009556,7,29,36,101,1349,1522
E01009557,21,8,14,161,1125,1329
E01009558,22,32,41,105,1290,1490
E01009559,4,29,33,199,1136,1401
E01009537,3,117,29,90,1255,1494
E01009538,8,82,43,51,1263,1447
E01009611,11,505,68,183,1371,2138
E01009612,15,268,52,103,964,1402
E01032527,3,130,36,45,1357,1571
E01032528,2,229,37,78,1175,1521
E01009679,21,79,25,150,1188,1463
E01032531,18,109,76,110,2287,2600
E01032532,15,3,23,63,1216,1320
E01032533,49,59,62,587,1100,1857
E01009549,36,58,45,347,1133,1619
E01009550,38,64,39,297,1416,1854
E01009552,25,47,48,317,1158,1595
E01032534,26,117,63,416,1284,1906
E01032535,21,21,23,146,974,1185
E01009544,6,74,25,207,1231,1543
E01009619,48,226,53,250,1308,1885
E01032529,6,27,14,59,1132,1238
E01032530,13,20,30,55,1731,1849
E01009539,5,154,49,15,1364,1587
E01009540,10,426,41,44,1405,1926
E01009541,14,85,37,33,1363,1532
E01009542,5,168,51,66,1484,1774
E01009560,40,7,15,360,1117,1539
E01009561,6,23,37,199,1322,1587
E01009562,23,23,32,404,1160,1642
E01009563,50,16,19,344,1243,1672
E01009672,58,18,28,479,1503,2086
E01009666,39,17,20,206,1028,1310
E01009667,49,1,18,422,866,1356
E01009668,9,19,26,263,1326,1643
E01009670,25,5,23,297,1314,1664
E01009665,36,10,25,257,860,1188
E01009669,24,10,37,270,947,1288
E01009671,51,88,115,1557,2437,4248
E01033058,43,74,66,591,1900,2674
E01009588,31,62,60,177,1208,1538
E01009592,32,88,79,275,1159,1633
E01009596,23,107,66,456,872,1524
E01009597,58,94,64,510,1062,1788
E01032587,17,108,81,235,1306,1747
E01009763,13,61,54,62,1667,1857
E01009764,0,13,10,42,1360,1425
E01009767,0,8,20,34,1406,1468
E01009769,0,43,52,35,1449,1579
E01009770,6,27,28,79,1313,1453
E01009773,0,10,16,5,1512,1543
E01009777,6,21,27,24,1373,1451
E01009778,1,16,14,18,1501,1550
E01009895,0,16,23,22,1346,1407
E01009896,3,4,23,22,1434,1486
E01009897,0,3,5,25,1422,1455
E01009898,1,1,12,18,1445,1477
E01009901,0,12,15,57,1313,1397
E01009902,0,11,16,36,1206,1269
E01009765,1,15,25,59,1504,1604
E01009766,0,33,14,49,1488,1584
E01009768,0,19,22,49,1297,1387
E01009771,0,6,12,20,1354,1392
E01009775,5,25,44,71,1455,1600
E01009776,1,21,8,33,1471,1534
E01009758,5,45,65,37,1551,1703
E01009760,4,32,27,30,1224,1317
E01009772,0,24,39,13,1267,1343
E01009774,0,16,27,24,1510,1577
E01009788,11,25,21,12,1509,1578
E01009756,16,67,41,66,1221,1411
E01009757,4,66,41,135,1406,1652
E01009759,3,12,20,70,1186,1291
E01009762,8,52,67,74,1197,1398
E01033187,8,104,132,85,2009,2338
E01009781,2,34,27,23,1813,1899
E01009786,4,29,45,35,1384,1497
E01009789,0,3,6,3,1447,1459
E01009790,0,16,22,21,1486,1545
E01009779,1,3,12,5,1338,1359
E01009782,4,9,41,9,1494,1557
E01009783,2,6,16,22,1421,1467
E01009785,0,2,12,8,1426,1448
E01009899,0,0,4,0,1432,1436
E01009900,1,3,16,0,1444,1464
E01009780,8,32,27,201,1803,2071
E01009784,15,17,33,87,1517,1669
E01009787,6,7,7,102,1449,1571
E01009880,6,41,56,236,1264,1603
E01009882,8,69,33,225,1080,1415
E01009891,5,132,101,449,1042,1729
E01009892,9,112,74,462,851,1508
E01009893,33,139,92,479,973,1716
E01009894,12,69,55,321,1300,1757
E01009844,9,127,68,458,837,1499
E01009879,7,111,56,431,1444,2049
E01009881,24,231,60,354,1408,2077
E01009885,10,138,63,405,945,1561
E01009816,1,5,15,17,1435,1473
E01009817,1,10,14,27,1231,1283
E01009819,2,8,21,23,1506,1560
E01009820,3,8,13,12,1512,1548
E01009748,15,37,33,87,1464,1636
E01009839,17,55,49,292,1233,1646
E01009883,10,39,32,63,1224,1368
E01009884,14,55,56,206,1217,1548
E01009886,4,28,33,67,1460,1592
E01009814,1,2,9,2,1315,1329
E01009815,1,3,11,13,1297,1325
E01009818,0,0,9,9,1121,1139
E01009821,1,2,9,11,1377,1400
E01009822,3,9,18,14,1460,1504
E01009887,21,88,79,394,1201,1783
E01009888,4,26,52,202,1331,1615
E01009889,19,167,81,766,805,1838
E01009890,21,87,44,264,1277,1693
E01009749,2,4,19,63,1366,1454
E01009750,0,5,28,47,1441,1521
E01009823,2,3,9,42,1345,1401
E01009824,1,11,33,23,1580,1648
E01009751,2,29,26,50,1391,1498
E01009752,4,12,27,29,1432,1504
E01009753,5,2,52,41,1478,1578
E01009754,9,20,39,102,1471,1641
E01009841,14,53,77,99,1362,1605
E01009840,7,88,80,562,698,1435
E01009842,9,94,44,238,1452,1837
E01009843,3,41,53,55,1417,1569
E01009871,4,37,48,99,1656,1844
E01009875,8,23,44,64,1455,1594
E01009825,4,3,6,37,1385,1435
E01009826,6,3,16,17,1427,1469
E01009827,3,10,9,14,1564,1600
E01009828,8,3,22,13,1332,1378
E01009829,0,1,8,32,1506,1547
E01009830,1,4,20,14,1568,1607
E01009872,0,31,36,138,1294,1499
E01009873,1,16,35,75,1382,1509
E01009874,4,31,46,66,1468,1615
E01009876,10,26,49,100,1483,1668
E01009877,2,15,68,58,1423,1566
E01009911,4,2,8,12,1328,1354
E01009912,1,11,21,33,1642,1708
E01009913,9,3,22,23,1487,1544
E01009914,2,1,5,4,1417,1429
E01009915,5,8,16,21,1671,1721
E01009916,1,9,15,6,1664,1695
E01009741,12,74,55,158,1992,2291
E01009744,3,50,37,194,1587,1871
E01009746,14,22,26,465,1134,1661
E01009747,2,9,19,84,1378,1492
E01009731,0,18,23,47,1478,1566
E01009740,5,16,35,33,1593,1682
E01009742,0,10,38,15,1505,1568
E01009743,1,16,45,30,1703,1795
E01009745,2,0,29,18,1664,1713
E01009917,0,1,11,9,1245,1266
E01009918,1,4,15,20,1384,1424
E01009919,5,4,6,5,1220,1240
E01009920,0,4,15,11,1379,1409
E01009864,3,20,16,65,1532,1636
E01009865,10,7,20,43,1411,1491
E01009866,1,22,27,48,1554,1652
E01009867,0,3,14,76,1641,1734
E01009878,5,20,33,40,1925,2023
E01009791,18,21,18,173,1279,1509
E01009792,43,33,38,239,1230,1583
E01009795,26,19,44,291,1277,1657
E01009796,13,23,25,195,1254,1510
E01009798,3,22,39,166,1472,1702
E01009719,1,9,22,51,1360,1443
E01009722,7,1,9,20,1333,1370
E01009727,0,2,9,41,1301,1353
E01009728,0,15,19,21,1296,1351
E01009729,0,3,35,31,1501,1570
E01009720,3,4,16,41,1352,1416
E01009723,8,2,11,37,1200,1258
E01009724,0,3,4,7,1483,1497
E01009730,2,1,15,30,1440,1488
E01009903,0,0,4,0,1454,1458
E01009904,0,1,19,18,1409,1447
E01009909,3,5,18,12,1324,1362
E01009910,1,10,29,12,1527,1579
E01009793,8,18,43,129,1189,1387
E01009794,10,32,28,154,1253,1477
E01009797,20,27,31,136,1134,1348
E01009801,5,23,17,120,1499,1664
E01009721,4,12,23,72,1787,1898
E01009725,9,22,30,86,1292,1439
E01009726,0,1,7,49,1275,1332
E01009834,2,9,32,156,1406,1605
E01009833,2,14,20,637,719,1392
E01009835,20,12,29,481,1021,1563
E01009869,16,33,16,37,1488,1590
E01009870,1,17,13,13,1416,1460
E01009809,87,20,60,83,1378,1628
E01009813,81,12,44,79,1384,1600
E01009861,74,13,45,71,1346,1549
E01009862,41,13,49,78,1578,1759
E01009863,55,26,50,55,1658,1844
E01009868,53,14,32,103,1358,1560
E01009734,47,21,25,33,1402,1528
E01009735,0,8,10,18,1459,1495
E01009736,13,3,8,29,1342,1395
E01009737,17,18,25,32,1387,1479
E01009738,74,8,18,59,1399,1558
E01009856,19,6,18,160,1780,1983
E01009905,0,1,12,16,1360,1389
E01009906,1,11,18,35,1556,1621
E01009907,1,6,27,31,1403,1468
E01009908,11,4,16,14,1607,1652
E01009800,3,36,50,103,1375,1567
E01009802,7,24,17,81,1490,1619
E01009803,8,1,14,123,1485,1631
E01009804,3,13,17,82,1213,1328
E01009831,1,9,28,79,1352,1469
E01009836,26,48,31,546,1183,1834
E01009837,22,6,14,451,1111,1604
E01009838,4,8,16,97,1543,1668
E01009847,4,2,9,1,1449,1465
E01009848,6,3,19,23,1379,1430
E01009849,3,7,27,3,1501,1541
E01009851,0,5,16,6,1411,1438
E01009732,108,28,40,74,1494,1744
E01009733,193,88,50,101,1347,1779
E01009739,38,12,35,37,1415,1537
E01009799,5,1,11,40,1440,1497
E01009805,11,10,18,50,1313,1402
E01009806,11,11,33,28,1368,1451
E01009854,9,2,11,65,1446,1533
E01009857,0,1,33,198,1381,1613
E01009858,0,35,40,85,1405,1565
E01009859,6,8,28,77,1497,1616
E01009845,7,4,11,55,1444,1521
E01009846,4,1,13,14,1441,1473
E01009850,0,1,14,17,1448,1480
E01009852,2,4,30,60,1397,1493
E01009832,2,8,28,54,1558,1650
E01009853,1,3,8,18,1357,1387
E01009855,4,8,10,151,1459,1632
E01009860,5,2,7,72,1447,1533
E01009807,6,4,12,24,1755,1801
E01009808,0,7,14,28,1403,1452
E01009810,31,7,12,49,1642,1741
E01009811,2,15,36,11,1472,1536
E01009812,21,5,17,39,1448,1530
E01010085,1,25,32,122,1426,1606
E01010086,8,49,56,204,1425,1742
E01010087,0,19,43,193,1463,1718
E01010088,0,12,28,248,1259,1547
E01010089,8,33,46,254,1526,1867
E01009969,45,125,79,471,1224,1944
E01009970,3,41,17,90,1347,1498
E01009971,16,88,77,124,1312,1617
E01009973,108,153,58,1361,759,2439
E01009960,7,22,25,61,1470,1585
E01009961,0,6,13,61,1158,1238
E01009966,13,12,41,92,1059,1217
E01009967,4,84,36,171,1512,1807
E01010092,7,55,57,265,1523,1907
E01009962,1,50,32,23,1230,1336
E01009963,4,37,45,58,1203,1347
E01009964,1,40,37,51,1395,1524
E01009965,1,44,43,31,1300,1419
E01010090,6,76,58,228,1336,1704
E01010091,3,19,34,261,1199,1516
E01010096,6,16,35,103,1319,1479
E01010097,3,45,14,188,1516,1766
E01009968,47,63,20,353,988,1471
E01009972,26,53,35,348,1355,1817
E01009974,36,63,23,375,995,1492
E01009975,28,56,36,327,1193,1640
E01010030,3,45,45,45,1367,1505
E01010034,3,14,21,79,1291,1408
E01010035,14,22,15,55,1262,1368
E01010036,4,97,49,61,1440,1651
E01009982,7,23,35,143,1353,1561
E01009983,9,34,27,27,1363,1460
E01010029,4,41,28,13,1313,1399
E01010037,0,45,29,22,1001,1097
E01009991,33,223,130,447,1371,2204
E01009994,6,74,56,97,1312,1545
E01009995,8,78,45,99,1392,1622
E01009996,3,70,59,87,1360,1579
E01009997,12,136,79,299,1208,1734
E01009998,18,148,102,273,1425,1966
E01010008,27,160,59,372,970,1588
E01010010,10,204,78,213,837,1342
E01010011,16,73,38,260,1258,1645
E01010012,6,61,27,185,1121,1400
E01010007,36,176,46,340,683,1281
E01010009,1,146,48,250,978,1423
E01010013,8,65,24,289,861,1247
E01010014,17,147,28,269,1171,1632
E01010093,22,93,40,204,736,1095
E01010094,59,112,27,606,661,1465
E01010095,12,77,48,117,1128,1382
E01010098,15,75,50,148,1424,1712
E01010099,3,92,43,159,1339,1636
E01010100,67,145,41,666,844,1763
E01009978,0,28,19,54,1635,1736
E01010031,3,56,31,29,1447,1566
E01010032,7,42,61,20,1318,1448
E01010033,1,55,30,45,1408,1539
E01010074,9,105,67,181,1973,2335
E01010066,16,45,39,329,1069,1498
E01010067,21,61,38,618,790,1528
E01010068,8,60,35,195,1338,1636
E01010070,10,57,37,116,1369,1589
E01010075,39,46,28,617,728,1458
E01010076,3,49,23,101,1111,1287
E01009976,53,104,74,558,1721,2510
E01009977,17,85,50,225,1386,1763
E01009979,1,80,50,154,1276,1561
E01009980,32,144,66,501,1540,2283
E01010069,47,171,53,709,852,1832
E01010071,21,102,29,437,1139,1728
E01009947,34,90,90,372,1351,1937
E01009992,20,108,56,513,1004,1701
E01009993,23,171,92,367,1223,1876
E01010103,29,167,80,467,1148,1891
E01010104,30,90,62,309,1154,1645
E01010105,88,130,24,862,379,1483
E01009981,21,77,41,216,1442,1797
E01009985,32,88,65,438,1096,1719
E01032887,92,182,96,944,1443,2757
E01009986,72,74,36,629,556,1367
E01009987,80,105,44,280,724,1233
E01009989,45,125,49,446,980,1645
E01010106,83,143,22,811,498,1557
E01009988,38,170,94,326,1150,1778
E01010101,65,176,65,525,1052,1883
E01010102,58,152,79,770,695,1754
E01010107,40,268,120,810,513,1751
E01010015,46,139,43,621,837,1686
E01010016,23,95,59,546,903,1626
E01010018,35,266,78,384,1305,2068
E01010072,43,158,99,592,1398,2290
E01010073,39,170,72,340,881,1502
E01010077,6,54,51,49,1371,1531
E01010079,10,24,26,106,1357,1523
E01010080,17,165,85,124,1402,1793
E01010081,2,32,24,64,1395,1517
E01010082,24,116,59,330,1774,2303
E01010083,9,81,40,79,1495,1704
E01010084,12,101,72,72,1342,1599
E01010046,41,156,72,1470,328,2067
E01010047,90,119,53,1162,448,1872
E01010048,99,119,39,1128,293,1678
E01010049,117,138,42,937,390,1624
E01010050,102,96,38,929,356,1521
E01010052,16,121,44,732,497,1410
E01010053,83,292,90,948,561,1974
E01010017,32,129,94,592,1048,1895
E01010019,30,100,47,866,686,1729
E01010020,41,133,94,651,968,1887
E01010021,44,151,69,592,844,1700
E01010039,1,29,37,76,1231,1374
E01010043,0,9,18,100,1337,1464
E01010044,0,38,37,36,1284,1395
E01010078,9,22,34,83,1127,1275
E01010059,70,316,96,1048,396,1926
E01010061,66,215,64,1209,274,1828
E01010062,83,332,109,575,495,1594
E01010063,97,724,158,549,617,2145
E01010064,44,408,114,763,471,1800
E01010065,93,552,117,1265,663,2690
E01009934,13,110,57,170,1105,1455
E01009935,31,141,75,171,1498,1916
E01009936,14,36,23,101,1464,1638
E01010004,13,109,46,122,1268,1558
E01010054,54,353,137,576,786,1906
E01010055,68,139,102,576,812,1697
E01010056,28,107,89,420,956,1600
E01010057,98,228,61,995,583,1965
E01010060,124,226,77,959,586,1972
E01010038,4,52,57,64,1612,1789
E01010040,1,32,19,49,1328,1429
E01010041,8,46,35,54,1547,1690
E01010045,1,35,34,54,1475,1599
E01010000,26,47,41,219,1239,1572
E01010002,15,155,101,335,1506,2112
E01010003,5,90,62,191,1151,1499
E01010005,23,88,57,465,877,1510
E01010006,27,63,45,252,1266,1653
E01009938,8,92,87,124,1392,1703
E01009943,51,110,82,291,937,1471
E01009944,35,83,97,243,1045,1503
E01010051,55,82,67,419,609,1232
E01010058,6,119,79,255,1182,1641
E01009937,5,60,86,87,1352,1590
E01009939,32,70,65,249,1345,1761
E01009940,3,58,73,99,1256,1489
E01009941,11,71,64,420,972,1538
E01009942,19,100,100,216,1213,1648
E01009929,2,38,64,66,1538,1708
E01009930,10,30,37,64,1380,1521
E01009931,18,29,43,154,1998,2242
E01009932,17,32,44,216,1382,1691
E01009999,13,78,52,179,1055,1377
E01009921,21,85,79,260,1134,1579
E01009922,19,102,45,149,952,1267
E01009924,5,55,59,91,1165,1375
E01009925,9,58,48,110,1124,1349
E01009926,12,64,86,128,1123,1413
E01009927,19,93,112,183,1157,1564
E01009928,19,162,118,191,1269,1759
E01009933,18,26,44,160,1246,1494
E01009952,24,77,77,151,1634,1963
E01009955,8,40,31,440,1410,1929
E01009956,10,23,35,146,1357,1571
E01009959,3,2,22,28,1383,1438
E01010042,35,15,26,173,1538,1787
E01009923,16,75,42,159,1154,1446
E01010024,20,47,31,255,1160,1513
E01010026,11,90,74,229,1323,1727
E01010027,29,76,58,309,1047,1519
E01010001,17,75,59,108,1484,1743
E01010022,6,69,50,154,1271,1550
E01010023,22,80,42,195,1413,1752
E01010025,11,105,40,81,1309,1546
E01010028,5,105,56,74,1154,1394
E01009953,7,27,57,30,1555,1676
E01009954,9,11,43,39,1635,1737
E01009957,22,31,45,136,1424,1658
E01009958,10,17,12,39,1515,1593
E01009946,23,66,37,325,1232,1683
E01009948,32,51,19,196,1174,1472
E01009949,74,35,27,484,943,1563
E01009950,10,64,61,195,1328,1658
E01009951,24,198,95,112,1468,1897
E01032592,23,56,55,193,1432,1759
E01010118,0,39,38,59,1154,1290
E01010120,3,40,35,39,1176,1293
E01010121,8,18,19,61,1310,1416
E01010122,3,20,27,84,1246,1380
E01010235,5,76,63,23,1328,1495
E01010236,6,65,49,25,1367,1512
E01010239,2,59,70,17,1420,1568
E01010240,4,66,62,3,1199,1334
E01010117,7,29,28,15,1307,1386
E01010119,6,21,10,15,1454,1506
E01010123,0,10,20,17,1373,1420
E01010124,5,20,33,24,1444,1526
E01010146,2,69,50,28,1467,1616
E01010234,1,52,46,17,1152,1268
E01010237,5,83,58,21,1724,1891
E01010238,0,58,70,14,1266,1408
E01010145,2,33,44,15,1420,1514
E01010147,2,72,99,23,1267,1463
E01010148,1,76,55,16,1683,1831
E01010149,0,19,47,16,1362,1444
E01010125,1,45,64,16,1356,1482
E01010129,0,69,70,18,1359,1516
E01010139,2,24,29,4,1023,1082
E01010141,0,50,63,30,1220,1363
E01010140,8,49,72,13,1378,1520
E01010142,1,54,67,38,1273,1433
E01010143,3,37,80,28,1276,1424
E01010144,4,68,34,31,1520,1657
E01010111,0,42,58,25,1340,1465
E01010126,0,46,55,11,1356,1468
E01010127,1,51,49,15,1647,1763
E01010128,1,67,64,7,1312,1451
E01010130,3,69,72,19,1622,1785
E01010131,0,70,47,8,1270,1395
E01010109,4,17,25,26,1320,1392
E01010110,14,55,43,74,1458,1644
E01010112,1,32,80,33,1408,1554
E01010113,0,27,20,33,1252,1332
E01010114,5,51,38,77,1640,1811
E01010157,5,28,18,96,1269,1416
E01010159,22,22,24,277,1068,1413
E01010162,12,37,26,150,1288,1513
E01010163,14,29,12,182,1228,1465
E01010132,2,20,26,93,1291,1432
E01010133,7,19,25,174,1296,1521
E01010134,4,28,12,108,1274,1426
E01010135,14,18,36,139,1291,1498
E01010138,5,18,11,97,1269,1400
E01010136,5,4,23,62,1190,1284
E01010137,14,13,30,93,1162,1312
E01010158,17,20,41,100,1335,1513
E01010160,6,21,29,112,1339,1507
E01010161,6,16,14,137,1352,1525
E01010174,25,48,55,162,1344,1634
E01010175,32,30,33,198,1418,1711
E01010177,0,20,30,84,1216,1350
E01010178,5,42,67,196,1552,1862
E01010172,13,15,30,154,1332,1544
E01010173,22,10,22,187,1210,1451
E01010176,10,10,25,281,1057,1383
E01010179,1,7,16,125,1435,1584
E01010115,11,16,23,112,1336,1498
E01010116,21,5,19,248,1174,1467
E01010227,35,18,46,237,1555,1891
E01010228,11,18,40,150,1417,1636
E01010232,19,21,34,166,1805,2045
E01010195,18,10,14,216,1334,1592
E01010226,16,15,31,201,1341,1604
E01010229,18,13,26,217,1220,1494
E01010230,14,56,34,208,1483,1795
E01010231,36,22,30,252,1365,1705
E01010233,11,38,19,215,1535,1818
E01010108,4,5,33,72,1862,1976
E01010164,4,13,18,32,1520,1587
E01010165,4,2,20,25,1422,1473
E01010167,1,4,15,14,1485,1519
E01010199,16,18,31,248,1550,1863
E01010200,10,9,21,122,1309,1471
E01010201,8,21,19,252,1352,1652
E01010204,4,18,54,119,1053,1248
E01010205,16,9,32,293,1143,1493
E01010206,23,14,26,246,1382,1691
E01010192,29,22,28,240,1307,1626
E01010196,22,18,20,168,1447,1675
E01010197,27,4,25,270,1350,1676
E01010198,11,7,21,145,1400,1584
E01010218,5,27,24,52,1213,1321
E01010219,5,15,40,95,1450,1605
E01010221,4,12,12,37,1373,1438
E01010222,2,14,25,86,1352,1479
E01010191,33,17,24,270,1500,1844
E01010202,31,19,26,159,1332,1567
E01010203,17,18,40,191,1467,1733
E01010209,7,12,30,125,1574,1748
E01010213,10,17,40,83,1550,1700
E01010208,17,8,21,98,1391,1535
E01010210,1,3,16,107,1443,1570
E01010211,8,7,21,90,1276,1402
E01010217,0,3,16,30,1469,1518
E01010190,18,8,27,112,1533,1698
E01010193,10,11,35,97,1223,1376
E01010194,11,10,29,97,1495,1642
E01010207,14,14,17,195,1210,1450
E01010166,4,10,27,47,1366,1454
E01010168,1,11,36,73,1750,1871
E01010169,3,5,10,36,1568,1622
E01010170,8,2,22,57,1435,1524
E01010171,8,8,27,27,1274,1344
E01010151,4,5,23,15,1527,1574
E01010152,7,0,16,52,1303,1378
E01010153,17,13,25,18,1471,1544
E01010154,12,8,29,111,1505,1665
E01010155,10,5,12,4,1525,1556
E01010156,6,5,18,42,1487,1558
E01010212,28,22,20,224,1125,1419
E01010214,12,2,20,91,1092,1217
E01010215,18,19,26,288,1272,1623
E01010216,27,15,17,251,1214,1524
E01010150,4,7,10,47,1557,1625
E01010184,0,14,26,25,1364,1429
E01010185,0,7,17,67,1466,1557
E01010186,10,10,23,41,1839,1923
E01010187,3,7,35,67,1404,1516
E01010188,7,6,9,51,1674,1747
E01010180,10,5,14,31,1209,1269
E01010181,4,8,44,142,1753,1951
E01010183,6,10,13,49,1284,1362
E01010189,12,8,10,26,1548,1604
E01032885,4,16,37,119,1021,1197
E01032886,19,17,45,227,1666,1974
E01010220,13,5,18,100,1513,1649
E01010223,9,21,35,99,1048,1212
E01010225,8,19,21,124,1319,1491
E01032590,19,15,39,373,1302,1748
E01010301,6,11,12,12,1439,1480
E01010303,1,5,23,25,1487,1541
E01010306,13,37,18,103,1791,1962
E01010307,4,21,24,8,1713,1770
E01010302,0,19,22,18,1443,1502
E01010304,0,11,25,28,1644,1708
E01010305,1,4,21,11,1385,1422
E01010308,0,12,11,31,1237,1291
E01010345,0,11,5,11,1055,1082
E01010346,2,11,21,20,1339,1393
E01010347,2,9,20,15,1451,1497
E01010350,0,4,9,13,1437,1463
E01010249,0,19,51,34,1670,1774
E01010250,1,18,30,34,1353,1436
E01010252,1,15,44,46,1661,1767
E01010254,13,21,16,35,1406,1491
E01010348,5,5,5,15,1412,1442
E01010349,0,3,15,23,1218,1259
E01010351,1,4,24,19,1652,1700
E01010352,3,9,21,27,1572,1632
E01010284,2,7,38,18,1459,1524
E01010285,1,11,33,35,1636,1716
E01010286,2,7,37,25,1632,1703
E01010290,0,4,26,9,1582,1621
E01010251,5,19,10,69,1309,1412
E01010253,6,3,10,22,1202,1243
E01010255,5,1,11,9,1311,1337
E01010256,7,6,38,15,1463,1529
E01010257,0,3,14,19,1182,1218
E01010292,0,12,41,31,1537,1621
E01010294,3,14,36,23,1451,1527
E01010296,0,16,13,40,1395,1464
E01010297,0,8,15,57,1359,1439
E01010291,3,7,45,9,1354,1418
E01010293,2,9,18,12,1470,1511
E01010298,1,9,23,10,1129,1172
E01010299,0,14,27,16,1544,1601
E01010300,5,28,9,15,1436,1493
E01010319,31,63,36,291,981,1402
E01010321,1,34,19,76,1463,1593
E01010353,0,11,25,29,1396,1461
E01010354,1,7,34,15,1477,1534
E01010395,10,23,22,180,1141,1376
E01010397,4,18,33,68,1533,1656
E01010398,30,23,22,123,1454,1652
E01010399,1,22,37,71,1451,1582
E01010282,4,13,35,29,1236,1317
E01010287,3,25,15,29,1444,1516
E01010288,6,24,35,24,1636,1725
E01010289,1,21,40,16,1575,1653
E01010277,12,38,31,43,1493,1617
E01010283,10,35,70,68,1753,1936
E01032889,10,54,53,74,1774,1965
E01010393,33,31,26,109,1298,1497
E01010394,25,28,27,225,1143,1448
E01010396,3,4,26,20,1549,1602
E01010400,1,30,72,24,1757,1884
E01010241,14,17,25,83,2080,2219
E01010242,2,14,29,38,1572,1655
E01010243,0,10,16,34,1451,1511
E01010244,3,12,32,23,1438,1508
E01010320,2,34,42,27,1237,1342
E01010322,2,16,41,67,1401,1527
E01010323,2,19,37,50,1379,1487
E01010324,7,25,52,88,1390,1562
E01010271,9,34,67,38,1655,1803
E01010272,10,6,21,41,1440,1518
E01010273,0,11,39,16,1481,1547
E01010295,1,12,31,20,1410,1474
E01010279,5,118,58,121,1377,1679
E01010374,16,155,53,564,1020,1808
E01010375,22,230,110,981,865,2208
E01032888,13,65,71,58,2429,2636
E01010378,22,19,16,177,1027,1261
E01010379,2,5,13,35,1269,1324
E01010382,15,11,33,57,1424,1540
E01010383,3,33,79,62,1245,1422
E01010376,28,47,24,133,1132,1364
E01010377,4,20,10,71,1442,1547
E01010380,0,16,11,77,1401,1505
E01010381,10,27,60,86,1303,1486
E01010267,17,91,38,241,1323,1710
E01010268,13,46,52,928,744,1783
E01010274,2,35,18,15,1509,1579
E01010275,0,32,29,9,1452,1522
E01010245,2,11,22,68,1438,1541
E01010246,8,14,18,80,1447,1567
E01010247,4,16,21,59,1559,1659
E01010248,7,20,20,103,1488,1638
E01010388,7,12,17,150,1256,1442
E01010258,1,71,75,63,1536,1746
E01010259,15,18,44,100,1456,1633
E01010260,13,35,45,99,1402,1594
E01010266,8,76,93,61,1160,1398
E01010317,38,26,36,322,1178,1600
E01010318,27,106,138,223,1046,1540
E01010325,15,58,74,286,1242,1675
E01010369,33,110,118,453,1116,1830
E01010401,8,38,76,63,1278,1463
E01010403,45,54,99,295,1245,1738
E01010404,12,44,89,217,1452,1814
E01010407,18,31,44,131,1434,1658
E01010408,5,29,79,99,1336,1548
E01010269,6,56,63,1076,453,1654
E01010270,32,85,56,592,1017,1782
E01010362,34,63,87,625,949,1758
E01010363,20,85,102,749,931,1887
E01010402,17,48,34,357,1248,1704
E01010405,28,43,48,331,1233,1683
E01010406,75,76,141,618,1663,2573
E01010409,38,53,72,287,1152,1602
E01010385,12,11,17,206,1314,1560
E01010386,0,5,13,86,1501,1605
E01010387,12,13,25,90,1429,1569
E01010392,4,15,26,97,1409,1551
E01010326,23,20,33,667,898,1641
E01010327,30,70,78,681,841,1700
E01010328,83,22,24,622,721,1472
E01010330,16,50,59,466,899,1490
E01010368,10,110,138,449,1184,1891
E01010370,24,140,127,557,985,1833
E01010371,13,209,141,1206,713,2282
E01010372,37,126,41,662,727,1593
E01010373,27,83,54,615,1120,1899
E01010361,9,69,88,487,855,1508
E01010364,34,85,96,752,566,1533
E01010365,14,110,122,805,445,1496
E01010366,23,99,106,727,805,1760
E01010367,40,77,75,789,743,1724
E01010384,15,17,21,77,1361,1491
E01010389,16,29,36,249,1157,1487
E01010390,7,18,33,145,1525,1728
E01010391,5,23,38,214,1704,1984
E01010261,13,81,73,123,1319,1609
E01010263,4,46,72,1015,550,1687
E01010264,5,33,79,356,1171,1644
E01010265,9,70,70,839,865,1853
E01010336,70,60,45,859,584,1618
E01010340,16,91,57,1294,301,1759
E01010341,26,58,62,1399,168,1713
E01010342,17,76,63,1022,467,1645
E01010343,36,50,67,1151,285,1589
E01010344,22,77,40,833,731,1703
E01010331,67,13,20,652,930,1682
E01010332,136,44,17,881,768,1846
E01010333,26,12,26,549,1001,1614
E01010334,69,25,25,567,875,1561
E01010262,10,45,21,221,1288,1585
E01010309,12,78,112,286,1402,1890
E01010311,8,45,42,415,1137,1647
E01010316,9,62,54,107,1445,1677
E01010335,9,75,79,406,1140,1709
E01010337,12,42,28,440,898,1420
E01010338,32,53,59,916,784,1844
E01010339,35,32,29,550,886,1532
E01010310,4,37,47,124,1538,1750
E01010312,3,35,54,204,1451,1747
E01010313,4,33,32,208,1233,1510
E01010314,7,46,29,66,1418,1566
E01010315,2,38,22,49,1174,1285
E01010329,55,23,28,249,1235,1590
E01010355,0,21,6,25,1413,1465
E01010356,34,15,6,64,1432,1551
E01010357,9,82,51,200,1526,1868
E01010358,0,21,13,62,1369,1465
E01010359,0,33,32,31,1470,1566
E01010360,3,47,36,87,1332,1505
E01010434,3,216,86,102,1276,1683
E01010436,5,28,15,65,1323,1436
E01010437,1,35,23,7,1160,1226
E01010438,3,50,37,85,1198,1373
E01010439,1,51,46,7,1260,1365
E01010440,2,50,84,9,1415,1560
E01010441,5,88,92,48,1151,1384
E01010495,0,75,78,52,1474,1679
E01010497,10,34,39,219,909,1211
E01010499,8,109,62,155,1075,1409
E01010500,23,114,117,135,1027,1416
E01010496,2,145,88,116,1112,1463
E01010498,7,46,44,61,1295,1453
E01010541,7,134,131,99,1090,1461
E01010543,12,157,167,98,1015,1449
E01010456,3,114,140,37,1175,1469
E01010457,5,52,37,95,1394,1583
E01010462,1,72,111,13,1388,1585
E01010481,12,185,88,54,1256,1595
E01010555,7,52,53,21,1366,1499
E01010556,7,14,36,5,1419,1481
E01010557,4,10,18,40,1368,1440
E01010559,6,25,27,3,1351,1412
E01010560,0,29,32,24,1585,1670
E01010435,8,172,114,185,926,1405
E01010501,16,86,86,82,1218,1488
E01010502,15,91,57,273,920,1356
E01010503,22,117,95,179,918,1331
E01010482,1,71,118,26,1133,1349
E01010483,0,87,142,21,1182,1432
E01010484,7,122,88,24,1138,1379
E01010485,15,314,174,165,1001,1669
E01010458,20,51,68,70,1520,1729
E01010459,11,63,60,150,1351,1635
E01010460,20,142,59,182,1229,1632
E01010461,10,50,51,212,1251,1574
E01010566,22,54,42,126,1551,1795
E01010539,9,72,56,238,1227,1602
E01010540,18,20,35,181,1189,1443
E01010542,9,63,57,144,1254,1527
E01010544,68,50,17,259,1103,1497
E01010545,8,92,61,210,1302,1673
E01010554,7,3,25,30,1339,1404
E01010558,36,48,30,217,1358,1689
E01010562,16,67,45,202,1233,1563
E01010563,1,50,93,39,1310,1493
E01010567,24,20,92,38,1336,1510
E01010478,13,218,105,365,694,1395
E01010479,10,174,54,248,1093,1579
E01010480,14,207,124,258,658,1261
E01010486,3,289,196,82,1218,1788
E01010474,19,45,79,208,1274,1625
E01010561,16,20,31,217,1320,1604
E01010564,51,111,107,599,1083,1951
E01010565,44,23,26,340,1435,1868
E01010522,95,268,138,627,615,1743
E01010523,53,153,110,432,840,1588
E01010524,75,326,121,432,581,1535
E01010525,85,189,86,576,486,1422
E01010546,19,16,25,394,1064,1518
E01010547,13,13,21,186,1305,1538
E01010548,6,35,39,123,1212,1415
E01010549,13,40,48,174,1240,1515
E01010553,32,22,43,313,1160,1570
E01010471,85,248,182,359,845,1719
E01010472,53,402,185,462,793,1895
E01010473,138,865,253,282,920,2458
E01010475,21,50,50,281,1237,1639
E01010476,24,181,107,273,1248,1833
E01010477,42,227,160,197,1080,1706
E01010526,130,163,88,746,360,1487
E01010527,135,270,133,770,566,1874
E01010528,68,235,125,463,973,1864
E01010529,58,191,114,734,521,1618
E01010506,38,150,117,365,989,1659
E01010508,60,106,81,369,797,1413
E01010510,29,81,78,333,1068,1589
E01010511,89,192,114,616,614,1625
E01010512,33,104,69,415,822,1443
E01010442,7,164,71,294,769,1305
E01010443,31,205,150,93,1232,1711
E01010444,9,84,71,230,926,1320
E01010445,9,175,138,122,929,1373
E01010447,6,144,104,104,1461,1819
E01010448,9,109,121,111,1178,1528
E01010509,18,49,77,69,1265,1478
E01010550,16,10,28,266,1275,1595
E01010551,12,31,36,180,1369,1628
E01010552,13,46,65,143,1580,1847
E01010463,48,152,89,641,705,1635
E01010464,28,269,160,328,813,1598
E01010465,48,129,131,676,657,1641
E01010466,34,163,130,679,486,1492
E01010470,37,153,56,543,619,1408
E01010521,95,467,250,496,1239,2547
E01010487,8,43,43,191,1237,1522
E01010488,22,56,40,246,1072,1436
E01010493,22,45,56,239,1177,1539
E01010504,19,48,28,340,952,1387
E01010505,24,28,29,336,873,1290
E01010507,23,14,45,289,1102,1473
E01010418,22,23,39,323,1131,1538
E01010421,10,131,120,184,1139,1584
E01010423,10,62,102,156,1222,1552
E01010424,37,32,43,289,1178,1579
E01010417,9,113,125,121,1283,1651
E01010419,11,61,57,163,1145,1437
E01010420,17,109,79,288,805,1298
E01010425,40,65,41,241,964,1351
E01010446,27,116,83,183,1221,1630
E01010467,38,121,69,440,920,1588
E01010468,13,63,64,359,1001,1500
E01010469,6,49,47,231,1089,1422
E01010516,34,38,52,345,976,1445
E01010518,65,32,37,494,995,1623
E01010414,16,120,137,254,1435,1962
E01010415,21,190,120,198,1181,1710
E01010416,32,74,63,264,1232,1665
E01010422,9,65,63,364,1193,1694
E01010489,5,59,88,147,1235,1534
E01010490,8,72,108,113,1427,1728
E01010491,2,30,64,120,1289,1505
E01010492,9,29,38,183,1081,1340
E01010494,14,33,30,197,1311,1585
E01010449,80,321,174,817,925,2317
E01010450,9,148,133,329,1119,1738
E01010451,32,111,63,610,761,1577
E01010452,37,212,101,324,891,1565
E01010455,21,297,241,366,910,1835
E01010427,118,86,41,926,528,1699
E01010431,140,89,24,1056,297,1606
E01010432,159,44,40,996,321,1560
E01010519,38,73,68,586,837,1602
E01010520,73,45,48,499,982,1647
E01010513,39,19,38,288,1146,1530
E01010514,28,44,53,327,1172,1624
E01010515,15,46,46,246,1285,1638
E01010517,33,97,43,308,1128,1609
E01010533,26,129,81,430,1055,1721
E01010535,34,91,111,220,1108,1564
E01010536,38,25,26,390,1166,1645
E01010537,4,9,16,176,1257,1462
E01010410,1,43,71,53,1502,1670
E01010411,5,27,77,152,1402,1663
E01010412,9,82,70,154,1721,2036
E01010413,2,46,25,33,1604,1710
E01010531,10,62,94,178,1418,1762
E01010532,3,77,84,88,1401,1653
E01010534,101,70,27,932,462,1592
E01010538,8,44,69,138,1379,1638
E01010426,107,129,65,693,550,1544
E01010428,74,112,71,908,279,1444
E01010429,114,130,74,716,256,1290
E01010430,87,206,90,697,630,1710
E01010433,88,129,73,578,301,1169
E01010453,85,260,160,480,940,1925
E01010454,39,153,131,561,752,1636
E01010530,24,178,144,390,646,1382
E01032138,1,4,19,65,1330,1419
E01032139,7,5,36,24,1598,1670
E01032140,4,5,29,43,1621,1702
E01032141,1,7,50,71,1350,1479
E01032136,6,3,11,15,1295,1330
E01032137,0,3,10,16,1505,1534
E01032168,0,8,12,18,1080,1118
E01032169,6,4,14,17,1078,1119
E01032176,0,1,14,23,2127,2165
E01032126,1,3,25,20,2029,2078
E01032170,6,4,29,4,1403,1446
E01032171,0,3,7,18,1489,1517
E01032172,1,17,30,15,1387,1450
E01032133,3,8,39,21,1576,1647
E01032135,1,9,27,47,1564,1648
E01032145,1,10,20,26,1394,1451
E01032147,0,3,9,20,1161,1193
E01032134,8,20,26,36,1555,1645
E01032146,0,13,15,36,1595,1659
E01032177,1,12,19,10,1106,1148
E01032178,1,2,22,33,1229,1287
E01032142,0,7,21,17,1486,1531
E01032143,7,2,29,68,1370,1476
E01032144,3,4,33,55,1699,1794
E01032149,6,0,32,64,1130,1232
E01032127,1,4,22,9,1599,1635
E01032128,1,6,13,6,1393,1419
E01032129,0,10,32,46,1328,1416
E01032152,1,7,12,7,1311,1338
E01032148,1,5,12,26,1056,1100
E01032150,0,5,35,27,1433,1500
E01032151,1,4,10,12,1339,1366
E01032153,10,4,8,21,1423,1466
E01032155,9,6,11,39,1677,1742
E01032122,4,11,36,61,1977,2089
E01032123,4,6,19,38,1457,1524
E01032124,0,3,31,10,1455,1499
E01032125,1,2,22,10,1417,1452
E01032154,2,9,23,46,1725,1805
E01032159,2,1,14,46,1694,1757
E01032160,5,4,20,23,1635,1687
E01032161,1,6,16,9,1415,1447
E01032156,5,17,40,162,1569,1793
E01032157,3,5,36,37,1647,1728
E01032173,1,12,30,23,1610,1676
E01032175,0,13,9,19,1566,1607
E01032158,1,2,12,25,1414,1454
E01032162,3,2,28,39,1843,1915
E01033059,16,7,11,67,1491,1592
E01033061,15,7,26,74,1784,1906
E01032130,4,10,57,31,2567,2669
E01032131,1,10,43,32,1623,1709
E01032132,3,10,33,13,2108,2167
E01032174,0,7,21,23,1506,1557
E01032166,1,3,15,8,2067,2094
E01033060,13,78,70,110,1878,2149
E01033062,1,6,38,35,2316,2396
E01033243,2,5,13,9,1216,1245
E01032193,2,4,15,5,2146,2172
E01032212,3,1,16,3,1895,1918
E01032213,0,10,6,60,1513,1589
E01032214,3,1,11,6,2167,2188
E01032181,0,1,14,8,2081,2104
E01032190,1,0,10,20,1818,1849
E01032199,0,5,8,12,1727,1752
E01032223,1,0,18,6,2117,2142
E01032179,0,3,6,10,1656,1675
E01032180,1,2,11,12,1806,1832
E01032182,3,4,14,4,1991,2016
E01032183,0,1,9,12,1384,1406
E01032194,3,0,13,8,1424,1448
E01032195,3,1,9,10,1589,1612
E01032196,1,0,14,29,1548,1592
E01032197,5,2,16,27,1453,1503
E01032205,0,1,12,10,1047,1070
E01032206,0,2,4,15,1159,1180
E01032207,0,0,7,5,1429,1441
E01032217,1,1,3,12,1554,1571
E01032188,1,5,39,17,1913,1975
E01032189,5,8,26,18,1925,1982
E01032220,0,2,13,18,1459,1492
E01032221,1,12,26,15,1331,1385
E01032222,2,3,21,14,1349,1389
E01032201,5,2,25,24,1532,1588
E01032202,5,2,20,20,1688,1735
E01032203,1,2,16,12,1463,1494
E01032204,3,0,16,21,1568,1608
E01032191,0,4,12,13,2283,2312
E01032192,0,1,18,4,1577,1600
E01032211,0,0,8,4,1767,1779
E01032184,1,8,12,20,1500,1541
E01032185,1,2,14,8,1403,1428
E01032186,1,14,25,143,1262,1445
E01032187,3,0,16,36,1662,1717
E01032208,4,0,14,45,1401,1464
E01032209,8,25,28,95,1327,1483
E01032210,2,2,11,16,1099,1130
E01032218,21,10,15,38,1493,1577
E01032219,1,1,12,9,1596,1619
E01032198,2,7,11,9,2086,2115
E01032200,3,0,12,11,2037,2063
E01032215,1,0,7,3,1112,1123
E01032216,0,2,6,15,1504,1527
E01032226,13,16,45,104,1827,2005
E01032227,2,1,10,7,1037,1057
E01032243,1,6,10,8,1378,1403
E01032244,0,5,16,20,1199,1240
E01032240,2,3,37,31,1268,1341
E01032241,3,14,25,17,1326,1385
E01032242,2,10,19,8,1339,1378
E01032245,1,33,24,7,1320,1385
E01032232,3,30,57,122,1456,1668
E01032233,8,24,65,72,2809,2978
E01032234,7,44,64,142,1562,1819
E01032235,1,18,45,70,1683,1817
E01032224,3,45,42,531,1158,1779
E01032225,3,19,34,69,1023,1148
E01032239,3,60,55,555,1139,1812
E01032262,4,35,51,381,1668,2139
E01032273,0,5,20,8,1363,1396
E01032275,3,7,21,38,1290,1359
E01032277,1,5,40,34,1224,1304
E01032278,7,21,47,38,1490,1603
E01032236,4,56,50,231,1438,1779
E01032237,4,12,32,109,1354,1511
E01032238,1,18,25,222,1090,1356
E01032264,10,14,30,99,1612,1765
E01032255,1,13,26,55,1321,1416
E01032263,3,15,33,174,1559,1784
E01032266,9,21,24,27,1508,1589
E01032274,0,11,19,17,1247,1294
E01032259,0,1,13,36,1480,1530
E01032269,3,5,31,13,1586,1638
E01032270,2,2,15,28,1290,1337
E01032271,6,7,13,27,1260,1313
E01032272,0,10,22,22,1188,1242
E01032253,4,22,22,16,1247,1311
E01032265,8,12,29,49,1498,1596
E01032267,2,14,49,72,1538,1675
E01032268,0,5,14,13,1193,1225
E01032276,1,8,11,8,1447,1475
E01032250,2,12,35,82,1258,1389
E01032251,2,32,62,56,1610,1762
E01032252,4,13,37,57,1323,1434
E01032254,2,15,50,72,1464,1603
E01032256,6,20,28,16,1436,1506
E01032257,0,13,15,21,1414,1463
E01032258,1,11,14,22,1430,1478
E01032260,0,20,44,35,1283,1382
E01032246,2,7,11,26,1358,1404
E01032247,1,9,23,31,1354,1418
E01032248,7,9,15,22,1424,1477
E01032249,1,4,25,27,1522,1579
E01032261,0,3,15,22,1375,1415
E01032228,1,5,26,4,1351,1387
E01032229,8,26,43,17,1389,1483
E01032230,9,7,7,15,1426,1464
E01032231,0,9,20,24,1665,1718
E01032296,2,5,20,36,1587,1650
E01032297,4,1,11,12,1577,1605
E01032298,0,2,5,18,1769,1794
E01032299,3,4,28,21,1483,1539
E01032300,2,1,7,8,1569,1587
E01032303,0,6,15,19,1135,1175
E01032304,4,7,27,10,1399,1447
E01032331,0,2,22,9,1353,1386
E01032332,3,11,24,24,1135,1197
E01032330,0,12,11,17,1177,1217
E01032334,4,15,35,59,2237,2350
E01032335,3,2,18,62,1517,1602
E01032336,4,9,19,64,1469,1565
E01032279,2,9,19,65,1204,1299
E01032312,3,9,28,65,1360,1465
E01032327,4,7,20,45,1488,1564
E01032328,2,5,25,42,1413,1487
E01032329,8,3,16,46,1915,1988
E01032301,1,1,26,29,1371,1428
E01032302,8,5,17,192,1019,1241
E01032310,3,13,29,35,1382,1462
E01032311,0,6,36,42,1441,1525
E01032313,3,2,35,53,1255,1348
E01032333,3,7,42,42,1868,1962
E01032314,1,4,14,13,1103,1135
E01032315,6,14,42,58,1976,2096
E01032316,2,5,5,12,1151,1175
E01032317,1,8,10,6,1481,1506
E01032280,5,14,31,30,1530,1610
E01032281,2,14,23,74,1253,1366
E01032282,8,25,42,197,1487,1759
E01033246,4,5,8,24,1113,1154
E01033247,6,26,20,72,966,1090
E01032337,2,4,20,133,1739,1898
E01032338,1,9,34,89,1945,2078
E01032339,7,11,21,55,1569,1663
E01032318,6,2,24,26,1526,1584
E01032319,3,3,8,5,1691,1710
E01032320,4,7,15,36,1754,1816
E01032321,0,2,21,17,1452,1492
E01032322,8,12,36,36,1726,1818
E01032305,8,6,20,151,1470,1655
E01032306,7,1,28,180,1318,1534
E01032307,9,4,28,251,1499,1791
E01032309,2,11,21,170,1376,1580
E01032285,11,9,19,96,1558,1693
E01032292,6,34,49,521,1019,1629
E01032294,17,8,19,286,1116,1446
E01033248,4,14,16,47,934,1015
E01033249,7,22,37,95,1071,1232
E01032286,6,3,20,43,1617,1689
E01032287,2,5,34,35,1539,1615
E01032288,5,4,7,17,1545,1578
E01032289,1,1,7,17,1460,1486
E01032290,1,0,19,4,1498,1522
E01032283,5,3,23,146,1466,1643
E01032284,5,5,28,56,1877,1971
E01032295,3,10,42,89,2275,2419
E01032308,1,3,15,103,1464,1586
E01032323,3,2,18,40,1418,1481
E01032324,0,10,13,32,1310,1365
E01032325,1,9,18,72,1497,1597
E01032326,4,0,5,17,1382,1408
E01032354,2,11,26,36,2377,2452
E01032386,1,8,9,6,1306,1330
E01032387,4,1,9,9,1361,1384
E01032401,7,1,12,11,1465,1496
E01032368,1,6,26,19,1176,1228
E01032369,1,3,25,27,1487,1543
E01032370,3,16,19,5,1222,1265
E01032371,1,1,10,10,1326,1348
E01032359,1,4,18,37,1743,1803
E01032360,4,7,18,41,1863,1933
E01032361,0,8,14,24,1648,1694
E01032357,0,1,7,13,1166,1187
E01032358,0,0,6,22,1422,1450
E01032365,2,4,17,17,1763,1803
E01032367,1,3,7,16,1460,1487
E01032362,2,12,19,30,1916,1979
E01032363,1,8,17,9,1486,1521
E01032364,0,0,12,25,1624,1661
E01032366,2,1,12,14,1573,1602
E01032399,0,3,14,23,1650,1690
E01032400,12,2,25,26,2186,2251
E01032404,2,1,17,25,2315,2360
E01032345,0,2,10,5,1430,1447
E01032346,0,2,9,9,1311,1331
E01032395,0,0,14,4,1188,1206
E01032417,0,7,14,3,1467,1491
E01032392,2,1,11,15,1489,1518
E01032393,0,1,15,5,1531,1552
E01032394,1,0,9,7,1170,1187
E01032416,1,1,6,2,1107,1117
E01032355,0,0,4,4,1285,1293
E01032356,0,1,9,3,1110,1123
E01032402,1,2,12,16,1475,1506
E01032403,8,1,16,9,1410,1444
E01032375,0,1,1,1,1162,1165
E01032382,0,4,12,7,1221,1244
E01032383,3,5,17,2,1453,1480
E01032410,0,1,6,1,1346,1354
E01032411,2,0,13,11,1571,1597
E01032390,1,0,6,18,1339,1364
E01032391,1,0,7,5,1084,1097
E01032414,0,0,7,13,1504,1524
E01032415,7,44,34,46,1512,1643
E01032405,0,0,2,8,1320,1330
E01032406,1,1,4,8,1375,1389
E01032407,0,1,5,5,1409,1420
E01032408,1,2,7,2,1345,1357
E01032409,0,3,3,15,1548,1569
E01032340,7,1,11,4,1410,1433
E01032341,1,2,11,10,1291,1315
E01032349,1,2,10,8,1492,1513
E01032350,2,0,12,1,1037,1052
E01032388,1,0,6,3,1333,1343
E01032389,2,2,11,21,1231,1267
E01032343,15,3,21,83,2214,2336
E01032377,8,7,28,23,1726,1792
E01032378,3,5,18,33,1646,1705
E01032376,4,0,9,35,1459,1507
E01032384,1,0,8,10,1294,1313
E01032385,0,0,3,13,1209,1225
E01032396,0,1,18,20,1629,1668
E01032342,6,6,16,36,1501,1565
E01032344,0,2,3,32,1411,1448
E01032379,5,0,14,15,1845,1879
E01032380,6,3,6,31,1529,1575
E01032381,8,1,25,12,1857,1903
E01032397,2,2,26,13,1702,1745
E01032398,2,1,22,6,1736,1767
E01032351,0,0,11,13,1479,1503
E01032352,2,1,10,7,1481,1501
E01032353,3,1,9,10,1554,1577
E01032374,2,0,5,2,1282,1291
E01032347,2,2,8,1,1276,1289
E01032348,4,1,12,3,1195,1215
E01032372,2,1,15,1,1433,1452
E01032373,0,0,9,9,1235,1253
E01032412,3,2,2,3,1219,1229
E01032413,0,1,11,2,1054,1068
E01032431,0,0,6,7,1428,1441
E01032432,3,9,13,176,1253,1454
E01032433,0,2,18,27,1256,1303
E01032439,1,0,11,0,1361,1373
E01032440,4,4,13,4,1165,1190
E01032479,2,1,12,20,2052,2087
E01032441,0,0,4,2,1251,1257
E01032442,0,7,2,2,1460,1471
E01032443,0,1,5,2,1327,1335
E01032444,0,2,9,4,1192,1207
E01032445,1,0,8,12,1499,1520
E01032436,1,3,18,7,1493,1522
E01032438,0,1,14,20,1479,1514
E01032446,1,1,11,25,1402,1440
E01032447,4,9,27,41,1387,1468
E01032448,2,2,11,18,1194,1227
E01032434,2,4,38,115,1491,1650
E01032435,3,11,37,149,1246,1446
E01032437,1,6,18,47,1729,1801
E01032450,5,16,40,91,2117,2269
E01032430,2,4,9,10,1653,1678
E01032480,0,1,16,14,1751,1782
E01032481,1,1,5,7,1703,1717
E01032482,3,6,17,8,1365,1399
E01032451,1,0,9,3,1518,1531
E01032452,1,0,14,22,1530,1567
E01032453,1,1,26,24,1629,1681
E01032454,0,4,17,27,1618,1666
E01032449,1,4,28,37,1524,1594
E01032464,1,4,13,9,1468,1495
E01032465,5,3,19,12,1456,1495
E01032466,3,4,14,10,1360,1391
E01032467,0,2,8,5,1143,1158
E01032468,1,1,5,23,1138,1168
E01032474,1,6,50,62,1584,1703
E01032475,1,10,28,24,1595,1658
E01032476,1,2,7,5,1384,1399
E01032477,1,6,16,5,1165,1193
E01032478,3,8,13,20,1485,1529
E01032469,0,1,17,13,1707,1738
E01032470,0,6,15,21,1776,1818
E01032471,0,6,19,15,1568,1608
E01032418,1,7,16,20,1271,1315
E01032419,1,6,11,3,1292,1313
E01032420,0,3,18,6,1234,1261
E01032421,0,1,8,7,1227,1243
E01032422,1,2,36,16,1392,1447
E01032427,3,0,13,4,1543,1563
E01032428,3,1,17,12,1602,1635
E01032429,2,3,20,8,1487,1520
E01032472,4,0,8,3,1189,1204
E01032473,0,1,23,15,1200,1239
E01032455,0,1,15,4,1486,1506
E01032456,1,4,12,6,1197,1220
E01032457,0,0,5,1,1342,1348
E01032458,1,0,1,6,1359,1367
E01032459,1,1,12,14,1410,1438
E01032460,5,1,14,14,1751,1785
E01032461,4,9,14,43,1908,1978
E01032462,3,5,28,16,2172,2224
E01032463,3,2,9,13,1608,1635
E01032423,1,5,11,17,1465,1499
E01032424,0,2,17,8,1396,1423
E01032425,2,1,9,1,1417,1430
E01032426,7,0,1,8,1423,1439
E01017540,0,0,16,8,1442,1466
E01017541,0,2,19,6,1259,1286
E01017544,1,3,21,20,1386,1431
E01017545,13,3,27,37,1412,1492
E01017464,3,4,22,5,1426,1460
E01017465,6,2,16,6,1396,1426
E01017503,0,8,19,27,1257,1311
E01017504,13,9,35,29,1892,1978
E01017546,0,13,21,16,1175,1225
E01017547,12,15,29,49,1442,1547
E01017478,4,9,31,29,1642,1715
E01017479,1,4,28,43,1193,1269
E01017480,11,150,67,156,1707,2091
E01017481,2,25,40,29,1104,1200
E01017528,7,13,28,42,2403,2493
E01017495,0,21,52,32,1898,2003
E01017496,0,3,14,25,1431,1473
E01017542,3,6,22,16,1336,1383
E01017543,1,15,19,12,1417,1464
E01033431,8,105,85,160,1104,1462
E01033432,16,69,70,107,1987,2249
E01017453,12,88,64,83,1083,1330
E01017454,11,40,42,167,1213,1473
E01017455,18,29,27,83,1301,1458
E01017456,20,24,27,82,1279,1432
E01017457,1,48,63,107,961,1180
E01017458,3,37,38,67,1135,1280
E01017529,0,31,27,75,1162,1295
E01017530,2,20,41,62,1285,1410
E01017531,5,74,57,125,1093,1354
E01017532,7,11,24,74,1155,1271
E01017533,19,44,15,81,1050,1209
E01017534,9,15,35,52,1422,1533
E01017488,10,18,35,79,1309,1451
E01017489,16,146,155,112,1152,1581
E01017490,10,141,79,102,1051,1383
E01017491,20,72,52,80,1324,1548
E01017492,14,153,97,119,1087,1470
E01017493,4,142,113,82,1316,1657
E01017459,10,15,25,69,1569,1688
E01017460,22,23,24,147,1370,1586
E01017461,4,53,59,192,1596,1904
E01017462,5,5,23,59,1529,1621
E01017463,2,22,35,31,1255,1345
E01017482,12,38,50,114,1130,1344
E01017483,7,111,63,108,1699,1988
E01017484,4,41,37,164,1042,1288
E01017485,8,56,51,88,1185,1388
E01017497,18,101,63,191,1034,1407
E01017498,4,55,52,128,1038,1277
E01017499,15,76,57,124,1062,1334
E01017500,7,72,41,136,891,1147
E01017501,12,73,38,146,1093,1362
E01017502,30,168,79,260,1184,1721
E01017524,24,39,46,86,1365,1560
E01017525,12,72,51,91,980,1206
E01017526,8,57,49,106,1235,1455
E01017527,3,31,40,81,1019,1174
E01017466,31,148,84,714,944,1921
E01017467,4,27,38,40,1188,1297
E01017468,5,28,51,57,1174,1315
E01017469,13,61,50,114,1515,1753
E01017470,10,24,35,42,1164,1275
E01017471,22,154,91,265,976,1508
E01017535,16,55,53,530,802,1456
E01017536,44,208,108,1107,924,2391
E01017537,29,115,76,559,590,1369
E01017538,32,73,30,1150,530,1815
E01017539,45,112,56,718,590,1521
E01017518,17,105,88,172,1152,1534
E01017519,16,80,97,213,1172,1578
E01017520,6,69,55,189,1142,1461
E01017521,9,122,60,195,1142,1528
E01017522,30,105,55,258,1363,1811
E01017523,15,149,101,256,1035,1556
E01017472,14,112,78,412,846,1462
E01017473,22,150,131,663,1286,2252
E01017474,7,125,104,633,859,1728
E01017475,17,93,54,461,896,1521
E01017476,11,92,76,314,964,1457
E01017477,13,81,80,149,938,1261
E01017509,5,91,61,138,958,1253
E01017510,3,40,41,162,1264,1510
E01017511,8,52,28,221,949,1258
E01017512,13,80,67,382,912,1454
E01017505,7,51,41,240,1196,1535
E01017506,11,60,85,209,1187,1552
E01017507,9,34,51,327,935,1356
E01017508,21,71,49,186,1291,1618
E01017513,18,57,55,257,1102,1489
E01017514,19,96,100,232,1188,1635
E01017515,3,96,50,145,1303,1597
E01017516,9,60,34,194,1184,1481
E01017517,14,59,60,235,1224,1592
E01017486,8,49,33,67,1562,1719
E01017487,10,72,123,111,1492,1808
E01017548,3,31,83,70,1675,1862
E01017549,10,25,11,36,1326,1408
E01017550,17,119,109,534,1923,2702
E01017551,4,12,29,78,1324,1447
E01017552,1,5,21,24,1139,1190
E01017553,1,19,23,38,1177,1258
E01017554,2,15,26,28,1380,1451
E01017433,1,22,46,32,1487,1588
E01017434,4,10,39,49,1582,1684
E01017436,5,31,37,42,2214,2329
E01017430,0,7,20,8,1357,1392
E01017431,0,17,34,17,1413,1481
E01017432,4,10,6,29,1442,1491
E01017435,4,22,39,37,1590,1692
E01017425,1,0,6,13,1042,1062
E01017426,2,6,17,0,1345,1370
E01017427,2,1,23,23,1682,1731
E01017428,3,1,18,37,1572,1631
E01017429,3,3,15,12,1372,1405
E01017412,1,17,19,16,1467,1520
E01017422,8,12,10,10,1476,1516
E01017423,4,8,13,18,1493,1536
E01017424,4,7,16,32,1315,1374
E01017383,1,25,20,46,1778,1870
E01017384,2,15,33,9,1553,1612
E01017385,6,22,40,44,1541,1653
E01017386,5,15,29,37,1696,1782
E01017387,1,5,16,9,1319,1350
E01017388,3,19,25,11,1286,1344
E01017381,1,8,6,12,1446,1473
E01017382,1,19,22,43,1389,1474
E01017389,6,9,34,50,1845,1944
E01017390,1,11,36,52,1949,2049
E01017379,0,13,24,29,1125,1191
E01017380,6,15,18,22,1180,1241
E01017394,19,17,34,81,1389,1540
E01017397,25,41,36,128,1443,1673
E01033194,169,198,47,430,1823,2667
E01017410,1,4,10,28,1156,1199
E01017411,2,2,21,38,1451,1514
E01017419,1,5,30,21,1555,1612
E01017420,1,6,19,20,1474,1520
E01017421,3,5,32,27,1671,1738
E01017416,5,7,35,38,1896,1981
E01017417,5,18,51,70,2221,2365
E01017418,5,17,14,49,1472,1557
E01017451,8,2,25,23,1360,1418
E01017452,10,4,15,25,1112,1166
E01017376,10,9,45,61,1720,1845
E01017377,8,10,53,60,1840,1971
E01017378,3,13,26,39,1687,1768
E01017413,2,2,18,29,1705,1756
E01017414,5,5,26,19,1681,1736
E01017415,2,9,27,28,1786,1852
E01017437,0,17,26,33,1452,1528
E01017438,2,11,21,44,1584,1662
E01017439,1,8,21,33,1613,1676
E01017440,3,12,25,35,1299,1374
E01017441,3,18,32,34,1848,1935
E01017444,0,6,26,16,1794,1842
E01017371,1,3,21,7,1268,1300
E01017372,4,4,31,12,1421,1472
E01017373,1,5,20,18,1444,1488
E01017374,0,2,18,60,1392,1472
E01017375,11,6,35,17,1374,1443
E01017391,2,10,23,28,1304,1367
E01017392,1,11,11,23,1465,1511
E01017393,2,9,15,15,1704,1745
E01017442,1,27,50,79,1895,2052
E01017443,9,16,28,71,1681,1805
E01017446,1,5,42,16,1667,1731
E01017447,10,27,34,66,1930,2067
E01017449,0,6,6,36,1438,1486
E01033188,1,11,19,41,1358,1430
E01033189,5,31,44,97,1365,1542
E01033190,16,25,63,83,1189,1376
E01017399,5,11,45,21,1413,1495
E01017400,1,15,40,17,1423,1496
E01017401,0,12,26,37,1196,1271
E01017402,0,9,19,21,1550,1599
E01017403,1,7,21,20,1370,1419
E01017404,1,4,13,16,1314,1348
E01017405,4,10,32,24,1379,1449
E01017406,4,20,23,6,1502,1555
E01017407,0,8,22,53,1519,1602
E01017398,6,11,38,35,2310,2400
E01017408,0,4,14,15,1039,1072
E01017409,2,2,18,17,1186,1225
E01017445,2,13,23,29,1724,1791
E01017450,2,17,35,45,2201,2300
E01017558,4,17,32,62,1683,1798
E01017559,8,10,26,26,1633,1703
E01017560,2,2,16,23,1448,1491
E01017616,10,63,66,149,2032,2320
E01017577,2,11,41,23,2092,2169
E01017615,2,7,18,25,2045,2097
E01017620,1,6,35,27,1733,1802
E01017621,1,2,14,30,1593,1640
E01017622,6,14,36,56,1569,1681
E01017603,0,3,25,21,1452,1501
E01017604,2,6,24,18,1611,1661
E01017605,7,23,34,21,1331,1416
E01017606,5,2,19,13,1475,1514
E01017607,0,8,25,16,1360,1409
E01017555,15,23,41,62,1769,1910
E01017556,8,11,27,31,1502,1579
E01017557,2,17,40,44,1656,1759
E01017608,6,15,25,24,1659,1729
E01017609,6,10,41,44,1567,1668
E01017589,8,19,43,53,1530,1653
E01017590,0,16,37,21,1454,1528
E01017591,2,15,27,22,1630,1696
E01017610,2,1,19,13,1098,1133
E01017611,4,8,13,15,1227,1267
E01017612,4,9,22,19,1271,1325
E01017613,4,6,23,25,1329,1387
E01017614,7,5,26,19,1438,1495
E01017600,19,153,55,62,1650,1939
E01017601,16,167,72,27,1205,1487
E01017602,6,115,47,79,1307,1554
E01017618,9,126,73,59,1378,1645
E01017619,14,117,96,55,1889,2171
E01017573,1,10,10,18,1385,1424
E01017575,11,23,63,73,2308,2478
E01017576,1,12,23,20,1351,1407
E01033191,3,4,27,18,1365,1417
E01033192,4,53,55,38,1374,1524
E01033193,0,12,17,29,1531,1589
E01017578,3,34,39,73,1600,1749
E01017579,1,42,56,47,1321,1467
E01017580,11,121,82,83,1841,2138
E01017581,0,41,54,53,1680,1828
E01017617,1,48,34,34,1188,1305
E01017582,7,38,15,95,1363,1518
E01017583,15,84,79,147,1518,1843
E01017584,5,66,57,115,1725,1968
E01017585,1,26,16,75,1299,1417
E01017566,5,5,19,52,1417,1498
E01017595,1,21,22,36,1117,1197
E01017596,5,32,24,27,1451,1539
E01017597,1,16,22,21,1388,1448
E01017598,7,17,22,13,999,1058
E01017599,16,92,61,97,1859,2125
E01017565,1,8,9,24,1479,1521
E01017567,13,22,42,54,1524,1655
E01017568,27,58,60,77,1628,1850
E01017569,5,52,48,60,1447,1612
E01017570,13,64,65,127,1667,1936
E01017592,12,44,36,60,1388,1540
E01017593,2,50,24,20,1391,1487
E01017594,4,120,94,52,1896,2166
E01017623,4,46,37,122,1471,1680
E01017624,0,87,35,80,1675,1877
E01017625,1,12,18,16,1562,1609
E01017626,7,7,19,12,1664,1709
E01017571,1,5,17,12,1196,1231
E01017572,1,4,20,25,1304,1354
E01017586,7,11,19,27,1391,1455
E01017587,3,13,25,18,1489,1548
E01017588,1,2,9,4,1156,1172
E01017561,2,28,20,18,1429,1497
E01017562,1,12,19,23,1385,1440
E01017563,2,7,14,22,1538,1583
E01017564,1,21,19,28,1337,1406
E01015706,18,80,28,225,1055,1406
E01015707,14,69,36,145,1178,1442
E01015708,14,70,32,263,1020,1399
E01015709,10,96,52,193,1115,1466
E01015710,7,103,53,206,1125,1494
E01015770,5,104,42,199,929,1279
E01015801,11,284,93,216,1157,1761
E01015803,12,66,34,75,1318,1505
E01015804,12,231,109,230,1248,1830
E01015805,11,161,43,101,1019,1335
E01015769,10,174,70,119,822,1195
E01015771,5,270,92,329,731,1427
E01015772,13,332,88,321,721,1475
E01015773,10,241,125,204,753,1333
E01015774,32,312,77,191,832,1444
E01015802,4,284,104,185,941,1518
E01015744,19,132,79,272,936,1438
E01015746,11,91,69,171,1165,1507
E01015747,14,76,29,347,968,1434
E01015748,18,90,54,254,1244,1660
E01015749,22,434,140,372,926,1894
E01015751,10,290,126,372,923,1721
E01015752,16,260,87,252,724,1339
E01015753,14,204,70,128,997,1413
E01015754,14,338,103,309,1009,1773
E01015755,10,246,54,285,1077,1672
E01015764,5,97,50,164,1239,1555
E01015765,4,266,84,291,1004,1649
E01015766,20,122,59,609,865,1675
E01015767,16,131,60,361,1004,1572
E01015768,6,94,57,219,1077,1453
E01015783,7,182,65,829,639,1722
E01015785,30,252,86,664,1102,2134
E01015693,22,65,53,423,982,1545
E01015694,27,97,37,491,791,1443
E01015695,18,97,75,699,703,1592
E01015696,30,68,92,176,1019,1385
E01015697,24,108,95,411,1133,1771
E01015745,28,75,61,517,909,1590
E01015797,2,35,36,52,1182,1307
E01015798,21,40,51,94,1136,1342
E01015799,13,30,30,90,1225,1388
E01015800,19,53,66,88,1297,1523
E01015812,6,65,35,57,1196,1359
E01015813,21,95,42,62,1094,1314
E01015756,11,193,81,219,1089,1593
E01015757,8,233,103,241,948,1533
E01015758,12,263,101,286,832,1494
E01015759,19,207,97,292,891,1506
E01015760,14,245,84,297,850,1490
E01015761,8,186,90,310,1058,1652
E01015700,36,190,90,1309,813,2438
E01015701,34,96,26,1850,213,2219
E01015704,41,125,74,1602,274,2116
E01015782,37,143,68,1143,679,2070
E01015784,30,120,25,1643,382,2200
E01015786,33,155,65,1585,372,2210
E01015711,23,171,60,967,482,1703
E01015712,35,152,59,839,720,1805
E01015715,12,148,70,1256,336,1822
E01015716,27,308,119,489,911,1854
E01015717,4,256,57,659,561,1537
E01015750,42,255,110,996,783,2186
E01015740,38,121,63,327,1016,1565
E01015775,43,75,46,140,1305,1609
E01015776,26,173,59,243,1391,1892
E01015777,58,161,68,191,1254,1732
E01015778,29,156,79,192,1270,1726
E01015796,16,57,35,117,1236,1461
E01015713,10,99,53,586,660,1408
E01015714,37,137,60,724,769,1727
E01015718,49,162,59,412,932,1614
E01015762,39,172,59,411,1018,1699
E01015763,11,145,69,291,1036,1552
E01015721,9,76,38,119,1294,1536
E01015722,19,153,58,116,929,1275
E01015806,2,55,51,49,1161,1318
E01015808,11,57,46,104,1196,1414
E01015809,18,52,24,109,1210,1413
E01015810,14,100,66,136,1075,1391
E01015811,18,50,55,99,1206,1428
E01015703,30,80,31,1839,165,2145
E01015726,16,133,33,1912,234,2328
E01015731,44,164,61,1391,311,1971
E01015787,25,144,76,1350,418,2013
E01015788,6,120,36,1693,178,2033
E01015719,22,88,58,189,1066,1423
E01015720,30,179,89,380,847,1525
E01015723,14,158,32,212,895,1311
E01015779,26,129,51,327,941,1474
E01015780,26,158,57,226,1178,1645
E01015781,16,158,65,218,1088,1545
E01015807,8,134,61,178,982,1363
E01015698,24,182,93,1067,519,1885
E01015699,50,223,90,951,524,1838
E01015702,14,119,57,1250,340,1780
E01015705,9,220,65,1066,337,1697
E01015725,20,59,55,1426,191,1751
E01015727,46,110,30,1512,200,1898
E01015739,59,221,127,313,1188,1908
E01015741,81,314,121,505,1235,2256
E01015742,43,243,92,218,1173,1769
E01015743,39,205,70,255,979,1548
E01015789,71,212,100,425,939,1747
E01015794,88,449,97,593,1278,2505
E01015724,26,225,61,1423,607,2342
E01015728,20,195,64,1000,523,1802
E01015729,41,190,68,1039,623,1961
E01015730,33,167,72,1314,754,2340
E01015732,45,123,73,304,978,1523
E01015733,46,131,87,512,1031,1807
E01015734,32,209,69,242,1303,1855
E01015735,28,266,111,355,970,1730
E01015736,37,180,74,340,1109,1740
E01015737,33,150,68,375,909,1535
E01015738,54,198,89,295,1170,1806
E01015790,41,162,45,169,1203,1620
E01015791,142,369,92,564,1325,2492
E01015792,13,156,70,281,1222,1742
E01015793,13,143,72,195,1304,1727
E01015795,41,386,129,438,1160,2154
E01015629,0,12,17,32,1679,1740
E01015635,2,3,11,19,1499,1534
E01015636,0,3,11,13,1123,1150
E01015679,13,15,47,58,1659,1792
E01015678,0,22,34,16,1350,1422
E01015680,4,60,55,52,1340,1511
E01015681,3,14,22,60,1453,1552
E01015682,2,9,18,71,1342,1442
E01015630,12,24,27,41,1435,1539
E01015631,3,6,18,3,1276,1306
E01015659,2,34,42,50,1823,1951
E01015684,1,14,32,52,1392,1491
E01015685,8,15,19,39,1530,1611
E01015589,1,3,23,19,1608,1654
E01015590,1,5,14,13,1189,1222
E01015626,2,20,10,2,1451,1485
E01015628,2,11,33,21,2201,2268
E01015617,1,13,26,15,1262,1317
E01015618,0,11,12,14,1047,1084
E01015619,5,18,48,50,1912,2033
E01015620,1,20,19,52,1612,1704
E01015674,10,20,24,40,1401,1495
E01015675,7,29,35,80,1431,1582
E01015676,6,27,39,57,1378,1507
E01015683,4,14,26,32,1760,1836
E01015686,6,2,12,37,1448,1505
E01015607,41,35,51,73,1207,1407
E01015609,54,67,99,149,1366,1735
E01015656,7,18,39,58,1419,1541
E01015657,12,79,71,87,1726,1975
E01015658,9,51,72,66,1355,1553
E01015660,15,32,32,41,1410,1530
E01015605,40,35,43,241,1271,1630
E01015608,28,25,52,176,1278,1559
E01015610,8,43,53,167,1293,1564
E01015633,18,69,73,156,1907,2223
E01015634,24,33,49,378,1366,1850
E01015593,10,28,53,62,1277,1430
E01015596,12,42,54,170,1377,1655
E01015662,16,50,57,246,1081,1450
E01015663,26,54,52,262,1057,1451
E01015664,25,84,58,251,1254,1672
E01015603,30,80,85,883,1214,2292
E01015604,23,29,97,1250,564,1963
E01015632,37,46,55,468,1422,2028
E01015661,20,93,56,234,1346,1749
E01015677,4,14,32,38,977,1065
E01015591,2,31,41,81,1324,1479
E01015592,9,47,30,62,1381,1529
E01015594,4,54,54,88,1622,1822
E01015595,2,56,49,125,1227,1459
E01015597,5,93,58,55,1362,1573
E01015601,36,51,35,1401,532,2055
E01015651,5,18,57,808,1172,2060
E01015652,37,44,47,861,1041,2030
E01015653,21,29,59,407,1302,1818
E01015654,44,54,69,633,1574,2374
E01015606,11,34,55,188,1437,1725
E01015611,31,36,79,519,1432,2097
E01015613,4,49,60,69,1367,1549
E01015614,6,64,51,112,1566,1799
E01015615,25,46,42,300,1201,1614
E01015616,41,62,98,473,1105,1779
E01015599,66,71,134,799,811,1881
E01015600,32,50,79,1161,553,1875
E01015602,51,47,93,413,1343,1947
E01015612,39,87,48,610,1399,2183
E01015655,23,47,57,407,1602,2136
E01015598,21,26,26,169,1256,1498
E01015687,19,33,27,322,1189,1590
E01015689,1,15,21,144,1254,1435
E01015690,7,17,16,263,901,1204
E01015691,20,18,15,417,921,1391
E01015622,16,98,65,146,2036,2361
E01015665,24,39,52,762,791,1668
E01015688,16,26,38,341,1000,1421
E01015692,21,34,18,646,702,1421
E01033173,11,50,53,204,1589,1907
E01033182,14,65,28,33,1332,1472
E01015621,18,54,49,107,1747,1975
E01015623,7,29,30,45,1602,1713
E01015624,27,28,47,41,1484,1627
E01015666,2,18,29,33,1218,1300
E01015668,5,54,43,64,1611,1777
E01015627,0,6,20,17,1697,1740
E01015644,9,45,54,104,1734,1946
E01015645,3,27,25,47,1532,1634
E01015646,3,8,23,55,1824,1913
E01015648,3,8,10,44,1348,1413
E01015667,1,19,30,40,1234,1324
E01015669,12,14,19,23,1326,1394
E01015670,3,6,8,54,1369,1440
E01015671,4,31,26,69,1443,1573
E01015672,3,21,33,79,1444,1580
E01015673,7,34,43,36,1376,1496
E01015637,4,57,60,33,1308,1462
E01015639,5,70,59,56,1322,1512
E01015640,7,26,64,58,1312,1467
E01015641,7,64,46,16,1126,1259
E01015642,9,60,52,44,1362,1527
E01015647,8,55,44,27,1265,1399
E01015638,3,19,23,65,1447,1557
E01015650,7,31,33,102,1850,2023
E01033174,2,47,63,84,1025,1221
E01033179,11,37,30,69,1379,1526
E01033181,23,51,65,91,1344,1574
E01015643,10,48,32,28,1257,1375
E01033175,7,58,46,125,1240,1476
E01033176,12,32,63,101,1397,1605
E01033177,20,43,48,95,1213,1419
E01033178,16,64,95,95,1275,1545
E01033180,6,78,75,132,1341,1632
E01015833,5,4,13,28,1493,1543
E01015834,3,15,4,24,1418,1464
E01015835,7,26,14,35,1577,1659
E01015836,1,8,21,17,1468,1515
E01015837,5,6,16,45,1611,1683
E01015838,1,10,13,19,1457,1500
E01015863,10,28,37,73,2223,2371
E01015864,1,11,26,26,1296,1360
E01015865,2,9,14,27,1373,1425
E01015866,5,28,11,40,1448,1532
E01015867,6,53,37,27,1311,1434
E01015868,3,14,14,116,1457,1604
E01015814,10,26,20,21,1346,1423
E01015815,10,22,26,42,1498,1598
E01015816,4,3,13,9,1456,1485
E01015817,6,12,16,23,1516,1573
E01015818,1,12,12,43,1644,1712
E01015819,9,8,34,22,1355,1428
E01015857,1,13,19,39,1471,1543
E01015858,10,20,32,115,1547,1724
E01015859,15,37,34,154,1683,1923
E01015860,13,29,25,67,1406,1540
E01015861,13,42,25,86,1528,1694
E01015862,14,54,49,144,1286,1547
E01015820,1,21,33,46,1384,1485
E01015821,2,10,23,21,1509,1565
E01015822,0,12,19,27,1165,1223
E01015823,8,8,26,19,1598,1659
E01015824,20,21,33,65,1406,1545
E01015825,3,8,16,80,1493,1600
E01015826,0,10,14,52,1322,1398
E01015869,14,37,54,40,1485,1630
E01015870,6,31,21,25,1560,1643
E01015871,3,21,26,38,1529,1617
E01015872,18,30,39,43,1558,1688
E01015873,3,21,26,40,1211,1301
E01015874,13,55,32,36,1533,1669
E01015875,8,35,39,46,1537,1665
E01015901,10,42,37,93,1279,1461
E01015902,15,88,63,242,1274,1682
E01015903,18,58,43,92,1387,1598
E01015904,16,64,56,125,1387,1648
E01015905,7,58,42,50,1271,1428
E01015906,27,62,35,137,1320,1581
E01015907,7,51,39,121,1231,1449
E01015908,1,9,15,4,1582,1611
E01015909,3,5,11,12,1520,1551
E01015910,3,4,7,20,1473,1507
E01015911,1,1,13,11,1280,1306
E01015912,5,1,20,25,1446,1497
E01015913,3,13,24,31,1611,1682
E01015883,7,12,16,83,1265,1383
E01015884,8,27,48,73,1963,2119
E01015885,5,18,21,95,1517,1656
E01015886,8,47,30,65,1345,1495
E01015887,3,49,27,47,1468,1594
E01015888,5,17,10,78,1353,1463
E01015895,11,127,35,164,1621,1958
E01015896,24,124,54,246,1518,1966
E01015897,16,72,99,63,1787,2037
E01015898,6,35,38,95,1516,1690
E01015899,12,75,61,149,1602,1899
E01015900,20,87,40,106,1201,1454
E01015845,3,9,57,17,1537,1623
E01015846,11,7,46,44,1648,1756
E01015847,9,8,36,16,1664,1733
E01015848,1,10,27,33,1575,1646
E01015849,8,11,27,27,1596,1669
E01015850,3,8,24,24,1597,1656
E01015827,4,17,29,51,1560,1661
E01015828,14,54,67,47,1450,1632
E01015829,10,4,34,27,1487,1562
E01015830,2,9,35,37,1491,1574
E01015831,34,208,106,98,1552,1998
E01015832,8,30,60,41,1479,1618
E01015876,9,5,40,20,2094,2168
E01015877,2,20,21,32,1710,1785
E01015878,6,16,28,46,1258,1354
E01015879,2,27,36,26,1310,1401
E01015880,11,23,23,38,1357,1452
E01015881,4,14,20,20,1333,1391
E01015882,14,29,56,32,1477,1608
E01015839,8,57,62,30,1522,1679
E01015840,7,73,72,78,1510,1740
E01015841,18,107,85,113,2033,2356
E01015842,16,75,68,47,1672,1878
E01015843,12,39,78,31,1527,1687
E01015844,12,67,50,67,1594,1790
E01015851,14,84,38,58,1501,1695
E01015852,13,77,46,165,1434,1735
E01015853,4,56,33,43,1684,1820
E01015854,41,84,86,214,1603,2028
E01015855,32,120,66,162,1644,2024
E01015856,8,60,45,61,1587,1761
E01015889,7,21,25,77,1309,1439
E01015890,1,20,32,76,1387,1516
E01015891,7,23,34,20,1359,1443
E01015892,5,20,33,35,1610,1703
E01015893,6,2,6,59,1506,1579
E01015894,0,9,27,29,1470,1535
E01015914,3,27,30,118,1187,1365
E01015915,1,22,23,46,1370,1462
E01015916,16,81,27,57,1341,1522
E01015917,2,40,53,41,1543,1679
E01015918,7,7,19,22,1364,1419
E01015919,6,8,16,36,1247,1313
E01015920,1,3,15,32,1469,1520
E01015943,1,14,14,17,1440,1486
E01015944,2,10,2,4,1224,1242
E01015946,2,8,16,11,1499,1536
E01015997,2,20,12,10,1345,1389
E01015999,2,40,25,23,1297,1387
E01015945,7,5,20,6,1176,1214
E01015983,5,25,19,14,1392,1455
E01015987,7,40,23,5,1407,1482
E01015988,4,12,23,8,1417,1464
E01015998,1,6,11,19,1561,1598
E01015984,7,33,9,12,1251,1312
E01015985,4,12,11,2,1361,1390
E01015986,2,40,29,21,1412,1504
E01015990,1,19,16,16,1451,1503
E01016001,1,30,17,20,1283,1351
E01015977,8,29,40,37,1751,1865
E01015978,6,16,12,18,1229,1281
E01015979,13,35,33,37,1255,1373
E01015980,3,4,21,16,1552,1596
E01015989,12,48,29,87,1387,1563
E01015991,3,19,16,23,1364,1425
E01015992,1,24,19,34,1810,1888
E01016000,5,18,21,22,1348,1414
E01016002,4,35,9,31,1289,1368
E01015932,10,131,33,49,1362,1585
E01015971,1,81,25,27,1325,1459
E01015972,4,143,29,41,1487,1704
E01015973,8,172,33,51,1494,1758
E01015974,2,57,38,45,1279,1421
E01015975,10,87,25,35,1402,1559
E01015927,9,233,53,41,1521,1857
E01015928,6,90,23,32,1596,1747
E01015929,7,173,29,27,1267,1503
E01015930,9,146,32,36,1541,1764
E01015931,5,170,35,50,1064,1324
E01015976,7,130,15,33,1594,1779
E01015922,1,75,25,10,1407,1518
E01015923,7,105,37,30,1398,1577
E01015924,13,71,28,14,1425,1551
E01015925,12,116,29,15,1393,1565
E01015926,4,69,26,11,1415,1525
E01015957,11,118,29,79,1302,1539
E01015958,4,66,22,122,1101,1315
E01015993,3,42,20,34,1503,1602
E01015994,4,54,33,68,1397,1556
E01015995,8,53,12,131,1467,1671
E01015996,7,55,15,24,1530,1631
E01015963,6,39,22,33,1089,1189
E01015964,10,41,13,93,1398,1555
E01015965,3,31,12,28,1372,1446
E01015966,7,29,11,65,1468,1580
E01015933,7,92,29,16,1407,1551
E01015934,3,131,39,17,1306,1496
E01015935,5,146,29,29,1395,1604
E01015936,2,106,40,31,1518,1697
E01015937,2,89,17,18,1507,1633
E01015938,5,115,34,13,1717,1884
E01015947,5,48,25,15,1315,1408
E01015948,1,66,17,6,1448,1538
E01015949,2,40,21,18,1609,1690
E01015950,3,58,14,4,1649,1728
E01015960,5,37,12,117,1299,1470
E01015967,8,55,43,57,1359,1522
E01015968,9,85,29,66,1178,1367
E01015969,7,85,33,105,1507,1737
E01015970,8,57,29,72,1163,1329
E01015921,11,173,41,34,917,1176
E01016011,23,202,41,75,1172,1513
E01016012,20,441,69,109,1874,2513
E01016013,17,464,66,84,1571,2202
E01016014,12,446,88,94,1897,2537
E01016015,6,189,27,148,1343,1713
E01015955,14,114,36,89,1297,1550
E01015956,31,244,53,225,1506,2059
E01015959,27,156,52,208,1224,1667
E01015961,16,100,35,165,1186,1502
E01015962,1,213,57,167,1219,1657
E01015951,22,245,35,85,1294,1681
E01015952,25,414,30,200,1376,2045
E01015953,27,254,79,137,1585,2082
E01015954,33,274,85,163,1723,2278
E01016003,11,351,36,57,1511,1966
E01016004,7,172,25,34,1424,1662
E01016005,5,259,11,22,1259,1556
E01016006,13,174,29,13,1465,1694
E01016007,6,127,15,10,1331,1489
E01016008,9,261,23,18,1213,1524
E01016009,2,190,16,55,1444,1707
E01016010,4,168,28,36,1221,1457
E01015982,41,383,81,271,1790,2566
E01033610,27,307,98,221,995,1648
E01033611,17,345,63,145,1061,1631
E01033613,31,225,41,155,1087,1539
E01015939,26,176,44,84,1234,1564
E01015941,27,189,58,152,1022,1448
E01015942,10,145,58,84,1310,1607
E01033612,31,246,48,155,1100,1580
E01033614,22,347,69,131,1303,1872
E01017975,14,41,45,158,1394,1652
E01017976,16,46,36,152,1408,1658
E01017977,11,41,54,204,1307,1617
E01017978,23,52,75,184,1217,1551
E01017979,21,58,47,167,1265,1558
E01017980,10,15,27,106,948,1106
E01017949,10,16,59,187,1348,1620
E01017950,21,9,48,96,1190,1364
E01017951,21,56,38,139,1213,1467
E01017952,16,44,50,164,1218,1492
E01017953,12,27,37,318,1226,1620
E01017954,21,25,64,129,1268,1507
E01017971,21,23,43,198,1384,1669
E01017972,25,22,44,134,1397,1622
E01017973,55,28,66,57,1553,1759
E01017974,21,26,32,175,1484,1738
E01032792,28,28,27,105,1118,1306
E01032802,33,17,31,91,1139,1311
E01018006,22,18,40,136,1440,1656
E01018007,3,17,29,83,1480,1612
E01018008,24,37,52,105,1423,1641
E01018009,24,29,53,146,1683,1935
E01018010,12,13,67,117,1576,1785
E01017955,15,7,27,138,1282,1469
E01017956,12,12,52,192,1383,1651
E01017957,27,13,65,146,1271,1522
E01017958,58,49,214,898,3924,5143
E01017943,86,34,73,154,1404,1751
E01017944,29,38,52,95,1193,1407
E01017945,57,36,60,160,1413,1726
E01017946,32,55,53,120,1369,1629
E01017947,54,30,53,122,1412,1671
E01017948,11,68,60,146,1438,1723
E01017983,30,17,71,113,1665,1896
E01017984,28,10,43,208,1326,1615
E01017985,26,28,83,291,2177,2605
E01017986,59,34,137,594,2823,3647
E01032797,71,88,191,693,4211,5254
E01017987,28,34,65,185,1423,1735
E01017988,21,25,56,175,1416,1693
E01017989,45,43,71,220,1822,2201
E01017990,27,3,52,87,1078,1247
E01017991,48,23,60,191,1135,1457
E01017997,35,59,72,342,1776,2284
E01017998,30,26,52,105,1505,1718
E01017999,24,32,48,160,1537,1801
E01018000,24,37,58,107,1525,1751
E01018001,36,25,59,111,1467,1698
E01017965,42,23,54,161,1427,1707
E01017966,103,70,69,401,2060,2703
E01017967,22,46,71,255,1370,1764
E01017968,40,22,45,185,1297,1589
E01017969,20,31,69,212,1291,1623
E01017959,33,34,60,282,1284,1693
E01017960,36,21,33,212,1032,1334
E01017961,19,25,52,165,938,1199
E01017962,19,19,45,181,1361,1625
E01017963,26,23,34,262,1248,1593
E01017964,18,25,17,217,1059,1336
E01018002,11,16,52,156,1344,1579
E01018003,14,7,53,123,1377,1574
E01018005,32,50,66,266,1623,2037
E01032794,23,9,33,96,1115,1276
E01032795,34,32,41,193,1268,1568
E01017992,26,24,46,320,1482,1898
E01017993,24,59,49,295,1691,2118
E01017994,46,18,55,208,1325,1652
E01017995,20,12,39,165,1240,1476
E01017996,18,17,70,159,1719,1983
E01018042,6,8,16,20,1405,1455
E01018043,7,18,43,41,2012,2121
E01018044,3,5,25,39,1643,1715
E01018045,9,3,17,15,1303,1347
E01018046,6,20,22,22,2030,2100
E01018020,2,1,13,14,1475,1505
E01018021,1,11,8,8,1480,1508
E01018022,4,3,13,10,1381,1411
E01018055,5,6,23,11,1997,2042
E01018056,2,4,22,22,1860,1910
E01018027,4,3,32,32,1681,1752
E01018029,9,51,65,47,2370,2542
E01018032,16,25,33,44,2405,2523
E01018033,13,9,25,33,1852,1932
E01033426,13,14,42,50,1391,1510
E01033430,8,40,25,36,1405,1514
E01018024,2,14,14,8,1056,1094
E01018025,12,13,47,108,1365,1545
E01018026,4,10,19,35,1323,1391
E01018030,1,16,14,24,981,1036
E01033425,6,19,36,45,1877,1983
E01033428,10,11,37,40,1336,1434
E01018036,1,5,7,22,1608,1643
E01018037,0,1,9,7,1376,1393
E01018038,3,17,19,12,1519,1570
E01018039,2,1,11,20,1289,1323
E01018053,2,13,26,20,1646,1707
E01018054,8,9,49,24,2174,2264
E01018047,8,2,25,5,1867,1907
E01018049,7,5,27,22,1602,1663
E01018050,2,7,23,7,1356,1395
E01018051,3,13,27,14,1636,1693
E01018052,6,16,39,19,1698,1778
E01033427,1,21,21,20,1269,1332
E01033429,2,12,9,18,1890,1931
E01018034,9,5,14,17,1519,1564
E01018035,4,11,37,13,2139,2204
E01018040,1,16,22,9,1216,1264
E01018041,1,1,19,7,1086,1114
E01018013,5,3,12,6,1722,1748
E01018014,8,2,30,52,1715,1807
E01018015,2,4,13,6,1314,1339
E01018016,0,3,17,3,1392,1415
E01018011,1,2,17,36,2559,2615
E01018012,6,6,21,71,1295,1399
E01018057,2,3,30,23,1967,2025
E01018017,1,3,10,6,1243,1263
E01018019,5,11,12,8,1000,1036
E01018023,1,10,22,20,2200,2253
E01032611,8,0,23,24,1748,1803
E01018094,4,9,11,9,1730,1763
E01018095,0,5,6,12,1532,1555
E01018096,0,3,10,17,1546,1576
E01018097,1,3,2,8,1397,1411
E01018063,2,16,34,54,2225,2331
E01018073,3,10,18,34,2235,2300
E01018107,3,10,18,33,1616,1680
E01018108,13,5,35,40,1907,2000
E01018109,5,9,15,15,1818,1862
E01018069,5,1,14,14,1729,1763
E01018070,13,9,24,28,1627,1701
E01018071,3,4,11,15,1811,1844
E01018093,2,14,29,21,2305,2371
E01018103,6,2,10,12,1152,1182
E01018104,3,1,3,3,1212,1222
E01033111,3,2,22,29,1365,1421
E01033112,15,11,21,27,1090,1164
E01018066,2,6,13,7,1421,1449
E01018067,0,8,4,13,1787,1812
E01018068,2,9,17,6,1500,1534
E01018090,1,1,15,31,1720,1768
E01018091,0,2,14,14,1393,1423
E01018092,3,13,22,13,1653,1704
E01018081,8,101,48,81,1680,1918
E01018082,5,6,11,24,1885,1931
E01018083,9,21,31,39,1850,1950
E01018084,1,15,19,1,2000,2036
E01018064,0,6,24,33,1939,2002
E01018072,8,6,19,19,1645,1697
E01018074,3,3,7,5,1203,1221
E01018075,2,2,9,14,1212,1239
E01018098,3,1,10,7,1220,1241
E01018099,0,0,5,12,1248,1265
E01018100,1,4,17,6,1171,1199
E01018101,0,6,10,6,1311,1333
E01018077,2,10,14,40,1693,1759
E01018078,0,2,9,10,1619,1640
E01018079,2,16,15,1,1678,1712
E01018080,1,9,19,26,2264,2319
E01018058,0,5,7,9,1527,1548
E01018059,2,12,20,21,1277,1332
E01018060,0,0,20,18,1808,1846
E01018061,0,4,10,12,1246,1272
E01018085,1,8,0,5,1703,1717
E01018086,0,4,13,11,1679,1707
E01018087,2,13,13,37,1973,2038
E01018088,1,12,20,20,1518,1571
E01018065,2,6,17,12,2144,2181
E01018076,3,8,16,6,2055,2088
E01018111,1,4,23,36,2147,2211
E01018062,4,10,28,23,2447,2512
E01018102,5,19,23,21,2509,2577
E01018105,1,3,13,12,1126,1155
E01018106,0,13,14,24,1500,1551
E01018110,2,15,29,29,2583,2658
E01018212,0,24,36,34,1578,1672
E01018213,6,18,27,34,1810,1895
E01018214,3,21,38,43,1868,1973
E01018215,1,11,20,25,1341,1398
E01018216,6,30,29,55,2341,2461
E01018217,11,10,17,25,1579,1642
E01018127,8,3,18,16,1470,1515
E01018128,5,1,7,18,1121,1152
E01018200,0,6,7,9,1626,1648
E01018201,2,3,20,4,1414,1443
E01018156,2,1,9,9,1659,1680
E01018157,3,17,17,21,1985,2043
E01018158,6,19,16,46,1593,1680
E01018159,1,1,16,15,1375,1408
E01018160,2,8,12,26,1620,1668
E01018191,4,7,14,3,1167,1195
E01018192,2,4,26,20,1392,1444
E01018193,0,6,19,10,1153,1188
E01018194,6,4,17,17,1366,1410
E01018195,1,7,19,10,1262,1299
E01018208,4,5,17,14,1594,1634
E01018209,1,11,7,36,1425,1480
E01018210,2,5,20,11,1364,1402
E01018211,6,7,15,20,1790,1838
E01018196,1,1,8,6,1244,1260
E01018197,4,3,16,11,1466,1500
E01018198,5,13,29,12,1600,1659
E01018199,2,3,13,12,1486,1516
E01018206,3,23,31,75,1778,1910
E01018207,4,2,13,12,1499,1530
E01018121,0,4,14,11,1332,1361
E01018122,0,1,11,7,1137,1156
E01018123,1,5,13,28,1559,1606
E01018124,2,3,13,7,1978,2003
E01018143,0,23,23,52,1553,1651
E01018144,12,45,55,104,1281,1497
E01018145,1,47,45,142,1088,1323
E01018146,2,66,54,196,1852,2170
E01018147,11,67,39,121,1498,1736
E01018139,1,12,34,74,1425,1546
E01018140,4,20,32,50,1177,1283
E01018141,18,14,27,52,1493,1604
E01018142,8,22,24,45,1425,1524
E01018113,2,11,29,28,1417,1487
E01018116,1,8,15,26,1227,1277
E01018117,1,4,13,31,1576,1625
E01018118,7,32,20,25,1876,1960
E01033433,13,63,64,29,2053,2222
E01018161,0,5,24,52,1300,1381
E01018162,2,16,34,32,1532,1616
E01018163,1,27,25,53,1328,1434
E01018164,3,29,29,68,1152,1281
E01018165,6,15,13,76,1177,1287
E01018170,1,2,20,66,1310,1399
E01018171,2,7,29,52,1381,1471
E01018138,8,19,33,99,1765,1924
E01018148,37,56,59,180,2172,2504
E01018149,15,32,36,63,1333,1479
E01018150,15,43,35,90,1541,1724
E01018151,29,66,46,156,1470,1767
E01018166,3,4,16,121,1412,1556
E01018167,4,6,21,90,1344,1465
E01018168,17,13,44,148,1703,1925
E01018169,3,7,19,123,1417,1569
E01018131,3,8,23,37,1482,1553
E01018132,3,13,38,46,1532,1632
E01018133,9,24,36,20,1587,1676
E01018134,7,17,30,31,1765,1850
E01018125,9,8,33,14,1502,1566
E01018126,4,0,17,9,1579,1609
E01018152,0,3,15,8,1480,1506
E01018153,0,12,21,33,1781,1847
E01018129,2,12,32,40,1455,1541
E01018130,1,5,20,19,1656,1701
E01018202,4,3,10,8,1418,1443
E01018203,3,3,16,28,1334,1384
E01018204,1,10,10,15,1356,1392
E01018205,5,10,26,26,1750,1817
E01018115,18,174,64,86,2084,2426
E01018119,1,2,13,12,1476,1504
E01018120,4,4,11,7,1763,1789
E01018137,3,3,19,19,1670,1714
E01018135,6,46,95,73,2722,2942
E01018136,1,9,17,3,1718,1748
E01018154,3,8,23,12,1710,1756
E01018155,4,7,6,13,1458,1488
E01018187,9,28,35,44,1808,1924
E01018188,4,4,17,39,1406,1470
E01018189,2,4,18,35,1263,1322
E01018190,0,9,22,40,1485,1556
E01018172,1,15,8,10,1371,1405
E01018173,1,6,11,25,1140,1183
E01018174,1,7,23,22,1519,1572
E01018175,1,10,12,16,1343,1382
E01018176,0,1,15,22,1235,1273
E01018181,0,18,41,37,2666,2762
E01018182,3,8,22,14,1442,1489
E01018183,1,13,11,15,1436,1476
E01018184,1,13,26,36,1269,1345
E01018185,2,10,23,35,1580,1650
E01018186,2,23,37,19,1674,1755
E01018177,2,2,10,10,1478,1502
E01018178,2,8,21,29,1415,1475
E01018179,0,7,21,26,1353,1407
E01018180,1,7,21,11,1280,1320
E01018304,3,7,36,21,1781,1848
E01018305,0,1,8,5,1318,1332
E01018306,10,9,9,13,1489,1530
E01018307,1,11,41,43,2071,2167
E01018233,1,2,24,27,1521,1575
E01018234,8,12,21,34,1597,1672
E01018235,4,19,30,32,1599,1684
E01018236,6,17,27,52,1510,1612
E01018237,8,5,21,29,1464,1527
E01018266,4,22,54,121,2456,2657
E01018284,12,8,28,12,1204,1264
E01018285,4,11,17,22,1145,1199
E01018298,27,80,37,51,1626,1821
E01018299,6,15,25,39,1569,1654
E01018300,6,9,17,21,1109,1162
E01018301,4,24,24,33,1292,1377
E01018221,8,15,30,100,1506,1659
E01018222,7,12,11,53,1426,1509
E01018223,7,16,42,49,1766,1880
E01018257,10,9,29,54,1261,1363
E01018258,8,11,31,22,1554,1626
E01018259,8,6,27,85,1199,1325
E01018260,5,13,14,25,1723,1780
E01018262,6,10,14,37,1392,1459
E01033120,13,29,49,148,1220,1459
E01033121,8,71,62,186,1261,1588
E01018272,5,11,32,85,1199,1332
E01018273,6,10,33,49,1509,1607
E01018274,5,29,51,189,1466,1740
E01018297,4,11,23,25,1619,1682
E01018224,5,3,31,44,1345,1428
E01018225,0,2,11,27,1038,1078
E01018248,20,16,57,190,2055,2338
E01018249,2,8,9,39,949,1007
E01018250,18,10,26,65,1095,1214
E01018231,13,16,38,96,2315,2478
E01018232,3,17,38,46,2242,2346
E01018251,3,6,20,58,1133,1220
E01018252,16,4,39,49,1342,1450
E01018255,0,0,15,16,1118,1149
E01018242,7,22,24,75,1152,1280
E01018243,9,36,27,365,1328,1765
E01018244,5,5,31,32,1555,1628
E01018286,25,16,41,197,1333,1612
E01018287,26,24,51,293,937,1331
E01018296,5,5,17,27,1025,1079
E01018292,16,4,26,86,1276,1408
E01018293,6,6,35,45,1389,1481
E01018294,6,24,22,56,1538,1646
E01018295,5,3,32,50,1479,1569
E01018245,4,4,19,20,1653,1700
E01018246,2,11,28,7,1580,1628
E01018247,4,2,12,15,1539,1572
E01018275,6,9,33,12,2269,2329
E01018240,1,2,19,15,1195,1232
E01018253,2,11,29,44,994,1080
E01018254,3,7,26,54,1232,1322
E01018256,3,9,27,17,1451,1507
E01018291,5,3,21,23,1166,1218
E01018279,7,12,18,49,1406,1492
E01018280,2,8,17,60,1419,1506
E01018281,3,17,23,71,1450,1564
E01018282,2,10,19,36,1242,1309
E01018283,7,10,22,25,1210,1274
E01018218,5,4,22,22,1717,1770
E01018219,2,5,13,10,1375,1405
E01018220,3,13,19,8,1464,1507
E01018263,2,8,22,28,1418,1478
E01018264,1,2,16,10,1577,1606
E01018265,1,17,11,21,1712,1762
E01018238,4,2,7,18,1424,1455
E01018239,6,2,9,14,1322,1353
E01018288,3,4,17,12,1119,1155
E01018289,2,14,18,24,1095,1153
E01018302,0,20,25,23,1431,1499
E01018303,1,2,10,22,1166,1201
E01018241,2,4,19,23,1158,1206
E01018267,4,16,21,19,2268,2328
E01018268,3,7,31,16,1848,1905
E01018269,2,7,9,22,1337,1377
E01018270,0,8,25,11,1076,1120
E01018271,13,7,17,21,1373,1431
E01018226,9,23,29,30,1434,1525
E01018227,2,10,17,21,1846,1896
E01018228,1,3,20,7,1636,1667
E01018290,8,8,21,15,2352,2404
E01033113,7,22,48,113,930,1120
E01033114,17,27,61,133,1301,1539
E01033115,5,35,25,115,1227,1407
E01033117,24,35,40,102,1113,1314
E01033119,13,46,55,210,1481,1805
E01018276,10,32,26,192,1171,1431
E01018277,6,3,16,26,1668,1719
E01018278,18,12,26,124,1558,1738
E01033116,6,19,25,71,1565,1686
E01033118,11,4,34,91,1323,1463
E01021237,3,5,7,38,1331,1384
E01021238,1,7,18,36,1325,1387
E01021242,0,7,16,18,1186,1227
E01021250,1,7,16,33,1491,1548
E01021251,2,2,12,33,1538,1587
E01021245,1,17,25,25,1381,1449
E01021246,1,15,18,32,1412,1478
E01021248,0,5,21,36,1371,1433
E01021249,5,9,30,28,1487,1559
E01021252,5,2,12,25,1384,1428
E01021239,0,4,25,35,1379,1443
E01021240,6,14,22,52,1534,1628
E01021241,13,28,26,13,1493,1573
E01021243,7,8,15,20,1639,1689
E01021247,8,11,18,36,1409,1482
E01021244,0,2,7,45,1392,1446
E01021253,1,4,13,49,1632,1699
E01021255,3,9,22,32,1297,1363
E01021256,1,3,16,21,1424,1465
E01021258,3,6,16,24,1540,1589
E01021334,3,8,21,30,1642,1704
E01021336,2,24,20,22,1560,1628
E01021338,2,24,30,13,1386,1455
E01021339,5,24,12,31,1317,1389
E01021264,0,8,9,42,1389,1448
E01021329,4,13,18,36,1423,1494
E01021330,5,28,13,47,1496,1589
E01021332,2,2,14,22,1389,1429
E01021333,1,23,14,23,1492,1553
E01021335,4,8,11,35,1370,1428
E01021337,1,8,13,17,1371,1410
E01021340,1,13,33,17,1546,1610
E01021341,1,18,23,19,1550,1611
E01021345,13,21,34,53,1882,2003
E01021331,1,20,12,67,1437,1537
E01021342,5,19,22,16,1540,1602
E01021343,2,12,14,50,1682,1760
E01021344,4,38,35,47,2089,2213
E01021346,11,21,36,42,1849,1959
E01021254,10,14,18,24,1391,1457
E01021257,1,14,19,5,1478,1517
E01021259,0,8,20,26,1476,1530
E01021260,5,16,14,18,2335,2388
E01021261,2,22,17,44,1620,1705
E01021262,6,17,24,27,1489,1563
E01021263,4,52,26,37,1720,1839
E01021274,4,26,31,56,1750,1867
E01021279,5,41,49,22,1520,1637
E01021301,3,59,27,26,1403,1518
E01021303,3,46,22,22,1235,1328
E01021307,8,56,28,34,1208,1334
E01021308,4,21,20,14,1227,1286
E01021309,6,70,18,27,1200,1321
E01021312,1,20,15,6,1556,1598
E01021265,7,60,30,31,1422,1550
E01021267,1,50,21,19,1625,1716
E01021269,3,75,51,14,1522,1665
E01021270,10,49,26,25,1392,1502
E01021272,2,28,37,26,1510,1603
E01021271,3,158,45,68,1491,1765
E01021302,3,63,38,18,1426,1548
E01021304,1,64,21,15,1351,1452
E01021305,1,99,23,23,1319,1465
E01021306,5,63,34,18,1350,1470
E01021273,3,43,44,38,1555,1683
E01021275,10,61,30,57,1491,1649
E01021276,10,53,29,70,1284,1446
E01021277,6,23,31,26,1330,1416
E01021278,4,58,32,25,1550,1669
E01021266,4,39,23,57,1535,1658
E01021268,3,27,22,26,1581,1659
E01021318,4,120,48,168,1703,2043
E01021320,2,127,41,50,1431,1651
E01021321,11,91,41,67,1400,1610
E01021286,19,147,40,68,1460,1734
E01021288,13,107,69,37,1585,1811
E01021289,5,88,48,42,1609,1792
E01021290,5,62,54,25,1629,1775
E01021291,6,65,40,131,1425,1667
E01021287,0,51,17,108,1330,1506
E01021292,0,41,19,83,1375,1518
E01021293,5,81,28,174,1397,1685
E01021298,1,25,22,70,1470,1588
E01021319,7,95,34,100,1347,1583
E01021313,7,26,19,21,1394,1467
E01021314,5,64,20,36,1248,1373
E01021315,5,55,20,16,1403,1499
E01021316,7,41,41,44,1358,1491
E01021317,7,110,40,72,1396,1625
E01021322,0,110,34,24,1355,1523
E01021323,1,108,43,40,1568,1760
E01021324,7,52,46,28,1518,1651
E01021325,12,150,47,44,1312,1565
E01021327,2,48,36,28,1574,1688
E01021294,0,26,34,68,1488,1616
E01021295,4,66,26,32,1557,1685
E01021296,6,44,36,107,1527,1720
E01021297,23,70,33,235,1277,1638
E01021299,6,17,19,112,1358,1512
E01021280,5,35,18,64,1405,1527
E01021281,4,22,18,78,1372,1494
E01021282,2,9,26,53,1437,1527
E01021283,6,45,31,37,1462,1581
E01021284,2,33,17,64,1464,1580
E01021285,3,11,15,61,1265,1355
E01021300,1,91,53,49,1913,2107
E01021310,2,58,15,33,1226,1334
E01021311,3,71,22,27,1226,1349
E01021326,8,111,30,33,1636,1818
E01021328,10,120,23,33,1380,1566
E01021375,0,0,14,11,1127,1152
E01021376,0,5,11,12,1378,1406
E01021414,1,5,16,19,2104,2145
E01021430,3,10,28,14,2120,2175
E01021398,1,6,6,3,1477,1493
E01021406,6,1,12,3,2144,2166
E01021407,3,1,22,8,2146,2180
E01021382,0,0,7,4,1281,1292
E01021397,2,3,12,9,1738,1764
E01021399,5,2,12,4,1583,1606
E01021400,0,4,12,22,1649,1687
E01021387,4,12,23,43,1886,1968
E01021388,2,3,20,13,1585,1623
E01021391,2,9,17,12,1672,1712
E01021392,3,6,17,9,1636,1671
E01021393,4,5,10,11,1479,1509
E01021404,2,1,21,12,2027,2063
E01021411,0,1,6,3,1217,1227
E01021412,5,1,4,6,1455,1471
E01021413,0,2,9,2,1256,1269
E01021389,11,1,13,14,1787,1826
E01021390,2,2,11,22,1560,1597
E01021408,1,11,15,10,1741,1778
E01021409,0,1,7,6,1792,1806
E01021410,2,1,12,31,1611,1657
E01021349,1,4,28,33,1358,1424
E01021351,12,21,21,60,1470,1584
E01021352,1,13,16,27,1620,1677
E01021355,1,4,26,25,1954,2010
E01021356,1,3,7,15,1397,1423
E01021381,0,3,21,7,1142,1173
E01021354,6,15,22,24,1228,1295
E01021357,3,5,16,11,1479,1514
E01021358,1,39,45,56,2089,2230
E01021359,3,17,28,21,1983,2052
E01021350,3,20,28,38,1630,1719
E01021353,6,7,19,25,1722,1779
E01021365,8,41,45,39,2158,2291
E01033458,6,40,36,51,1180,1313
E01033459,4,26,25,43,1721,1819
E01021364,3,3,20,33,1583,1642
E01021366,8,1,25,41,1482,1557
E01021383,1,19,37,35,2044,2136
E01021405,3,13,17,26,2240,2299
E01021368,6,4,21,38,1454,1523
E01021370,3,16,20,26,1574,1639
E01021372,4,19,22,35,1745,1825
E01021373,5,23,51,52,2260,2391
E01021374,7,17,21,32,1458,1535
E01021360,3,9,24,20,1945,2001
E01021361,0,11,13,12,1588,1624
E01021367,3,10,21,32,1442,1508
E01021369,3,56,41,110,2677,2887
E01021380,0,8,24,25,2254,2311
E01021347,3,17,29,11,2418,2478
E01021371,13,5,20,23,1665,1726
E01021384,6,6,29,31,2262,2334
E01021385,5,6,23,20,1277,1331
E01021386,0,8,27,25,1590,1650
E01021377,1,4,17,6,1728,1756
E01021378,1,8,18,10,1573,1610
E01021379,0,2,13,9,1811,1835
E01021401,1,2,19,5,1482,1509
E01021402,2,3,26,33,2014,2078
E01021403,4,5,22,4,1526,1561
E01021362,0,7,23,27,1430,1487
E01021417,1,12,25,12,1456,1506
E01021418,8,12,12,11,1448,1491
E01021419,0,11,26,27,1597,1661
E01021426,1,6,17,33,1250,1307
E01021428,1,6,14,12,1370,1403
E01021423,1,27,49,35,1458,1570
E01021425,0,12,22,8,1495,1537
E01021427,1,12,42,30,1284,1369
E01021429,4,16,27,8,1289,1344
E01021415,0,13,19,35,1392,1459
E01021416,0,8,20,37,1536,1601
E01021420,4,22,20,39,1572,1657
E01021422,3,7,26,13,1585,1634
E01033460,3,19,21,30,1143,1216
E01033461,2,18,38,21,1423,1502
E01033462,1,22,20,48,975,1066
E01021348,5,7,23,13,1528,1576
E01021394,5,7,14,23,1395,1444
E01021395,1,4,10,8,1447,1470
E01021396,1,1,10,2,1448,1462
E01021424,7,38,39,54,1892,2030
E01021441,2,8,18,9,1468,1505
E01021442,0,4,8,12,1324,1348
E01021443,2,11,12,11,1460,1496
E01021444,1,9,13,5,1581,1609
E01021469,4,5,11,10,1125,1155
E01021470,0,7,8,7,1057,1079
E01021471,1,7,15,5,1545,1573
E01021457,0,5,12,4,1378,1399
E01021458,9,5,25,27,1567,1633
E01021459,2,5,10,20,1278,1315
E01021460,3,6,16,45,1549,1619
E01021448,7,14,22,29,1333,1405
E01021449,4,33,23,32,1504,1596
E01021450,3,57,32,66,1907,2065
E01021451,3,62,44,55,1387,1551
E01021452,1,7,16,37,1406,1467
E01021431,3,28,21,68,1446,1566
E01021432,10,32,26,88,1525,1681
E01021434,8,15,24,28,1235,1310
E01021461,2,21,23,35,1369,1450
E01021464,5,11,21,43,1487,1567
E01021447,20,12,42,93,2283,2450
E01021453,1,13,14,72,1118,1218
E01021455,6,10,7,69,1260,1352
E01021465,14,6,25,73,1754,1872
E01021466,23,7,26,61,1695,1812
E01021467,7,14,25,61,1641,1748
E01021438,4,28,45,113,1835,2025
E01021462,1,15,21,26,1330,1393
E01021463,9,11,23,36,1474,1553
E01021468,3,37,35,84,1732,1891
E01021433,6,27,45,79,1771,1928
E01021436,14,55,49,133,1950,2201
E01021439,20,46,62,141,2043,2312
E01021475,9,29,33,126,1319,1516
E01033063,11,21,37,55,1216,1340
E01033064,16,18,31,67,1238,1370
E01021435,8,24,50,80,1696,1858
E01021437,10,52,43,43,1582,1730
E01021472,13,39,47,72,1362,1533
E01021473,5,31,30,67,1218,1351
E01021474,1,10,15,30,1517,1573
E01021445,10,6,40,23,2096,2175
E01021446,6,3,18,27,1483,1537
E01021454,4,19,20,22,1180,1245
E01021456,0,11,13,61,1144,1229
E01021513,0,13,11,19,1581,1624
E01021514,6,17,27,7,1461,1518
E01021515,2,4,17,12,1317,1352
E01021525,1,14,28,26,1439,1508
E01021527,3,8,23,12,1626,1672
E01021509,0,7,9,24,1326,1366
E01021510,0,10,11,22,1407,1450
E01021511,1,23,16,44,1244,1328
E01021528,4,8,7,14,1579,1612
E01021531,3,9,8,13,1340,1373
E01021476,2,25,13,44,1821,1905
E01021477,0,3,19,35,1483,1540
E01021478,10,14,24,41,1635,1724
E01021516,5,7,23,33,1296,1364
E01021479,1,10,8,18,1488,1525
E01021481,3,20,9,7,1510,1549
E01021483,0,18,7,33,1689,1747
E01021512,4,8,11,21,1520,1564
E01021526,1,3,13,8,1592,1617
E01021517,2,5,22,12,1561,1602
E01021519,3,1,13,6,1448,1471
E01021530,3,3,10,9,1401,1426
E01021532,5,1,8,6,1430,1450
E01021482,2,13,25,22,1565,1627
E01021518,5,9,32,26,1845,1917
E01021520,2,23,23,34,1481,1563
E01021529,6,18,28,40,1406,1498
E01021480,1,12,27,36,1753,1829
E01021521,1,12,17,3,1389,1422
E01021522,7,14,32,22,1670,1745
E01021523,2,6,12,34,1313,1367
E01021524,0,7,9,6,1564,1586
E01021487,7,10,17,12,1329,1375
E01021494,1,18,13,15,1443,1490
E01021504,2,20,20,33,1439,1514
E01021505,5,31,12,7,1358,1413
E01021506,5,15,11,14,1275,1320
E01021492,0,11,3,13,1716,1743
E01021493,0,1,10,13,1525,1549
E01021495,1,3,4,10,1993,2011
E01021496,0,18,11,13,1390,1432
E01021485,3,8,10,14,1221,1256
E01021486,8,1,14,7,1244,1274
E01021488,1,7,13,6,1441,1468
E01021503,2,7,27,15,1363,1414
E01021507,2,22,32,29,1515,1600
E01021508,1,9,24,9,1339,1382
E01021484,1,23,12,13,1321,1370
E01021498,0,5,16,13,1454,1488
E01021499,4,5,16,7,1637,1669
E01021501,0,15,11,21,1367,1414
E01021502,3,33,20,16,2153,2225
E01021489,4,9,11,2,1390,1416
E01021490,13,7,30,21,1422,1493
E01021491,3,1,14,3,1642,1663
E01021497,0,20,11,7,1457,1495
E01021500,3,17,7,10,1659,1696
E01021538,4,8,39,45,2613,2709
E01021539,1,1,9,11,1276,1298
E01021540,5,10,17,11,1491,1534
E01021541,8,16,12,45,1384,1465
E01021542,45,35,37,106,1829,2052
E01021543,3,3,21,39,1648,1714
E01021587,7,16,8,60,1369,1460
E01021590,12,20,17,57,1366,1472
E01021591,10,27,26,64,1372,1499
E01021550,10,1,15,14,1364,1404
E01021597,5,37,34,46,1344,1466
E01021598,2,33,28,24,1389,1476
E01021600,5,25,18,38,1087,1173
E01021601,5,23,30,52,1448,1558
E01021616,5,25,9,37,1365,1441
E01021617,0,13,28,46,1281,1368
E01021619,3,10,12,61,1427,1513
E01021620,3,34,29,46,1338,1450
E01021623,4,37,29,52,1128,1250
E01021624,5,11,6,24,1186,1232
E01021536,2,15,21,30,1508,1576
E01021537,2,24,20,87,1888,2021
E01021568,30,3,13,8,1532,1586
E01033142,5,36,48,101,1984,2174
E01033144,16,43,49,113,1631,1852
E01021576,6,19,39,88,1485,1637
E01021588,2,18,21,84,1287,1412
E01021589,4,48,22,62,1368,1504
E01021592,1,54,33,106,1398,1592
E01021596,4,50,41,103,1373,1571
E01021618,11,15,33,56,1369,1484
E01021621,5,25,29,67,1425,1551
E01021622,7,9,22,32,1397,1467
E01021625,3,14,15,52,1369,1453
E01021626,17,14,30,31,1323,1415
E01021544,1,19,21,42,1228,1311
E01021545,6,11,16,46,1539,1618
E01021546,3,9,19,50,1377,1458
E01021547,8,32,48,50,1420,1558
E01021628,0,34,47,62,1543,1686
E01021629,7,27,39,61,1525,1659
E01021573,20,55,27,121,1493,1716
E01021575,14,42,34,111,1497,1698
E01021599,18,10,32,69,1708,1837
E01021631,18,22,39,85,1736,1900
E01033138,2,11,16,65,1421,1515
E01033139,23,53,50,112,1223,1461
E01021574,32,137,74,230,1877,2350
E01021578,9,51,38,79,1521,1698
E01021582,15,32,59,79,1663,1848
E01021627,3,57,42,46,1387,1535
E01033140,13,16,20,91,971,1111
E01033141,11,20,25,66,901,1023
E01021551,1,2,14,5,1338,1360
E01021632,0,4,19,22,1398,1443
E01021633,6,10,21,20,1327,1384
E01021634,2,4,18,29,1468,1521
E01021635,2,7,25,9,1340,1383
E01021636,4,14,21,15,1041,1095
E01021556,2,26,27,74,1526,1655
E01021577,4,21,24,90,1332,1471
E01021579,10,36,39,76,1449,1610
E01021580,6,9,36,50,1339,1440
E01021584,4,6,15,41,1161,1227
E01021548,3,12,17,45,1229,1306
E01021560,4,14,13,29,1590,1650
E01021561,15,3,21,35,1714,1788
E01021564,1,8,15,37,1431,1492
E01021571,19,13,14,29,1537,1612
E01021562,2,16,45,24,1675,1762
E01021563,9,51,37,97,1491,1685
E01021565,2,9,27,23,1530,1591
E01021566,1,14,35,20,1650,1720
E01033137,5,20,43,48,1461,1577
E01033145,2,9,26,41,1307,1385
E01021557,6,8,10,14,1226,1264
E01021558,6,3,13,30,1214,1266
E01021583,3,24,20,68,1460,1575
E01021585,3,7,9,48,1205,1272
E01021586,1,18,18,42,1471,1550
E01021533,2,7,15,10,2236,2270
E01021535,9,15,13,17,1736,1790
E01021569,8,12,29,19,1543,1611
E01021570,7,7,18,39,1871,1942
E01021572,2,13,22,26,1471,1534
E01021552,1,12,35,13,1477,1538
E01021553,1,15,12,34,1320,1382
E01021554,4,28,29,16,1363,1440
E01021555,0,10,20,8,1340,1378
E01021559,4,16,22,16,1447,1505
E01021602,2,6,20,15,1633,1676
E01021604,2,2,21,9,2252,2286
E01033143,2,7,24,27,2529,2589
E01021611,8,0,16,22,1455,1501
E01021612,5,2,22,34,1464,1527
E01021613,3,16,19,13,1767,1818
E01021614,2,7,12,23,1723,1767
E01021615,1,9,11,18,1435,1474
E01021605,5,4,12,11,1218,1250
E01021606,0,16,27,29,1643,1715
E01021607,2,4,20,19,1472,1517
E01021608,2,5,12,20,1106,1145
E01021609,2,14,16,18,1374,1424
E01021610,1,14,18,19,1263,1315
E01021593,7,16,17,10,1615,1665
E01021594,1,11,25,16,1574,1627
E01021595,2,5,11,37,1674,1729
E01021655,5,7,15,27,1340,1394
E01021656,4,9,14,4,1518,1549
E01021659,2,9,28,30,2010,2079
E01021661,1,9,27,30,1709,1776
E01021668,42,46,27,79,1457,1651
E01021669,16,20,36,56,1397,1525
E01021670,9,32,28,97,1384,1550
E01021671,11,17,30,66,1333,1457
E01033720,51,43,40,96,1782,2012
E01033721,20,53,35,138,1546,1792
E01021660,1,1,17,7,1451,1477
E01021728,2,3,15,16,1600,1636
E01021729,2,1,28,14,1663,1708
E01021730,2,2,13,36,1677,1730
E01021679,32,48,68,193,2019,2360
E01021680,16,36,54,185,2535,2826
E01021681,20,47,73,98,2452,2690
E01021682,45,69,77,246,2252,2689
E01021646,32,31,68,133,1759,2023
E01021647,31,22,61,99,1578,1791
E01021648,40,49,64,135,2068,2356
E01021649,45,30,57,91,1651,1874
E01021650,31,51,43,202,1625,1952
E01021696,4,29,35,63,1428,1559
E01021697,8,20,32,77,1523,1660
E01021698,23,71,45,68,1300,1507
E01021699,6,64,35,90,1295,1490
E01021700,22,42,45,67,1335,1511
E01033719,200,138,72,363,894,1667
E01033722,52,66,45,111,1323,1597
E01021673,24,9,14,42,1337,1426
E01021674,3,13,16,55,1271,1358
E01021675,6,16,13,53,1224,1312
E01021676,15,10,32,57,1339,1453
E01021654,3,9,29,32,1842,1915
E01021662,3,1,13,6,1573,1596
E01021663,4,1,10,13,1071,1099
E01021677,0,1,4,9,1198,1212
E01021678,0,9,18,8,1304,1339
E01021683,18,67,44,43,2196,2368
E01021684,7,31,27,50,1400,1515
E01021685,53,33,76,96,1659,1917
E01021686,77,24,54,118,1575,1848
E01021687,13,31,48,59,1479,1630
E01021688,9,18,30,40,1307,1404
E01021718,8,22,27,52,1412,1521
E01021719,2,5,30,45,1459,1541
E01021720,8,6,26,31,1490,1561
E01021721,9,4,23,32,1917,1985
E01021722,9,7,21,40,1598,1675
E01021651,20,23,57,76,1450,1626
E01021652,13,19,37,56,1399,1524
E01021653,9,6,18,22,1277,1332
E01021717,31,18,32,29,1616,1726
E01021689,1,6,12,46,1388,1453
E01021690,6,2,15,28,1269,1320
E01021691,1,5,34,38,1388,1466
E01021692,5,1,23,75,1389,1493
E01021693,2,3,34,44,1581,1664
E01021711,8,28,32,12,1215,1295
E01021713,3,12,26,30,1120,1191
E01021714,13,71,51,93,1554,1782
E01021715,1,26,23,31,1381,1462
E01033723,22,176,67,129,2236,2630
E01021657,8,5,24,15,1530,1582
E01021658,4,7,32,21,987,1051
E01021664,26,35,46,49,1889,2045
E01021665,21,20,35,15,1273,1364
E01021666,13,17,23,50,1192,1295
E01021667,12,13,39,31,1382,1477
E01021736,128,299,97,628,2239,3391
E01021737,12,12,15,41,1152,1232
E01021738,29,4,52,60,1959,2104
E01021739,28,17,14,35,1469,1563
E01021740,31,10,29,39,1626,1735
E01021637,0,21,11,27,1125,1184
E01021638,6,16,11,27,1184,1244
E01021639,6,44,42,35,1848,1975
E01021640,5,5,14,14,1167,1205
E01021641,5,17,24,26,1331,1403
E01021642,24,41,53,114,1771,2003
E01021643,1,6,18,10,2413,2448
E01021644,0,3,11,6,1690,1710
E01021645,8,3,14,5,1463,1493
E01021694,4,3,9,19,1412,1447
E01021695,0,0,10,13,1126,1149
E01021723,1,3,9,16,1612,1641
E01021724,0,0,6,14,1650,1670
E01021725,0,0,3,3,1284,1290
E01021726,5,6,13,12,1491,1527
E01021727,0,3,7,3,1442,1455
E01021731,1,5,7,6,1426,1445
E01021732,1,4,12,11,1495,1523
E01021733,0,0,10,8,1483,1501
E01021734,2,2,3,3,1347,1357
E01021735,1,1,6,10,1339,1357
E01021702,15,26,36,64,1190,1331
E01021703,5,10,20,68,1172,1275
E01021704,6,25,27,61,1397,1516
E01021705,2,34,22,31,1945,2034
E01021706,65,31,32,101,1123,1352
E01021707,2,8,20,47,1289,1366
E01021708,8,8,19,40,1346,1421
E01021709,11,13,19,17,1374,1434
E01021710,9,20,15,53,1855,1952
E01021768,12,16,26,16,2068,2138
E01021795,6,23,19,23,1943,2014
E01021797,2,3,20,17,1272,1314
E01021798,6,13,18,33,1466,1536
E01021799,4,13,36,32,1542,1627
E01021741,9,7,26,23,1905,1970
E01021792,9,6,15,18,1157,1205
E01021793,7,9,20,18,1469,1523
E01021794,3,3,17,19,1104,1146
E01021801,20,11,31,25,2106,2193
E01021769,1,4,16,17,2199,2237
E01021796,4,9,13,7,2089,2122
E01021800,13,9,28,86,2120,2256
E01021753,6,3,15,7,1376,1407
E01021754,1,7,27,20,1483,1538
E01021755,1,2,8,2,1088,1101
E01021802,9,24,24,23,2125,2205
E01021760,1,7,37,32,1435,1512
E01021761,7,28,35,54,1726,1850
E01021762,3,17,33,19,1308,1380
E01021763,4,10,43,29,1410,1496
E01021756,1,7,27,41,1451,1527
E01021757,5,19,26,59,1517,1626
E01021758,1,20,25,50,1452,1548
E01021759,2,22,19,29,1419,1491
E01021811,11,59,44,25,1225,1364
E01021813,7,48,42,27,1262,1386
E01021814,8,51,32,12,1428,1531
E01021815,19,93,33,28,1374,1547
E01021816,9,27,27,17,1248,1328
E01021807,8,72,34,39,1381,1534
E01021808,4,38,22,26,1396,1486
E01021809,4,42,24,42,1313,1425
E01021810,15,48,62,67,1630,1822
E01021817,12,107,77,77,2218,2491
E01021806,19,59,37,31,2090,2236
E01021812,0,17,27,13,1184,1241
E01021818,9,71,67,44,1567,1758
E01021770,6,17,47,30,1913,2013
E01021803,6,3,21,13,1284,1327
E01021804,3,8,16,30,1384,1441
E01021805,3,3,19,4,1265,1294
E01021774,4,38,35,10,1322,1409
E01021775,8,53,50,25,1321,1457
E01021776,3,18,30,42,1274,1367
E01021777,2,33,35,28,1274,1372
E01021778,7,34,28,41,1344,1454
E01021779,11,29,60,62,1329,1491
E01021786,11,17,24,62,1139,1253
E01021787,7,18,36,35,1452,1548
E01021788,13,16,33,50,1446,1558
E01021789,20,12,23,203,1317,1575
E01021790,23,32,35,80,1310,1480
E01021791,10,25,33,55,1434,1557
E01021771,9,75,34,47,1358,1523
E01021772,9,29,24,76,1352,1490
E01021773,9,39,36,41,1388,1513
E01021783,7,28,25,72,1422,1554
E01021784,7,16,34,55,1420,1532
E01021780,13,5,33,161,1256,1468
E01021781,10,16,27,78,1344,1475
E01021782,13,20,40,65,1272,1410
E01021785,4,36,68,54,1458,1620
E01021742,16,32,59,87,1181,1375
E01021743,13,34,40,75,1531,1693
E01021744,3,29,32,104,1380,1548
E01021745,16,42,62,108,1297,1525
E01021746,23,16,51,127,1566,1783
E01021747,10,26,50,91,1550,1727
E01021748,20,22,63,119,1505,1729
E01021749,29,70,42,192,1874,2207
E01021750,8,33,18,255,955,1269
E01021751,18,32,13,374,904,1341
E01021752,30,42,51,262,1165,1550
E01021764,14,142,60,207,1347,1770
E01021765,42,107,60,397,1014,1620
E01021766,57,60,42,538,794,1491
E01021767,36,73,28,420,1182,1739
E01021854,6,17,20,23,1573,1639
E01021855,9,26,17,32,1310,1394
E01021856,2,17,23,32,1347,1421
E01021857,15,48,38,95,2318,2514
E01021844,4,17,23,56,1265,1365
E01021845,3,38,35,48,1310,1434
E01021846,5,65,37,33,1211,1351
E01021847,2,50,27,58,1322,1459
E01021848,7,48,26,69,1425,1575
E01021849,1,56,33,113,1400,1603
E01021850,12,69,38,72,1239,1430
E01021851,3,126,44,182,1130,1485
E01021852,1,51,29,90,1400,1571
E01021853,2,44,15,66,1207,1334
E01021839,4,61,24,176,1248,1513
E01021840,8,68,33,73,1259,1441
E01021841,5,42,27,85,1234,1393
E01021842,13,56,31,213,1216,1529
E01021843,13,96,55,263,1654,2081
E01021824,19,27,38,94,1554,1732
E01021825,16,33,51,82,1436,1618
E01021826,9,27,47,80,1439,1602
E01021827,9,58,33,73,1455,1628
E01021828,19,71,48,86,2091,2315
E01021819,2,49,36,45,1414,1546
E01021820,6,31,48,52,1370,1507
E01021822,7,46,40,37,1491,1621
E01021823,5,55,25,45,1582,1712
E01021870,5,41,39,32,1191,1308
E01021831,6,57,36,74,1253,1426
E01021868,13,48,31,26,1481,1599
E01021869,3,48,31,48,1221,1351
E01021871,8,84,33,38,1308,1471
E01021872,12,183,48,300,1272,1815
E01021821,0,47,38,47,1205,1337
E01021834,8,32,30,35,1392,1497
E01021835,2,49,36,57,1348,1492
E01021836,5,71,46,60,1259,1441
E01021837,8,28,24,44,1335,1439
E01021829,1,81,39,32,1315,1468
E01021830,11,13,10,54,1095,1183
E01021832,11,53,17,38,1128,1247
E01021833,8,21,11,39,1140,1219
E01021865,11,31,35,37,1224,1338
E01021838,1,22,29,31,1408,1491
E01021858,5,48,27,50,1362,1492
E01021859,10,115,45,63,1228,1461
E01021860,5,63,40,40,1378,1526
E01021861,5,49,15,35,1196,1300
E01021862,4,151,36,17,1240,1448
E01021863,9,132,29,36,1385,1591
E01021864,10,176,37,75,1139,1437
E01021866,2,21,32,20,1263,1338
E01021867,0,34,17,32,1333,1416
E01021908,4,2,8,2,1961,1977
E01021909,1,3,9,12,1324,1349
E01021910,0,2,10,3,1454,1469
E01021911,1,2,10,1,1233,1247
E01021882,1,5,27,13,1978,2024
E01021883,3,3,8,7,1615,1636
E01021912,1,8,17,14,1959,1999
E01021913,2,9,7,4,1479,1501
E01021884,0,1,3,11,1398,1413
E01021885,1,2,14,6,1108,1131
E01021886,0,5,13,4,1457,1479
E01021887,6,15,22,20,2150,2213
E01021888,0,18,9,11,1901,1939
E01021889,1,1,23,38,2126,2189
E01021890,3,4,27,22,1686,1742
E01021891,1,2,10,12,1442,1467
E01021892,1,1,14,29,985,1030
E01021893,1,2,11,14,1516,1544
E01021894,0,1,14,26,1204,1245
E01021895,2,8,11,16,1189,1226
E01021896,1,0,11,13,1325,1350
E01021897,3,0,2,18,1133,1156
E01021898,0,2,10,13,1246,1271
E01021901,1,5,9,16,1847,1878
E01021904,4,3,9,14,1475,1505
E01021905,0,4,17,4,1232,1257
E01021906,3,3,17,5,1482,1510
E01021907,3,9,9,5,2156,2182
E01021873,2,0,6,6,1359,1373
E01021874,0,0,11,13,1324,1348
E01021875,2,1,11,10,1383,1407
E01021899,1,1,9,21,1353,1385
E01021900,0,3,16,6,1072,1097
E01021902,4,7,18,4,1774,1807
E01021903,1,2,17,13,1579,1612
E01021878,0,4,5,6,1386,1401
E01021879,3,1,14,7,1341,1366
E01021880,2,6,23,8,1389,1428
E01021881,1,2,7,11,1143,1164
E01033057,0,3,18,26,2265,2312
E01021942,0,2,11,22,1544,1579
E01021943,1,2,16,1,1734,1754
E01021944,1,7,5,4,1615,1632
E01021945,1,3,8,9,1541,1562
E01021914,4,11,23,19,2038,2095
E01021927,2,2,19,16,1314,1353
E01021928,3,17,16,19,1488,1543
E01021929,1,11,21,23,1584,1640
E01021931,8,6,8,13,1303,1338
E01021933,0,4,16,18,1327,1365
E01021934,7,3,5,6,1395,1416
E01021935,4,3,14,7,1325,1353
E01021936,3,6,23,10,1655,1697
E01021937,2,7,15,16,1608,1648
E01021938,0,4,16,18,1457,1495
E01021939,1,5,22,6,1652,1686
E01021940,5,5,25,21,2064,2120
E01021941,1,17,27,14,2037,2096
E01021915,4,7,9,14,1313,1347
E01021916,1,1,5,7,1058,1072
E01021953,0,16,34,15,1418,1483
E01021955,1,18,35,33,1736,1823
E01021918,1,3,15,8,1494,1521
E01021919,0,1,2,12,1281,1296
E01021925,5,12,20,31,1569,1637
E01021960,14,61,37,51,2040,2203
E01021961,0,3,10,2,1479,1494
E01021920,3,19,18,12,1974,2026
E01021926,4,4,25,37,2032,2102
E01021957,2,2,14,17,1436,1471
E01021958,2,5,12,18,1206,1243
E01021959,3,11,23,34,1630,1701
E01021930,2,7,19,11,1336,1375
E01021932,1,7,17,18,1493,1536
E01021952,2,3,27,17,1361,1410
E01021954,3,14,21,27,1455,1520
E01021956,3,12,10,14,1420,1459
E01021950,1,12,10,8,1434,1465
E01021951,2,6,18,22,1224,1272
E01021962,6,9,21,15,1205,1256
E01021963,0,5,17,22,1319,1363
E01021964,2,9,19,8,1534,1572
E01021966,4,12,27,27,1685,1755
E01021946,2,9,15,31,1499,1556
E01021947,3,1,10,9,1174,1197
E01021948,1,2,17,28,1287,1335
E01021949,6,3,7,10,1492,1518
E01021965,4,9,18,32,2230,2293
E01021917,4,8,22,10,1832,1876
E01021921,1,9,15,13,1463,1501
E01021922,0,1,8,8,1574,1591
E01021923,0,7,20,11,1326,1364
E01021924,0,10,18,7,1247,1282
E01021997,4,8,16,25,1270,1323
E01021998,0,5,23,24,1301,1353
E01021999,0,2,23,2,1701,1728
E01022001,5,12,37,42,1572,1668
E01022000,4,4,11,3,1609,1631
E01022006,0,2,15,16,1585,1618
E01022007,0,10,9,19,1652,1690
E01033051,2,3,24,14,2330,2373
E01021978,1,6,18,15,2193,2233
E01022013,4,2,15,5,1528,1554
E01022014,6,6,14,10,1323,1359
E01022015,1,8,19,17,1344,1389
E01022019,4,9,18,17,1444,1492
E01022020,6,4,22,15,1693,1740
E01022021,3,1,14,7,1346,1371
E01021991,1,0,9,7,1000,1017
E01021992,0,1,4,4,1162,1171
E01022002,0,12,29,28,1845,1914
E01022004,0,6,13,6,1631,1656
E01022005,0,10,15,16,1674,1715
E01022028,4,2,8,5,1339,1358
E01021971,1,4,14,10,1013,1042
E01021972,5,1,12,8,1243,1269
E01022051,0,6,16,11,1419,1452
E01022052,1,1,3,13,1422,1440
E01021985,1,9,12,19,1291,1332
E01021986,12,10,21,19,1383,1445
E01022054,2,2,10,28,1437,1479
E01022055,1,1,19,10,1276,1307
E01022056,2,15,22,26,1521,1586
E01021973,1,1,10,6,1121,1139
E01021974,4,5,8,8,1136,1161
E01022016,3,2,10,12,1707,1734
E01022017,2,5,4,14,1402,1427
E01022018,1,7,20,8,1393,1429
E01021987,0,9,13,12,1191,1225
E01021994,0,5,14,3,1108,1130
E01021995,0,2,14,7,1346,1369
E01021996,2,1,13,7,1325,1348
E01022009,1,3,4,7,1372,1387
E01022010,0,5,16,3,1522,1546
E01022011,1,1,11,12,1766,1791
E01022012,0,2,13,26,1859,1900
E01021967,1,4,7,27,1970,2009
E01021983,4,3,7,1,1338,1353
E01021993,2,0,13,12,2226,2253
E01022053,2,5,21,22,1745,1795
E01021984,9,2,15,23,1978,2027
E01022039,4,1,10,26,1437,1478
E01022040,0,4,20,10,1693,1727
E01022041,1,4,13,4,1435,1457
E01021979,0,5,15,14,1450,1484
E01021980,1,9,20,8,1727,1765
E01021981,3,5,17,7,1658,1690
E01021982,3,2,20,21,1738,1784
E01022046,1,3,8,10,1554,1576
E01022008,1,9,10,1,2030,2051
E01022033,1,1,4,8,1399,1413
E01022034,0,0,5,7,1489,1501
E01022035,4,2,12,7,1451,1476
E01021975,1,4,15,10,1454,1484
E01021976,7,6,16,15,1364,1408
E01021977,3,2,25,33,1594,1657
E01022022,3,6,11,23,1436,1479
E01022044,1,5,17,9,1592,1624
E01022042,2,3,19,4,1458,1486
E01022043,2,8,36,29,1833,1908
E01022048,0,5,27,18,1541,1591
E01022049,0,4,16,21,1451,1492
E01022050,0,6,27,23,1612,1668
E01022023,1,1,12,11,1434,1459
E01022024,1,0,13,11,1473,1498
E01022030,2,1,26,10,1591,1630
E01022031,1,2,23,19,1319,1364
E01022032,1,4,24,8,1756,1793
E01021970,8,9,19,8,1595,1639
E01022025,7,13,25,28,1543,1616
E01022026,9,20,55,47,1457,1588
E01022027,8,16,39,33,1536,1632
E01021968,4,8,41,34,1689,1776
E01021969,3,5,10,20,1388,1426
E01022036,0,4,11,20,1202,1237
E01022037,3,6,13,18,1453,1493
E01022038,2,3,16,22,1427,1470
E01021988,1,13,33,3,1728,1778
E01021989,0,3,4,1,1443,1451
E01021990,7,1,17,9,1536,1570
E01022045,6,6,13,1,1400,1426
E01022047,0,1,12,13,1249,1275
E01022057,3,1,13,20,1699,1736
E01022075,2,2,21,28,1786,1839
E01022077,2,1,12,17,1531,1563
E01022094,0,0,23,14,1672,1709
E01022074,2,11,27,58,1411,1509
E01022076,2,14,26,20,1624,1686
E01022078,4,3,12,19,1488,1526
E01022079,11,8,25,24,1638,1706
E01022080,3,8,22,69,1482,1584
E01022081,4,5,26,39,2238,2312
E01022082,12,17,53,69,1628,1779
E01022061,1,2,12,4,1442,1461
E01022071,0,7,8,18,1675,1708
E01022072,0,3,19,11,1853,1886
E01022073,3,1,9,6,1538,1557
E01022098,2,12,10,6,1490,1520
E01022092,6,20,7,22,1697,1752
E01022093,2,8,13,6,1731,1760
E01022097,1,1,17,4,1877,1900
E01022099,8,28,31,65,2275,2407
E01022062,5,6,26,22,2033,2092
E01022063,5,8,22,17,1535,1587
E01022083,0,2,17,22,1658,1699
E01022084,1,0,13,12,1582,1608
E01022085,1,5,32,36,1496,1570
E01022087,4,12,18,24,1745,1803
E01022089,2,4,5,15,1526,1552
E01022086,1,14,33,28,1293,1369
E01022090,19,11,42,70,2225,2367
E01022091,8,39,51,52,2199,2349
E01022095,5,6,16,6,1544,1577
E01022067,6,25,18,24,1727,1800
E01022068,1,9,25,30,1524,1589
E01033054,3,8,20,9,1047,1087
E01033055,1,6,13,14,1428,1462
E01033056,0,2,16,13,1298,1329
E01022058,5,4,28,9,1655,1701
E01022064,0,6,16,1,1736,1759
E01022069,0,11,23,25,1504,1563
E01022088,9,2,8,14,1527,1560
E01033052,1,21,26,29,1807,1884
E01033053,7,25,41,33,1776,1882
E01022059,3,5,13,17,1577,1615
E01022060,2,13,24,28,1889,1956
E01022070,7,14,32,35,1842,1930
E01022096,2,7,13,18,1813,1853
E01023316,0,5,16,10,1415,1446
E01023317,6,38,52,38,2413,2547
E01023318,4,26,18,29,1535,1612
E01023319,2,11,29,8,1526,1576
E01023327,11,18,35,32,1344,1440
E01023328,1,25,14,17,1323,1380
E01023329,5,11,29,19,1247,1311
E01023330,10,28,21,17,1431,1507
E01023331,6,22,14,28,1479,1549
E01023320,6,28,39,32,1824,1929
E01023321,5,26,26,41,1857,1955
E01023322,1,15,25,25,1699,1765
E01023323,11,25,26,17,1512,1591
E01023289,8,22,17,46,1438,1531
E01023290,4,21,20,32,1581,1658
E01023291,1,14,15,20,1502,1552
E01023292,16,11,24,19,1427,1497
E01023340,7,46,44,33,1606,1736
E01023341,8,47,43,22,1663,1783
E01023342,22,188,73,77,2288,2648
E01023343,14,114,65,19,1659,1871
E01023344,18,59,27,25,1596,1725
E01023307,18,52,27,57,1421,1575
E01023308,6,32,33,24,1608,1703
E01023309,11,33,22,9,1638,1713
E01023310,28,127,66,72,1908,2201
E01023311,14,32,38,47,1524,1655
E01023312,32,43,44,89,1472,1680
E01023313,10,22,23,27,1558,1640
E01023315,22,55,37,104,1643,1861
E01023302,22,60,31,34,1341,1488
E01023303,12,111,49,45,1343,1560
E01023304,19,54,44,22,1410,1549
E01023305,27,55,23,50,1227,1382
E01023306,16,52,29,24,1346,1467
E01023314,20,32,27,56,1201,1336
E01023324,14,43,20,20,1312,1409
E01023325,9,37,21,48,1306,1421
E01023326,16,65,35,49,1469,1634
E01023297,12,39,35,35,1243,1364
E01023298,2,44,36,19,1477,1578
E01023299,14,83,38,59,1496,1690
E01023300,17,130,57,32,1172,1408
E01023301,11,98,51,35,1411,1606
E01023293,15,40,41,19,1616,1731
E01023294,15,42,51,33,1376,1517
E01023295,17,49,29,33,1294,1422
E01023296,15,58,30,42,1521,1666
E01023332,33,193,63,53,1725,2067
E01023333,4,130,84,81,1545,1844
E01023334,7,57,38,60,1541,1703
E01023335,24,161,47,61,1430,1723
E01023336,40,361,95,60,1466,2022
E01023337,48,289,70,75,1193,1675
E01023338,30,329,81,64,1697,2201
E01023339,25,149,54,46,1235,1509
E01023430,1,6,24,20,1155,1206
E01023431,1,11,18,11,1254,1295
E01023432,1,12,23,7,1405,1448
E01023433,3,16,33,19,1393,1464
E01023423,1,7,24,8,1350,1390
E01023424,1,10,16,12,1351,1390
E01023425,1,3,25,9,1299,1337
E01023426,1,13,46,31,1455,1546
E01023418,2,3,33,22,1349,1409
E01023419,3,14,20,32,2049,2118
E01023420,3,1,29,25,1493,1551
E01023352,5,7,25,33,2377,2447
E01023421,9,0,23,37,1409,1478
E01023422,2,1,17,8,1242,1270
E01023434,5,98,17,121,1292,1533
E01023435,6,102,47,181,1157,1493
E01023436,7,53,32,81,1035,1208
E01023437,11,106,72,110,1232,1531
E01023355,4,1,14,22,1505,1546
E01023356,1,3,18,13,1090,1125
E01023416,8,10,26,28,1382,1454
E01023417,13,8,23,30,1285,1359
E01023393,6,81,30,98,1454,1669
E01023394,7,80,32,81,1176,1376
E01023395,4,92,35,108,1393,1632
E01023396,17,96,37,72,1337,1559
E01023397,1,43,31,69,1194,1338
E01023401,6,67,59,119,1569,1820
E01023402,6,123,42,126,1321,1618
E01023403,2,62,36,97,1307,1504
E01023404,15,41,34,99,1126,1315
E01023405,12,94,41,126,1234,1507
E01023361,3,10,47,63,1578,1701
E01023362,3,2,21,25,1683,1734
E01023363,2,4,30,33,1484,1553
E01023364,4,1,19,24,1246,1294
E01023390,5,42,46,56,1879,2028
E01023391,0,26,42,98,1536,1702
E01023399,0,31,52,54,1465,1602
E01023392,6,15,35,57,1513,1626
E01023427,3,30,20,58,1562,1673
E01023428,2,22,30,66,1357,1477
E01023429,9,38,39,52,1663,1801
E01023369,6,7,28,25,1396,1462
E01023370,3,5,44,56,1551,1659
E01023371,1,2,17,44,1445,1509
E01023372,3,3,16,21,1410,1453
E01023345,3,20,36,83,1415,1557
E01023346,2,43,31,74,1159,1309
E01023347,9,27,24,72,1194,1326
E01023348,1,48,40,113,1454,1656
E01023365,1,5,17,28,1213,1264
E01023366,7,5,19,16,1452,1499
E01023367,2,4,10,6,1149,1171
E01023368,9,2,30,34,1641,1716
E01023349,11,61,55,128,1690,1945
E01023350,6,28,42,83,1470,1629
E01023351,2,37,45,110,1395,1589
E01023398,14,112,62,265,1972,2425
E01023400,11,59,40,84,1608,1802
E01023383,6,20,30,57,1384,1497
E01023384,3,36,29,73,1769,1910
E01023385,4,24,24,52,1557,1661
E01023409,11,29,35,128,1294,1497
E01023410,1,12,17,53,1274,1357
E01023411,5,29,28,97,1334,1493
E01023412,2,16,15,68,1169,1270
E01023413,5,37,34,96,1172,1344
E01023354,7,5,40,58,1573,1683
E01023379,0,7,26,47,1525,1605
E01023380,5,7,20,18,1098,1148
E01023381,2,1,16,23,1283,1325
E01023382,4,13,31,82,1358,1488
E01033022,6,38,53,136,1078,1311
E01033023,9,38,40,85,1337,1509
E01023386,8,67,26,142,1279,1522
E01023387,3,56,45,162,1120,1386
E01023388,10,34,39,139,1370,1592
E01023389,7,39,37,82,1518,1683
E01023357,8,65,30,211,1355,1669
E01023358,2,55,41,275,1104,1477
E01023359,8,46,53,218,1498,1823
E01023360,2,30,43,112,1286,1473
E01023414,9,32,36,147,1208,1432
E01023415,4,20,35,104,1218,1381
E01023373,20,204,91,126,1462,1903
E01023374,1,1,23,35,1358,1418
E01023375,1,3,21,4,1508,1537
E01023376,5,2,16,12,1233,1268
E01023377,2,5,18,9,1178,1212
E01023378,4,23,48,93,1493,1661
E01023406,3,15,34,50,1813,1915
E01023407,9,21,45,42,1547,1664
E01023408,6,7,37,51,1534,1635
E01023462,2,0,7,2,1326,1337
E01023464,3,5,16,23,2123,2170
E01023465,0,0,13,16,1421,1450
E01023466,9,5,16,21,1707,1758
E01023467,3,14,24,4,2350,2395
E01023494,2,10,11,3,1180,1206
E01023495,1,6,8,1,1275,1291
E01023508,1,6,14,11,1440,1472
E01023509,3,3,24,5,1321,1356
E01023452,10,8,18,33,1319,1388
E01023453,2,22,24,63,1359,1470
E01023454,1,11,27,32,1240,1311
E01023455,2,7,20,17,1292,1338
E01023463,4,1,14,4,1180,1203
E01023493,10,4,39,30,2385,2468
E01023449,5,6,25,27,1557,1620
E01023450,11,19,30,58,1819,1937
E01023451,4,20,44,36,2037,2141
E01023438,7,24,40,30,1348,1449
E01023439,3,9,27,47,1272,1358
E01023440,6,15,40,39,1541,1641
E01023441,1,38,56,63,1299,1457
E01023442,7,55,51,113,1869,2095
E01023498,6,9,32,21,2585,2653
E01023506,1,3,9,13,1380,1406
E01023507,4,11,30,47,1590,1682
E01023443,9,8,49,43,1452,1561
E01023444,7,17,21,34,1550,1629
E01023445,7,11,32,40,1643,1733
E01023446,15,43,62,87,1928,2135
E01023447,2,3,44,17,1182,1248
E01023448,6,6,39,39,1433,1523
E01023456,4,9,25,30,1367,1435
E01023457,4,14,27,64,1398,1507
E01023458,10,12,24,30,1255,1331
E01023459,3,4,22,61,1299,1389
E01023460,6,16,28,36,1433,1519
E01023461,5,10,38,62,1508,1623
E01023491,2,4,14,10,1249,1279
E01023492,6,13,18,20,1435,1492
E01023496,6,8,22,14,1241,1291
E01023497,5,0,20,2,1544,1571
E01023485,2,6,32,29,2208,2277
E01023486,3,7,31,33,2440,2514
E01033609,0,10,28,34,2266,2338
E01023499,5,19,24,50,1655,1753
E01023500,3,21,22,57,1631,1734
E01023501,3,8,22,15,1465,1513
E01023502,1,5,21,30,1678,1735
E01023503,4,10,12,24,1673,1723
E01023512,9,23,29,49,1750,1860
E01023513,1,6,25,32,1424,1488
E01023514,9,18,30,74,1661,1792
E01023518,11,31,37,44,1922,2045
E01023519,5,10,33,34,1653,1735
E01023520,3,8,15,21,1561,1608
E01023510,1,10,17,28,1457,1513
E01023511,5,18,40,57,1397,1517
E01023515,5,18,19,32,1487,1561
E01023516,2,13,28,34,2008,2085
E01023517,4,7,14,31,1539,1595
E01023470,9,5,16,31,1702,1763
E01023471,4,5,26,11,1288,1334
E01023472,1,9,24,12,1297,1343
E01023473,2,4,13,10,1426,1455
E01023474,0,2,19,11,1529,1561
E01023487,1,18,17,20,1318,1374
E01023488,0,33,29,23,1524,1609
E01023489,1,9,21,24,1254,1309
E01023490,3,4,29,11,1225,1272
E01023482,11,4,36,41,1861,1953
E01023483,2,13,37,36,1881,1969
E01023484,1,17,43,20,1450,1531
E01023475,5,21,16,28,1391,1461
E01023476,4,3,27,38,1406,1478
E01023477,10,18,44,74,1950,2096
E01023478,5,14,23,73,1593,1708
E01023479,2,11,26,43,1485,1567
E01023468,3,1,23,10,1331,1368
E01023469,1,2,15,4,1488,1510
E01023480,0,3,14,6,1553,1576
E01023481,5,37,34,50,1543,1669
E01023504,0,4,32,26,1301,1363
E01023505,1,10,27,23,1653,1714
E01023576,21,21,29,64,1342,1477
E01023577,17,28,42,86,1534,1707
E01023578,9,26,36,110,1409,1590
E01023579,6,36,52,158,1130,1382
E01023580,32,41,34,97,1515,1719
E01023567,18,30,54,79,1877,2058
E01023568,9,33,33,63,1373,1511
E01023569,6,49,45,89,1433,1622
E01023570,14,36,35,81,1306,1472
E01023571,11,44,30,89,1330,1504
E01023572,3,35,39,74,1296,1447
E01023573,14,51,34,101,1010,1210
E01023574,9,74,55,77,1386,1601
E01023575,8,46,46,116,1366,1582
E01023581,13,24,25,54,1220,1336
E01023582,28,31,78,119,1457,1713
E01023583,9,29,34,42,1311,1425
E01023584,3,13,13,31,972,1032
E01023523,18,33,35,163,1477,1726
E01023524,13,32,27,64,1401,1537
E01023525,13,11,42,86,1524,1676
E01023526,25,18,44,94,1599,1780
E01023527,25,25,37,74,1283,1444
E01023534,10,119,64,80,1422,1695
E01023535,15,121,43,80,1435,1694
E01023536,15,155,63,91,1280,1604
E01023537,22,89,39,95,1525,1770
E01023538,14,127,42,115,1378,1676
E01023529,17,108,41,83,1245,1494
E01023530,17,145,55,114,892,1223
E01023531,19,117,53,94,1681,1964
E01023532,34,68,31,130,1386,1649
E01023533,13,167,62,107,1249,1598
E01023552,6,42,33,169,1414,1664
E01023553,10,51,47,299,1280,1687
E01023554,25,59,48,138,1400,1670
E01023555,21,55,44,144,1442,1706
E01023544,14,49,32,64,1028,1187
E01023545,7,68,48,81,1031,1235
E01023546,24,130,49,129,1473,1805
E01023547,24,125,43,87,1400,1679
E01023528,13,75,34,101,1429,1652
E01023564,21,99,64,186,1347,1717
E01023565,20,38,37,205,1407,1707
E01023566,13,44,25,351,1253,1686
E01023539,86,252,87,305,2196,2926
E01023540,9,98,46,92,1451,1696
E01023541,26,134,43,120,1595,1918
E01023542,25,139,38,154,1420,1776
E01023543,12,120,48,95,1091,1366
E01023558,14,49,40,119,1460,1682
E01023559,5,22,56,129,1302,1514
E01023560,12,71,33,156,1210,1482
E01023561,25,64,50,108,1373,1620
E01023562,5,38,25,132,1269,1469
E01023563,5,14,39,104,1334,1496
E01023548,24,13,30,195,1551,1813
E01023549,15,20,40,149,1451,1675
E01023550,22,13,40,169,1447,1691
E01023551,15,18,36,170,1295,1534
E01023556,12,21,41,125,1339,1538
E01023557,19,24,31,117,1331,1522
E01023660,6,29,30,79,2061,2205
E01023661,0,18,14,34,1300,1366
E01023662,9,36,20,52,1431,1548
E01023654,4,12,29,18,1491,1554
E01023655,7,3,11,31,1459,1511
E01023656,4,27,49,53,2032,2165
E01023657,7,21,27,42,2409,2506
E01023658,1,13,27,5,1552,1598
E01023659,4,4,18,19,1283,1328
E01023635,4,18,42,45,1367,1476
E01023636,4,29,52,56,1664,1805
E01023637,2,43,42,42,1571,1700
E01023638,9,30,42,64,1412,1557
E01023587,0,9,22,43,1023,1097
E01023588,0,4,25,38,1275,1342
E01023589,16,15,25,61,1526,1643
E01023590,3,18,36,58,1595,1710
E01023591,3,9,26,51,1421,1510
E01023592,8,15,44,53,1456,1576
E01023593,2,6,25,30,1339,1402
E01023585,5,3,19,13,1127,1167
E01023586,2,3,10,15,1499,1529
E01023597,1,3,11,6,1197,1218
E01023598,2,13,19,22,1334,1390
E01023600,4,19,27,36,1304,1390
E01023663,4,13,33,12,2029,2091
E01033024,11,70,53,107,1378,1619
E01033025,12,47,36,97,1094,1286
E01033026,1,90,63,102,1324,1580
E01033027,5,61,50,134,1221,1471
E01023630,2,39,63,174,1375,1653
E01023631,12,48,86,209,1308,1663
E01023632,8,9,44,193,1119,1373
E01023633,12,27,30,99,1208,1376
E01023634,4,23,38,56,1187,1308
E01023649,20,29,46,78,1080,1253
E01023650,12,48,43,108,1266,1477
E01023651,20,57,39,179,935,1230
E01023652,4,46,60,93,1248,1451
E01023644,7,31,35,97,1487,1657
E01023645,18,42,53,149,1266,1528
E01023646,10,32,84,64,1199,1389
E01023647,4,14,35,113,1366,1532
E01023648,3,29,21,119,1059,1231
E01023639,24,22,32,127,1152,1357
E01023640,6,46,48,66,1046,1212
E01023641,4,71,60,39,1153,1327
E01023642,13,26,25,205,1057,1326
E01023643,15,44,52,179,1078,1368
E01023601,27,87,92,291,1635,2132
E01023602,17,49,49,216,1249,1580
E01023603,5,49,50,109,1359,1572
E01023604,19,40,50,216,1044,1369
E01023605,22,84,79,155,1104,1444
E01023617,0,29,38,112,1309,1488
E01023618,13,50,85,146,1217,1511
E01023619,18,37,48,223,1293,1619
E01023620,34,60,71,78,1081,1324
E01023621,14,67,63,90,1112,1346
E01023611,7,65,95,110,1361,1638
E01023612,10,50,51,133,1550,1794
E01023613,9,126,112,95,1311,1653
E01023614,8,19,50,99,1774,1950
E01023615,6,18,20,52,1487,1583
E01023616,11,48,61,64,1852,2036
E01023606,19,52,39,83,1447,1640
E01023607,21,31,36,169,1216,1473
E01023608,4,8,45,85,1367,1509
E01023609,10,16,44,71,1429,1570
E01023610,3,24,33,82,1228,1370
E01023594,7,20,58,26,2083,2194
E01023622,1,4,34,36,1102,1177
E01023623,3,6,31,16,1412,1468
E01023624,2,7,16,9,1297,1331
E01023625,4,7,25,17,1053,1106
E01023653,3,10,41,21,2104,2179
E01023595,2,11,22,27,1432,1494
E01023596,1,2,10,6,1080,1099
E01023626,3,8,20,20,2116,2167
E01023627,11,7,39,92,1605,1754
E01023628,7,29,25,51,1611,1723
E01023629,12,7,23,56,1672,1770
E01023690,9,8,30,52,1508,1607
E01023691,9,4,45,50,1350,1458
E01023692,11,62,44,72,1223,1412
E01023693,8,10,32,23,1215,1288
E01023694,5,16,24,48,1381,1474
E01023685,6,14,28,28,1614,1690
E01023686,7,6,42,42,1496,1593
E01023687,5,43,38,45,1390,1521
E01023688,17,12,56,32,1311,1428
E01023689,6,37,49,47,1320,1459
E01023699,3,3,23,47,1458,1534
E01023700,4,6,23,11,1312,1356
E01023701,4,19,30,102,1624,1779
E01023702,6,6,49,57,1491,1609
E01023703,3,6,17,20,1419,1465
E01023746,8,37,45,25,1430,1545
E01023747,1,23,22,23,1723,1792
E01023748,1,3,9,12,1358,1383
E01023749,4,9,31,20,1626,1690
E01023695,5,2,23,53,1495,1578
E01023696,1,3,32,97,1603,1736
E01023697,5,37,26,90,1697,1855
E01023698,6,11,29,64,1496,1606
E01023722,8,11,18,27,1365,1429
E01023723,5,10,27,50,1600,1692
E01023724,3,3,33,38,1511,1588
E01023725,6,13,18,35,1445,1517
E01023713,2,53,52,169,1596,1872
E01023734,3,15,31,32,1567,1648
E01023735,3,26,36,65,1616,1746
E01023736,7,5,24,36,1488,1560
E01023709,1,33,45,99,1480,1658
E01023710,7,6,30,65,1456,1564
E01023711,11,12,42,80,1443,1588
E01023712,2,59,50,106,1470,1687
E01023669,30,79,91,112,1369,1681
E01023670,12,27,58,115,1960,2172
E01023671,30,32,74,218,1538,1892
E01023672,14,44,58,226,1616,1958
E01023673,5,11,38,61,1326,1441
E01023714,11,18,49,66,1678,1822
E01023715,5,26,53,131,1389,1604
E01023716,8,10,48,88,1886,2040
E01023666,16,68,64,442,1124,1714
E01023674,21,44,78,190,1529,1862
E01023675,4,12,37,42,1314,1409
E01023676,5,43,75,181,1869,2173
E01023726,6,17,59,77,1512,1671
E01023727,12,63,41,139,1661,1916
E01023728,28,33,56,64,2022,2203
E01023729,23,50,63,244,1432,1812
E01023664,36,27,56,129,1503,1751
E01023665,20,30,55,166,1319,1590
E01023667,14,28,52,153,1184,1431
E01023668,14,18,48,90,1236,1406
E01023742,4,8,43,71,1358,1484
E01023743,15,13,36,51,1608,1723
E01023744,1,22,29,44,1374,1470
E01023745,4,9,19,42,1653,1727
E01023677,20,51,57,127,985,1240
E01023678,4,42,73,163,1617,1899
E01023679,12,15,35,29,1387,1478
E01023680,9,12,45,77,1202,1345
E01023681,46,61,71,288,1135,1601
E01023682,21,46,47,221,1395,1730
E01023683,19,46,75,184,1336,1660
E01023684,15,39,50,168,1351,1623
E01023737,19,56,61,303,899,1338
E01023738,23,67,67,253,1176,1586
E01023739,15,95,47,184,1165,1506
E01023740,12,31,37,104,1154,1338
E01023741,7,33,41,103,1405,1589
E01023704,18,36,70,148,1340,1612
E01023705,29,52,65,321,1237,1704
E01023706,17,30,67,143,1333,1590
E01023708,19,38,61,111,1283,1512
E01033028,22,29,93,198,1148,1490
E01033029,41,46,97,175,1240,1599
E01023718,12,18,44,77,1595,1746
E01023719,4,25,31,66,1000,1126
E01023720,24,52,50,101,1625,1852
E01023721,7,23,27,60,1289,1406
E01023717,6,14,31,45,1136,1232
E01023730,17,23,52,59,1596,1747
E01023731,6,11,27,109,1326,1479
E01023732,3,25,18,118,1510,1674
E01023733,4,17,32,72,1478,1603
E01023787,3,106,53,136,1127,1425
E01023788,11,82,41,168,1295,1597
E01023789,17,157,45,150,1617,1986
E01023790,8,124,81,219,1306,1738
E01023776,13,51,78,141,2228,2511
E01023777,14,13,49,70,1659,1805
E01023778,8,22,38,132,1494,1694
E01023799,15,31,23,118,1191,1378
E01023800,21,52,54,310,1552,1989
E01023801,9,88,96,140,2084,2417
E01023771,17,59,24,78,1423,1601
E01023772,6,76,28,113,1495,1718
E01023773,13,50,45,46,1217,1371
E01023774,12,58,34,147,1388,1639
E01023767,3,22,27,86,1316,1454
E01023768,5,52,26,83,1499,1665
E01023769,1,46,37,65,1546,1695
E01023770,5,42,22,61,1382,1512
E01023795,7,28,32,57,1396,1520
E01023796,3,35,37,60,1339,1474
E01023797,4,20,43,47,1203,1317
E01023798,2,56,41,121,1264,1484
E01023775,5,36,46,155,1670,1912
E01023779,12,58,51,138,1346,1605
E01023780,14,38,56,63,1240,1411
E01023781,8,64,39,80,1490,1681
E01023782,1,40,29,49,1272,1391
E01023759,6,72,32,113,1287,1510
E01023760,3,37,52,51,1400,1543
E01023761,4,77,89,86,1912,2168
E01023762,6,65,51,81,1355,1558
E01023755,4,74,44,93,1395,1610
E01023756,10,89,56,170,1343,1668
E01023757,18,75,76,206,1514,1889
E01023758,12,63,49,138,1586,1848
E01023750,3,23,24,28,1206,1284
E01023751,3,24,37,49,1089,1202
E01023752,11,51,25,91,1151,1329
E01023753,5,27,31,55,1357,1475
E01023754,7,57,19,102,1183,1368
E01023791,6,58,40,36,1424,1564
E01023792,12,64,100,43,1419,1638
E01023793,7,73,73,58,1230,1441
E01023794,1,87,30,66,1383,1567
E01023783,15,82,51,65,1452,1665
E01023784,10,18,19,44,1538,1629
E01023785,2,31,34,34,1473,1574
E01023786,4,46,38,79,1360,1527
E01023763,7,29,37,36,1374,1483
E01023764,8,34,30,31,1322,1425
E01023765,2,37,31,26,1376,1472
E01023766,7,37,22,34,1430,1530
E01023802,7,19,27,39,1631,1723
E01023803,5,9,18,47,1457,1536
E01023804,4,34,42,34,1405,1519
E01023807,3,21,33,40,1413,1510
E01023808,7,45,70,95,2310,2527
E01023829,4,58,51,65,1530,1708
E01023830,10,22,17,35,1328,1412
E01023832,16,87,58,154,1374,1689
E01023833,7,57,59,224,2015,2362
E01023834,5,67,39,134,1316,1561
E01023823,1,8,23,60,1293,1385
E01023824,1,17,19,55,1844,1936
E01023831,8,32,60,58,1869,2027
E01023854,5,3,22,36,1783,1849
E01023812,10,21,43,406,979,1459
E01023813,17,21,37,314,1162,1551
E01023814,4,8,24,149,977,1162
E01023851,16,22,44,215,1339,1636
E01023815,5,2,31,78,1428,1544
E01023816,1,9,23,37,1223,1293
E01023817,2,8,31,83,1231,1355
E01023818,0,2,26,52,1295,1375
E01023819,9,9,26,58,1478,1580
E01023820,3,9,26,66,1178,1282
E01023821,5,8,24,82,1173,1292
E01023822,2,7,22,55,1275,1361
E01023825,18,41,58,286,1862,2265
E01023826,1,15,47,126,1272,1461
E01023847,12,27,48,121,1682,1890
E01023848,14,23,46,83,1493,1659
E01023850,10,16,30,87,1269,1412
E01023852,10,26,37,88,1332,1493
E01023853,8,6,53,185,1815,2067
E01023827,13,66,43,123,1941,2186
E01023828,7,33,27,94,1346,1507
E01023845,7,56,71,111,1579,1824
E01023846,9,18,31,125,1329,1512
E01023835,2,13,20,89,1283,1407
E01023836,5,32,37,67,1253,1394
E01023837,2,19,34,82,1413,1550
E01023838,6,17,47,49,1132,1251
E01023805,4,55,41,108,1463,1671
E01023809,22,49,27,161,1392,1651
E01023810,17,35,27,398,1259,1736
E01023811,15,38,30,159,1232,1474
E01023839,27,13,64,1061,1084,2249
E01023840,6,12,31,479,1143,1671
E01023841,14,40,30,745,783,1612
E01023849,5,11,33,128,1258,1435
E01023806,5,115,57,96,1917,2190
E01023842,7,68,30,46,1425,1576
E01023843,7,94,47,148,1633,1929
E01023844,8,67,61,77,1398,1611
E01023904,16,113,53,128,1683,1993
E01023905,11,102,64,140,1565,1882
E01023906,8,49,55,89,1284,1485
E01023907,12,73,47,165,1426,1723
E01023890,9,116,55,110,989,1279
E01023891,10,111,67,113,1139,1440
E01023892,5,82,35,64,1126,1312
E01023893,7,99,55,175,1374,1710
E01023894,10,49,35,144,1216,1454
E01023873,4,143,52,48,1040,1287
E01023874,12,78,28,112,1090,1320
E01023875,6,87,51,187,1509,1840
E01023876,17,152,80,150,1339,1738
E01023877,24,101,65,152,1305,1647
E01023868,4,97,70,252,1305,1728
E01023869,3,52,29,412,881,1377
E01023870,32,80,66,403,902,1483
E01023871,14,39,57,138,942,1190
E01023872,13,116,45,346,1186,1706
E01023895,11,52,50,294,1197,1604
E01023896,9,86,41,181,1024,1341
E01023897,7,67,24,165,1323,1586
E01023898,4,30,36,215,1284,1569
E01023855,23,90,89,245,1366,1813
E01023856,13,163,92,269,1742,2279
E01023857,17,141,57,498,943,1656
E01023858,13,111,63,270,1239,1696
E01023878,27,48,59,387,1423,1944
E01023879,33,92,83,509,1501,2218
E01023880,14,73,79,231,1434,1831
E01023881,7,63,44,221,1278,1613
E01023886,29,136,122,700,1722,2709
E01023887,5,23,33,298,1339,1698
E01023888,22,64,63,405,1043,1597
E01023889,12,16,65,323,1358,1774
E01023859,22,147,88,357,1498,2112
E01023860,36,119,81,336,1263,1835
E01023861,35,183,78,586,1349,2231
E01023862,14,155,72,327,1397,1965
E01023899,35,139,49,678,647,1548
E01023900,13,123,50,814,728,1728
E01023901,19,186,81,532,1091,1909
E01023902,21,141,42,311,995,1510
E01023903,26,154,57,616,710,1563
E01023863,17,177,53,504,976,1727
E01023864,18,115,62,433,928,1556
E01023865,30,113,50,484,984,1661
E01023866,28,132,47,311,1035,1553
E01023867,35,154,112,579,1249,2129
E01023882,2,26,37,71,1428,1564
E01023883,15,93,64,372,1116,1660
E01023884,16,23,39,86,1545,1709
E01023885,7,55,33,234,1490,1819
E01023965,5,23,24,63,1301,1416
E01023966,5,23,30,48,1482,1588
E01023967,0,18,17,25,1302,1362
E01023971,16,10,35,59,1509,1629
E01023968,6,8,13,36,1214,1277
E01023969,2,2,13,32,1321,1370
E01023970,6,23,17,20,1324,1390
E01033310,15,75,44,198,1333,1665
E01033313,5,68,41,110,1263,1487
E01023959,4,19,30,66,1313,1432
E01023960,19,24,41,64,1424,1572
E01023961,3,54,49,49,1272,1427
E01023962,2,15,22,34,1419,1492
E01023912,0,27,17,84,1313,1441
E01023913,8,57,26,71,1186,1348
E01023914,9,25,34,54,1532,1654
E01023915,17,61,53,55,1335,1521
E01023950,11,45,57,100,1372,1585
E01023951,2,79,49,66,1381,1577
E01023952,8,67,21,71,1557,1724
E01023953,3,29,19,73,1304,1428
E01023916,10,28,44,74,1548,1704
E01023917,6,19,38,87,1570,1720
E01023918,18,27,25,112,1546,1728
E01023919,0,23,55,40,1536,1654
E01023954,14,99,74,100,1483,1770
E01023955,7,49,35,41,1250,1382
E01023956,5,91,49,52,1158,1355
E01023957,24,74,52,82,1253,1485
E01023958,9,59,28,77,1266,1439
E01023943,8,37,35,99,1348,1527
E01023944,12,63,53,128,1812,2068
E01023945,11,23,39,48,1473,1594
E01023946,39,86,26,190,1210,1551
E01023939,8,29,31,48,1108,1224
E01023940,8,53,43,97,1540,1741
E01023941,32,154,123,297,2188,2794
E01023942,9,74,29,132,1438,1682
E01023929,12,47,42,99,1413,1613
E01023930,22,125,51,134,1296,1628
E01023938,44,223,90,407,2090,2854
E01033308,129,424,111,770,1458,2892
E01033311,14,105,47,113,1244,1523
E01033314,49,309,74,497,1173,2102
E01023924,22,146,65,335,1093,1661
E01023925,3,13,20,50,1160,1246
E01023926,21,51,43,169,1455,1739
E01023927,9,165,32,158,1361,1725
E01023920,25,151,44,168,1249,1637
E01023921,61,238,64,299,1410,2072
E01023922,14,98,63,240,1353,1768
E01023923,22,114,53,315,1343,1847
E01023932,36,164,70,234,1204,1708
E01023934,29,165,43,251,981,1469
E01023935,18,81,44,166,1025,1334
E01023936,40,172,53,275,1734,2274
E01023937,22,154,35,187,936,1334
E01023933,12,120,40,164,1174,1510
E01023963,4,32,53,76,2071,2236
E01023964,25,15,27,41,1397,1505
E01023908,11,8,43,60,1420,1542
E01023909,34,36,36,112,1171,1389
E01023910,19,10,21,64,1257,1371
E01023911,5,12,23,37,1495,1572
E01023947,16,20,24,54,1493,1607
E01023948,12,32,22,76,1468,1610
E01023949,13,19,33,71,1828,1964
E01026436,4,3,15,4,2235,2261
E01026461,0,4,2,10,1320,1336
E01026483,4,1,5,4,1128,1142
E01033042,6,28,23,20,2295,2372
E01026442,0,4,18,11,2130,2163
E01026443,1,1,5,5,2100,2112
E01026445,1,5,12,4,2198,2220
E01026462,0,0,13,3,2224,2240
E01026428,2,6,38,12,2700,2758
E01026429,0,8,19,19,1449,1495
E01026430,0,6,20,5,1762,1793
E01026431,0,2,6,8,1122,1138
E01026446,2,2,7,7,1905,1923
E01026452,1,2,9,4,1656,1672
E01026453,1,2,14,4,1565,1586
E01026454,1,2,22,12,1631,1668
E01026425,0,12,31,18,1884,1945
E01026426,8,8,37,25,2294,2372
E01026427,0,0,11,13,2174,2198
E01026432,0,3,9,2,1456,1470
E01026433,1,8,25,13,1423,1470
E01026434,1,4,23,22,1920,1970
E01026479,0,1,8,0,1480,1489
E01026480,1,0,10,11,1441,1463
E01026481,0,1,6,15,1206,1228
E01026484,0,0,5,3,1363,1371
E01026485,0,1,8,2,1078,1089
E01026455,4,13,24,48,1812,1901
E01026456,0,0,1,14,1154,1169
E01026457,2,8,2,4,1256,1272
E01026458,0,8,18,18,1454,1498
E01026459,3,8,9,17,1381,1418
E01026437,0,0,3,3,1174,1180
E01026438,0,1,4,3,1019,1027
E01026451,0,2,11,5,2039,2057
E01026495,1,0,9,12,1265,1287
E01026496,0,2,11,2,1075,1090
E01026486,1,0,13,13,1505,1532
E01026487,3,1,26,8,1551,1589
E01026488,0,2,13,11,1143,1169
E01026489,3,5,10,1,1325,1344
E01026490,1,4,15,4,1544,1568
E01026419,0,1,5,0,1212,1218
E01026420,0,1,7,6,1118,1132
E01026464,5,1,9,4,1247,1266
E01026491,6,6,12,7,2117,2148
E01033040,6,124,85,55,1715,1985
E01033041,1,2,13,3,1042,1061
E01026422,0,12,12,8,1914,1946
E01026423,3,9,29,8,1765,1814
E01026447,0,8,18,13,1472,1511
E01026449,5,10,20,47,1877,1959
E01026450,3,3,6,17,1750,1779
E01026424,2,7,23,6,2040,2078
E01026444,5,10,16,6,1976,2013
E01026492,3,12,23,2,1251,1291
E01026493,1,2,21,5,1143,1172
E01026421,2,3,20,7,1698,1730
E01026435,3,11,35,12,2181,2242
E01026448,1,6,10,18,2216,2251
E01026439,1,1,6,11,1514,1533
E01026440,1,2,12,15,1161,1191
E01026441,5,4,2,14,1553,1578
E01026494,1,1,7,8,2191,2208
E01026465,5,1,40,28,1722,1796
E01026466,7,9,43,27,1828,1914
E01026467,4,16,88,36,2056,2200
E01026468,10,21,61,31,2250,2373
E01026469,7,13,37,30,1497,1584
E01026470,7,26,84,64,2577,2758
E01026471,8,12,26,13,1181,1240
E01026472,1,3,17,14,1171,1206
E01026473,12,11,20,16,1415,1474
E01026474,1,31,73,35,1551,1691
E01026475,1,11,31,35,1393,1471
E01026476,1,15,35,2,1432,1485
E01026477,7,8,26,15,1391,1447
E01026478,0,15,20,3,1663,1701
E01026499,0,0,7,16,1497,1520
E01026500,1,0,5,14,1681,1701
E01026501,0,2,20,4,1581,1607
E01026502,2,2,1,3,1153,1161
E01026503,0,3,7,5,1374,1389
E01026522,0,2,24,11,1400,1437
E01026523,4,1,9,2,1846,1862
E01026524,3,1,8,6,1425,1443
E01026525,2,0,6,1,1059,1068
E01026547,1,2,13,0,1403,1419
E01026548,2,0,6,4,1278,1290
E01026514,4,0,12,10,1507,1533
E01026515,2,4,8,5,1063,1082
E01026516,2,5,12,7,1222,1248
E01026517,0,1,5,8,1425,1439
E01026533,0,5,7,4,1174,1190
E01026534,4,1,10,5,1619,1639
E01026535,7,2,9,9,1647,1674
E01026536,1,12,15,14,1651,1693
E01026537,3,3,9,20,1506,1541
E01026549,4,1,9,7,1703,1724
E01026550,1,3,3,3,1121,1131
E01026551,1,3,9,3,1172,1188
E01026552,1,0,12,10,1376,1399
E01026562,2,20,18,31,1160,1231
E01026563,2,4,15,39,1350,1410
E01026564,5,5,17,32,1572,1631
E01026565,0,1,20,20,1124,1165
E01026566,3,2,7,13,1459,1484
E01026567,0,1,11,20,1606,1638
E01026568,7,6,12,17,1541,1583
E01026518,1,19,19,19,1337,1395
E01026519,2,4,20,17,1664,1707
E01026520,0,3,6,15,1091,1115
E01026521,0,6,11,4,1251,1272
E01026545,0,13,18,5,1597,1633
E01026546,2,7,11,15,1467,1502
E01026578,8,3,12,10,1939,1972
E01026579,1,2,6,8,1469,1486
E01026580,0,7,17,5,1607,1636
E01026540,0,2,14,21,1407,1444
E01026541,13,7,26,40,2342,2428
E01026542,2,0,16,18,1441,1477
E01026543,4,3,11,14,1390,1422
E01026544,10,15,16,16,1630,1687
E01026526,0,5,4,6,1406,1421
E01026527,0,6,13,10,1425,1454
E01026528,1,2,14,8,1363,1388
E01026529,5,4,15,31,1489,1544
E01026530,9,8,14,19,1655,1705
E01026531,0,3,14,36,1645,1698
E01026532,2,7,9,21,1708,1747
E01026553,1,3,18,36,1329,1387
E01026554,6,3,6,14,1136,1165
E01026555,1,5,14,19,1471,1510
E01026556,0,6,26,28,1361,1421
E01026557,1,0,8,15,1351,1375
E01026558,0,7,11,8,1250,1276
E01026559,1,1,17,21,1439,1479
E01026560,0,3,4,15,1318,1340
E01026561,0,2,13,19,1354,1388
E01026504,2,2,10,6,1512,1532
E01026505,0,5,13,13,1341,1372
E01026506,2,0,4,11,1350,1367
E01026507,1,4,5,12,1301,1323
E01026512,5,4,9,9,1270,1297
E01026513,0,1,6,6,1333,1346
E01026569,0,0,4,15,1408,1427
E01026570,3,0,17,13,1541,1574
E01026571,0,1,18,20,1430,1469
E01026572,0,6,14,17,1419,1456
E01026573,0,5,11,5,1349,1370
E01026574,13,11,31,52,1627,1734
E01026575,12,8,27,56,1633,1736
E01026576,0,12,33,59,1994,2098
E01026577,3,9,40,24,1616,1692
E01026508,0,0,7,15,1416,1438
E01026509,5,5,14,14,1555,1593
E01026510,1,3,21,28,1565,1618
E01026511,0,0,6,3,1132,1141
E01026497,0,1,6,4,1456,1467
E01026498,6,0,18,8,1325,1357
E01026538,3,3,8,10,1544,1568
E01026539,1,3,13,9,1651,1677
E01026605,0,5,10,5,1660,1680
E01026606,1,3,9,2,1552,1567
E01026607,2,3,7,8,1575,1595
E01026627,1,3,4,2,1378,1388
E01026628,1,0,0,5,1389,1395
E01026629,0,1,9,9,1474,1493
E01026608,3,0,16,4,1234,1257
E01026609,0,0,3,7,1159,1169
E01026636,1,0,5,4,1539,1549
E01026637,1,2,11,3,1990,2007
E01026638,0,2,3,4,1553,1562
E01026589,0,3,10,13,1398,1424
E01026590,4,1,13,10,1354,1382
E01026591,0,1,16,21,1707,1745
E01026592,0,1,6,3,1439,1449
E01026593,0,6,11,12,1285,1314
E01026594,7,5,23,11,1716,1762
E01026599,4,13,23,15,1377,1432
E01026639,3,3,10,16,1530,1562
E01026640,2,12,17,15,1531,1577
E01026641,0,1,14,8,1484,1507
E01026595,6,5,20,11,1666,1708
E01026596,5,8,19,24,1635,1691
E01026597,4,25,43,30,1760,1862
E01026598,17,26,54,25,1483,1605
E01026622,6,10,48,12,1566,1642
E01026623,35,17,68,44,1378,1542
E01026624,21,37,71,45,1624,1798
E01026625,8,31,90,49,1617,1795
E01026626,4,10,44,25,1821,1904
E01026600,3,3,11,2,1458,1477
E01026633,3,17,45,29,1767,1861
E01026634,6,18,17,23,1479,1543
E01026635,6,12,41,24,2170,2253
E01026581,12,2,7,17,1648,1686
E01026582,4,8,10,13,1903,1938
E01026583,6,3,9,6,1304,1328
E01026584,6,0,4,9,1477,1496
E01026601,0,2,12,14,1462,1490
E01026602,1,4,16,8,1452,1481
E01026603,0,17,17,5,1625,1664
E01026604,3,9,19,23,1523,1577
E01026632,3,8,25,12,1628,1676
E01026610,7,2,26,17,1481,1533
E01026611,11,13,15,31,1443,1513
E01026612,12,29,32,141,2288,2502
E01026630,5,9,20,21,1682,1737
E01026631,0,3,8,29,1678,1718
E01026617,1,2,7,48,1219,1277
E01026618,26,16,23,94,1433,1592
E01026619,1,0,10,35,1452,1498
E01026620,1,2,3,25,1405,1436
E01026621,1,7,11,55,1379,1453
E01026613,4,0,4,10,1278,1296
E01026614,1,4,10,7,1580,1602
E01026615,1,1,7,6,1340,1355
E01026616,0,1,3,3,1219,1226
E01026585,0,4,6,5,1269,1284
E01026586,0,0,12,8,1028,1048
E01026587,0,3,28,23,1694,1748
E01026588,0,6,24,19,2577,2626
E01026680,2,2,13,2,1438,1457
E01026681,0,2,10,8,1389,1409
E01026682,2,0,7,6,1243,1258
E01026683,1,1,14,17,1263,1296
E01026645,0,2,7,1,1283,1293
E01026646,3,1,7,4,1699,1714
E01026656,0,0,7,6,1924,1937
E01026695,0,2,10,7,2109,2128
E01026676,0,1,4,12,1661,1678
E01026677,0,4,8,1,1491,1504
E01026678,7,1,0,8,1552,1568
E01026701,0,0,4,13,1570,1587
E01026702,0,0,7,7,1266,1280
E01026703,0,1,9,9,1146,1165
E01026653,1,1,4,8,1726,1740
E01026654,0,0,2,1,1552,1555
E01026655,0,1,4,1,1339,1345
E01026718,5,2,10,8,2231,2256
E01026691,4,8,17,27,1118,1174
E01026692,1,0,2,33,1235,1271
E01026708,3,13,10,62,1267,1355
E01026709,8,10,20,64,1813,1915
E01026710,0,9,11,23,1150,1193
E01026669,1,8,19,22,1574,1624
E01026670,4,9,15,12,1584,1624
E01026671,4,4,12,17,1370,1407
E01026672,3,4,6,20,1460,1493
E01026673,2,4,12,11,1504,1533
E01026687,1,17,20,14,1523,1575
E01026688,3,14,28,20,1420,1485
E01026689,3,9,34,27,1452,1525
E01026690,5,7,23,14,1438,1487
E01026647,0,11,10,7,2143,2171
E01026711,0,11,11,11,1489,1522
E01026712,3,3,8,12,1613,1639
E01026713,3,4,7,6,1517,1537
E01026666,1,13,41,27,1822,1904
E01026667,2,5,30,8,1577,1622
E01026668,3,8,16,19,1543,1589
E01026693,0,3,14,17,1873,1907
E01026662,5,20,62,80,2316,2483
E01026663,6,16,32,104,1636,1794
E01026664,6,15,29,251,1901,2202
E01026714,15,28,38,167,1779,2027
E01026698,10,6,44,83,1807,1950
E01026699,8,15,29,29,1424,1505
E01026700,13,8,18,26,1341,1406
E01026704,4,9,21,26,1768,1828
E01026705,1,1,11,5,1557,1575
E01026706,5,2,29,9,1523,1568
E01026665,4,17,10,10,2199,2240
E01026674,2,0,10,5,1100,1117
E01026675,0,1,1,1,1217,1220
E01026694,4,6,14,19,2388,2431
E01026684,0,0,10,7,1192,1209
E01026685,3,2,4,16,1251,1276
E01026719,0,0,9,9,2304,2322
E01026720,1,1,7,11,1304,1324
E01026721,0,1,10,19,1287,1317
E01026642,0,5,9,4,1320,1338
E01026643,2,1,10,11,1376,1400
E01026644,4,9,29,18,2738,2798
E01026723,2,3,14,29,1571,1619
E01026724,3,9,21,35,1597,1665
E01026725,2,2,8,25,1413,1450
E01026696,2,1,4,6,1183,1196
E01026697,0,2,7,5,1257,1271
E01026722,0,1,17,12,2425,2455
E01026726,3,2,11,11,2075,2102
E01026659,0,1,16,7,1548,1572
E01026660,4,5,8,6,1625,1648
E01026661,0,6,4,2,1468,1480
E01026715,0,3,11,7,1400,1421
E01026716,2,18,26,21,1804,1871
E01026717,2,0,4,8,1521,1535
E01026686,3,2,9,16,1987,2017
E01026707,0,1,10,6,2062,2079
E01033036,6,11,24,9,1565,1615
E01033037,2,14,34,9,1455,1514
E01033038,5,15,22,12,1707,1761
E01033039,2,3,13,10,980,1008
E01026679,1,8,30,3,2367,2409
E01026727,9,20,19,9,2447,2504
E01026728,7,6,25,9,2229,2276
E01026648,3,9,21,13,1460,1506
E01026649,4,23,22,19,1498,1566
E01026650,12,26,39,52,1074,1203
E01026651,3,7,21,11,2290,2332
E01026652,1,5,3,9,1306,1324
E01026770,0,6,13,17,1951,1987
E01026771,7,2,6,3,1578,1596
E01026772,0,2,15,13,1692,1722
E01026773,0,0,14,6,2042,2062
E01026739,1,1,10,10,2022,2044
E01026763,0,2,8,8,1365,1383
E01026764,0,1,8,6,1180,1195
E01026765,1,2,6,3,1318,1330
E01026734,0,1,20,40,1098,1159
E01026735,2,2,18,11,1166,1199
E01026736,0,2,4,2,1282,1290
E01026777,0,1,2,13,1107,1123
E01026778,0,1,10,6,1424,1441
E01026779,0,2,11,6,1452,1471
E01026741,0,0,1,6,1887,1894
E01026742,1,5,17,31,1525,1579
E01026743,0,4,12,8,2207,2231
E01026762,2,2,10,11,2376,2401
E01026766,0,0,13,2,2216,2231
E01026781,2,8,21,9,2085,2125
E01026731,0,1,2,1,1058,1062
E01026732,1,0,7,7,1238,1253
E01026733,1,2,10,5,2304,2322
E01026737,1,2,11,3,2327,2344
E01026738,1,3,14,4,2434,2456
E01026750,0,1,5,7,1350,1363
E01026751,1,1,8,2,1383,1395
E01026752,2,1,9,1,1420,1433
E01026729,0,2,11,17,2214,2244
E01026730,1,3,13,6,2416,2439
E01026788,1,0,6,3,1255,1265
E01026780,2,2,19,12,2486,2521
E01026782,0,4,10,4,2149,2167
E01026787,0,2,7,0,1031,1040
E01026753,2,6,15,19,1533,1575
E01026754,0,0,14,6,1393,1413
E01026755,1,1,5,2,1206,1215
E01026756,1,1,6,11,1214,1233
E01026757,0,1,14,12,1556,1583
E01026758,3,0,7,15,1349,1374
E01026759,0,0,8,4,1327,1339
E01026760,0,0,7,12,1315,1334
E01026761,0,0,13,2,1553,1568
E01026745,1,1,22,17,1608,1649
E01026746,3,2,12,21,1619,1657
E01026747,2,4,5,8,1310,1329
E01026748,1,0,5,3,1421,1430
E01026749,2,1,7,20,1522,1552
E01026740,4,4,9,3,2366,2386
E01026767,4,5,9,12,1223,1253
E01026768,9,49,25,22,1576,1681
E01026789,1,3,5,7,1207,1223
E01026790,0,0,6,1,1154,1161
E01026774,1,0,7,1,1442,1451
E01026775,0,0,8,4,1261,1273
E01026776,0,1,21,6,1560,1588
E01026786,0,1,7,9,2173,2190
E01026744,0,3,5,15,1925,1948
E01026769,1,2,15,9,2103,2130
E01026783,0,2,0,2,1797,1801
E01026784,1,1,3,1,1039,1045
E01026785,3,1,6,4,1337,1351
E01026797,18,51,55,90,2188,2402
E01026798,7,18,18,76,1414,1533
E01026799,4,6,31,33,1385,1459
E01026800,8,64,66,46,1807,1991
E01026801,2,17,10,19,1558,1606
E01026802,10,27,29,43,1496,1605
E01026828,4,31,44,54,1611,1744
E01026829,13,54,39,32,1955,2093
E01026830,8,15,44,34,1175,1276
E01026831,9,13,29,23,1168,1242
E01026832,1,13,27,20,1354,1415
E01026833,3,17,24,18,1320,1382
E01026834,9,21,43,13,1417,1503
E01026841,7,18,26,54,1348,1453
E01026842,18,27,28,59,1516,1648
E01026843,11,27,32,44,1791,1905
E01026844,12,34,52,50,1593,1741
E01026845,9,13,34,26,1479,1561
E01026846,13,39,30,80,1464,1626
E01026803,4,11,25,19,1379,1438
E01026804,2,18,35,7,1367,1429
E01026805,5,13,13,10,1380,1421
E01026806,1,27,39,31,1405,1503
E01026807,3,21,31,24,1173,1252
E01026808,4,24,25,27,1240,1320
E01026809,5,7,19,10,1451,1492
E01026791,7,37,27,85,1319,1475
E01026792,9,24,13,94,1305,1445
E01026793,20,44,53,80,1620,1817
E01026794,74,23,28,98,1842,2065
E01026796,6,69,38,87,1443,1643
E01033435,167,89,56,171,1362,1845
E01033436,35,30,10,75,1243,1393
E01026863,8,30,32,90,1654,1814
E01026864,2,8,32,55,1450,1547
E01026865,4,35,55,103,1752,1949
E01026866,7,26,38,30,1473,1574
E01026867,20,48,33,52,1439,1592
E01026868,9,21,38,63,1497,1628
E01026869,1,18,33,59,1289,1400
E01026822,22,28,79,91,1811,2031
E01026823,17,32,59,109,1689,1906
E01026824,25,27,39,54,1326,1471
E01026825,5,12,33,47,1179,1276
E01026826,27,22,44,54,1309,1456
E01026827,13,35,35,32,1386,1501
E01026835,4,13,55,40,1390,1502
E01026836,3,8,43,31,1481,1566
E01026837,11,14,44,41,1361,1471
E01026838,15,9,34,63,1430,1551
E01026839,12,8,37,41,1498,1596
E01026840,10,13,37,37,1514,1611
E01026858,10,47,43,131,1281,1512
E01026859,10,22,45,44,1538,1659
E01026860,101,166,139,1008,2899,4313
E01026861,14,32,41,136,1270,1493
E01026862,10,8,32,66,1186,1302
E01026852,3,13,15,45,1219,1295
E01026853,14,9,43,111,1574,1751
E01026855,5,10,37,55,1461,1568
E01026856,11,38,64,46,1662,1821
E01026857,9,6,27,30,1443,1515
E01033434,7,17,25,90,937,1076
E01033437,5,39,56,65,1213,1378
E01026810,7,7,30,61,1284,1389
E01026811,7,5,21,42,1469,1544
E01026812,6,33,21,72,1293,1425
E01026813,4,9,23,89,1301,1426
E01026814,18,14,23,77,1390,1522
E01026815,9,30,33,83,1320,1475
E01026816,11,32,46,82,1570,1741
E01026817,6,19,28,27,1335,1415
E01026818,4,22,40,44,1352,1462
E01026819,11,20,35,49,1324,1439
E01026820,12,41,36,69,1569,1727
E01026821,7,5,20,53,1457,1542
E01033438,13,11,32,67,1274,1397
E01033439,18,27,29,64,1302,1440
E01033440,16,32,38,99,885,1070
E01033441,15,27,45,134,1008,1229
E01026848,4,21,42,41,1748,1856
E01026849,6,22,27,75,1608,1738
E01026850,11,14,30,65,1707,1827
E01026916,1,8,16,14,1989,2028
E01026917,5,4,17,21,1434,1481
E01026918,1,7,6,24,1651,1689
E01026924,3,10,28,26,1447,1514
E01026925,16,29,43,32,1982,2102
E01033538,9,29,30,93,2004,2165
E01033540,6,12,14,11,1441,1484
E01026881,5,8,29,57,1236,1335
E01026882,8,28,45,123,1868,2072
E01026883,3,2,16,25,1599,1645
E01026895,5,7,19,35,1448,1514
E01026896,6,5,2,4,1186,1203
E01026905,0,1,10,7,1007,1025
E01026906,3,6,13,13,1340,1375
E01026907,1,6,20,20,1785,1832
E01026908,1,23,22,33,1380,1459
E01026909,0,0,7,8,1405,1420
E01026910,1,1,8,3,1475,1488
E01026947,0,2,8,10,1295,1315
E01026948,2,19,45,49,1878,1993
E01026870,2,2,24,17,1508,1553
E01026871,0,3,11,9,1273,1296
E01026921,1,1,14,13,1337,1366
E01026922,1,14,22,8,1454,1499
E01026875,4,0,10,9,1119,1142
E01026876,1,2,12,7,1498,1520
E01026926,0,1,13,4,1537,1555
E01026927,3,2,22,13,1797,1837
E01026928,2,0,13,19,1400,1434
E01026936,0,2,8,12,1370,1392
E01026937,2,3,15,18,1437,1475
E01026884,2,2,7,6,1140,1157
E01026885,1,0,19,15,1400,1435
E01026933,7,3,38,25,2716,2789
E01026945,2,8,28,48,2148,2234
E01026946,0,4,15,18,1039,1076
E01026879,2,3,13,24,1186,1228
E01026880,0,4,6,7,1468,1485
E01026911,0,0,7,10,1091,1108
E01026912,2,1,12,4,1521,1540
E01026929,0,1,7,2,1294,1304
E01026930,1,1,16,4,1513,1535
E01026913,0,1,10,10,1618,1639
E01026914,3,6,11,2,1496,1518
E01026915,0,1,22,8,1933,1964
E01026919,3,0,18,9,1494,1524
E01026920,0,1,4,0,1129,1134
E01026941,4,1,13,8,1224,1250
E01026942,1,0,5,5,1138,1149
E01026898,2,3,3,3,1381,1392
E01026899,5,1,13,9,1451,1479
E01026943,0,0,22,5,1510,1537
E01026944,0,1,14,4,1170,1189
E01026877,0,1,7,4,1525,1537
E01026878,1,3,9,1,1186,1200
E01026897,3,9,17,13,2659,2701
E01026938,3,6,18,8,1948,1983
E01026939,0,2,27,12,1694,1735
E01026940,0,0,13,19,1769,1801
E01026892,1,0,14,5,1286,1306
E01026893,0,1,6,9,1011,1027
E01026894,4,4,11,12,2413,2444
E01026903,2,0,9,1,1186,1198
E01026904,0,2,11,10,1339,1362
E01026872,1,1,27,12,2159,2200
E01026900,0,1,5,7,1433,1446
E01026901,0,2,8,4,1319,1333
E01026902,2,4,18,12,1826,1862
E01026873,0,4,7,0,1254,1265
E01026874,2,1,8,1,1533,1545
E01026886,2,2,6,7,1325,1342
E01026887,1,2,13,1,1455,1472
E01026934,1,1,9,4,1013,1028
E01026935,0,1,9,1,1318,1329
E01026888,3,6,8,14,1586,1617
E01026889,0,2,14,27,1479,1522
E01026891,3,17,23,40,1563,1646
E01026931,2,4,10,9,1189,1214
E01026932,1,10,10,30,1185,1236
E01033539,10,8,20,17,1336,1391
E01033541,0,5,12,27,1352,1396
E01029876,2,7,9,5,2158,2181
E01029898,5,0,7,9,1701,1722
E01029907,0,2,14,6,2140,2162
E01029881,3,6,20,9,2019,2057
E01029884,1,4,12,9,1530,1556
E01029885,1,0,9,6,2129,2145
E01029900,0,6,14,7,1595,1622
E01029901,10,4,23,4,2111,2152
E01029917,12,1,25,10,1845,1893
E01029892,6,2,32,28,1767,1835
E01029893,12,15,22,18,2619,2686
E01029894,0,6,6,10,1141,1163
E01029895,1,7,14,9,1158,1189
E01029896,1,4,16,5,1354,1380
E01029911,8,3,18,4,2158,2191
E01029877,0,0,13,9,1273,1295
E01029878,2,13,16,13,1154,1198
E01029879,1,4,28,8,1474,1515
E01029908,4,9,28,17,1571,1629
E01029909,3,12,30,12,1499,1556
E01029910,6,13,40,21,1077,1157
E01029880,8,0,20,8,1663,1699
E01029921,0,1,15,1,1253,1270
E01029922,2,8,8,1,1287,1306
E01029923,1,1,2,4,1391,1399
E01029912,0,11,27,11,1566,1615
E01029913,1,8,4,3,1067,1083
E01029914,2,2,10,17,1589,1620
E01029915,3,1,8,36,1175,1223
E01029916,4,9,19,27,1254,1313
E01029918,4,3,9,22,1069,1107
E01029919,8,9,26,13,1429,1485
E01029920,5,16,21,35,1647,1724
E01029886,0,6,14,6,1268,1294
E01029887,2,4,19,18,1757,1800
E01029888,0,5,8,16,1174,1203
E01029889,3,5,16,25,1300,1349
E01029890,1,1,7,13,1315,1337
E01029891,3,2,13,9,1898,1925
E01029875,0,5,9,4,2152,2170
E01029899,0,0,14,8,1750,1772
E01029902,1,3,10,13,2123,2150
E01029906,1,3,14,7,1820,1845
E01029870,0,1,10,5,1149,1165
E01029872,0,2,11,9,1379,1401
E01029882,0,7,21,6,1527,1561
E01029883,0,6,7,27,1940,1980
E01029903,0,2,11,3,1387,1403
E01029904,0,0,8,14,1422,1444
E01029905,2,1,12,16,1056,1087
E01029871,2,2,9,0,1339,1352
E01029873,4,5,11,1,2136,2157
E01029874,1,7,12,10,1720,1750
E01029897,2,10,26,59,2370,2467
E01029926,1,12,28,4,1619,1664
E01029927,12,23,56,26,2243,2360
E01029928,5,17,31,17,1759,1829
E01029929,7,16,41,30,2144,2238
E01029930,5,21,31,11,1477,1545
E01029942,12,31,48,26,1356,1473
E01029944,17,21,19,15,1599,1671
E01033453,117,244,242,99,2712,3414
E01029945,11,54,45,22,1790,1922
E01032523,36,84,114,50,1031,1315
E01032524,13,21,29,13,907,983
E01032525,70,195,218,70,2280,2833
E01032526,18,27,30,16,1536,1627
E01029938,5,18,29,23,1326,1401
E01029939,25,37,30,26,1422,1540
E01029940,6,15,39,26,1347,1433
E01029946,26,43,90,63,1890,2112
E01029947,19,29,51,39,2064,2202
E01029941,5,12,23,11,1773,1824
E01029957,3,6,25,23,1606,1663
E01033451,44,88,71,34,1238,1475
E01033452,21,28,49,15,1281,1394
E01033454,12,31,60,12,1140,1255
E01029937,6,8,25,41,1880,1960
E01029953,4,24,27,36,1333,1424
E01029954,5,8,46,70,2310,2439
E01029955,5,12,42,42,1716,1817
E01029956,5,32,30,44,1245,1356
E01029925,3,25,39,55,1592,1714
E01029949,1,19,21,25,1338,1404
E01029950,7,51,37,110,1580,1785
E01029951,4,8,12,49,1320,1393
E01029952,1,6,13,38,1203,1261
E01032612,7,30,53,82,1850,2022
E01030032,13,72,136,31,1254,1506
E01030033,1,13,43,3,1474,1534
E01030034,0,13,27,20,1354,1414
E01030035,10,86,101,30,1615,1842
E01030036,7,36,78,46,1576,1743
E01029973,16,8,20,40,1431,1515
E01029974,19,17,31,50,1451,1568
E01029975,5,12,22,31,1224,1294
E01029976,9,15,31,42,1452,1549
E01029977,3,17,34,9,1474,1537
E01030027,9,41,78,33,1898,2059
E01030028,20,42,61,36,1472,1631
E01030029,17,43,59,40,1478,1637
E01030030,18,39,98,27,1819,2001
E01030031,12,20,59,57,1403,1551
E01029997,10,11,40,50,1480,1591
E01029998,11,33,81,111,1666,1902
E01029999,11,15,39,94,1549,1708
E01030000,9,23,39,68,1430,1569
E01030001,11,32,27,58,1426,1554
E01030007,18,31,67,66,1468,1650
E01030008,8,17,21,38,1219,1303
E01030009,9,16,41,65,1350,1481
E01030010,40,47,74,163,1530,1854
E01030011,2,8,27,29,1522,1588
E01030022,26,76,110,65,1922,2199
E01030023,34,80,84,146,1542,1886
E01030024,125,115,127,188,1786,2341
E01030025,18,63,72,211,1424,1788
E01030026,4,40,82,52,1546,1724
E01029958,2,24,39,53,1302,1420
E01029960,9,39,93,73,1581,1795
E01029961,4,49,70,61,1339,1523
E01029962,5,33,58,166,1332,1594
E01033124,5,42,53,53,952,1105
E01033125,12,35,43,128,804,1022
E01033129,48,71,48,244,830,1241
E01030002,5,26,60,95,1727,1913
E01030003,19,20,56,109,1532,1736
E01030004,6,21,26,66,1222,1341
E01030005,14,34,76,129,2063,2316
E01030006,30,24,40,100,1634,1828
E01029963,1,16,27,46,1451,1541
E01029964,1,24,42,76,1198,1341
E01029965,2,5,22,67,1378,1474
E01029966,17,36,31,104,1214,1402
E01029967,5,9,16,38,1229,1297
E01029984,17,63,86,54,1307,1527
E01029985,28,72,88,167,1950,2305
E01029986,36,56,82,36,1363,1573
E01029987,7,17,71,9,1458,1562
E01029988,34,120,105,157,1443,1859
E01029990,3,27,43,69,1475,1617
E01029991,10,17,30,24,1552,1633
E01029992,6,11,32,53,1226,1328
E01033123,9,36,64,86,1604,1799
E01033126,11,54,65,314,978,1422
E01029968,15,58,51,32,1321,1477
E01029969,14,28,39,28,1361,1470
E01029970,15,25,41,54,1600,1735
E01029971,13,26,52,19,1355,1465
E01033122,37,40,88,47,1229,1441
E01033130,50,50,63,34,847,1044
E01030012,6,20,30,9,1055,1120
E01030013,7,16,51,18,1305,1397
E01030014,4,13,33,3,1347,1400
E01030015,0,14,19,5,1272,1310
E01030016,6,8,30,7,1382,1433
E01029994,7,87,84,208,1230,1616
E01029995,9,32,27,44,1490,1602
E01029996,5,82,76,141,1397,1701
E01033127,7,32,89,81,1319,1528
E01033128,2,25,37,28,1010,1102
E01033131,10,50,72,119,1191,1442
E01030017,18,11,69,20,1247,1365
E01030018,12,59,91,24,1278,1464
E01030019,0,18,30,40,1467,1555
E01030020,4,51,30,5,1410,1500
E01030021,22,49,92,16,1213,1392
E01029978,2,36,32,30,1221,1321
E01029979,10,38,93,39,1470,1650
E01029980,11,62,84,50,1418,1625
E01029981,0,17,21,22,1106,1166
E01029982,1,29,53,73,1305,1461
E01029983,8,58,64,68,1371,1569
E01030052,7,6,12,11,2118,2154
E01030058,0,0,6,6,2048,2060
E01030064,1,1,12,8,2286,2308
E01030088,0,3,6,7,1151,1167
E01030039,1,5,11,3,1442,1462
E01030054,0,0,10,2,1241,1253
E01030055,0,3,12,6,1377,1398
E01030066,2,3,15,3,1562,1585
E01030067,1,2,17,9,1244,1273
E01030068,0,5,16,5,1662,1688
E01030053,1,7,17,2,2265,2292
E01030082,2,2,18,24,2511,2557
E01030090,4,7,18,8,2392,2429
E01030040,1,1,6,3,1184,1195
E01030049,0,4,14,13,1660,1691
E01030050,0,1,19,47,1971,2038
E01030084,3,4,17,5,1582,1611
E01030085,1,3,12,6,1599,1621
E01030037,0,2,7,18,1184,1211
E01030038,0,1,7,4,1216,1228
E01030059,0,1,14,3,2236,2254
E01030081,1,3,11,4,2244,2263
E01030051,3,0,19,14,1660,1696
E01030056,0,4,16,1,2160,2181
E01030065,2,4,19,8,2047,2080
E01030086,2,2,19,5,1149,1177
E01030089,1,3,16,6,1969,1995
E01030048,6,5,18,16,2324,2369
E01030057,2,3,31,3,2284,2323
E01030083,1,2,29,14,2280,2326
E01030087,0,0,11,4,1348,1363
E01030073,1,8,13,6,1474,1502
E01030077,2,3,16,23,1459,1503
E01030079,5,7,18,16,1586,1632
E01030080,0,9,18,19,1595,1641
E01030063,1,7,30,14,2312,2364
E01030069,0,7,6,2,1295,1310
E01030072,6,5,14,21,1558,1604
E01030075,0,1,10,17,1640,1668
E01030060,2,4,11,8,1611,1636
E01030071,4,3,15,17,1428,1467
E01030076,2,2,8,28,1449,1489
E01030078,0,4,15,3,1695,1717
E01033316,0,11,33,16,1512,1572
E01033317,3,3,28,27,1512,1573
E01033319,3,10,33,23,1843,1912
E01030041,0,6,10,10,2139,2165
E01030043,3,7,22,5,1198,1235
E01030061,1,7,23,9,1516,1556
E01030062,1,15,17,13,1290,1336
E01030070,15,147,71,59,1908,2200
E01030042,2,6,19,1,1539,1567
E01030044,0,4,18,7,1119,1148
E01030045,0,5,28,13,1758,1804
E01030046,0,3,15,14,1592,1624
E01030047,0,0,7,8,1243,1258
E01030095,1,0,6,3,1169,1179
E01030096,3,1,11,10,1418,1443
E01030097,2,3,5,3,1188,1201
E01030145,0,3,9,3,1397,1412
E01030146,5,2,10,0,1078,1095
E01030094,0,2,22,10,1378,1412
E01030121,4,5,17,8,2331,2365
E01030132,2,55,26,20,1853,1956
E01030133,0,15,15,8,1426,1464
E01030130,4,3,22,16,1248,1293
E01030131,3,13,24,26,1233,1299
E01030139,6,5,29,42,1643,1725
E01030140,1,2,13,3,1258,1277
E01030141,3,9,19,13,1563,1607
E01030103,1,3,15,15,1996,2030
E01030104,3,4,24,22,2138,2191
E01030138,6,1,14,11,2309,2341
E01030127,2,7,16,32,1189,1246
E01030128,3,16,29,22,1402,1472
E01030129,0,6,20,15,1386,1427
E01033044,9,7,43,31,1368,1458
E01033045,8,15,25,40,984,1072
E01033050,5,7,24,34,1223,1293
E01030091,14,14,23,42,1689,1782
E01030093,12,10,27,26,1457,1532
E01030137,5,8,35,29,1514,1591
E01033043,6,13,26,17,1162,1224
E01033046,9,8,28,18,1060,1123
E01033047,2,2,26,33,1113,1176
E01030092,5,8,24,14,1628,1679
E01030123,1,3,21,19,1552,1596
E01030124,2,4,10,8,1506,1530
E01030125,14,6,11,24,1456,1511
E01030148,5,2,12,17,1224,1260
E01030149,0,4,20,12,1441,1477
E01030098,3,6,11,7,2290,2317
E01030100,7,6,15,14,2048,2090
E01030119,0,7,20,10,2218,2255
E01030134,1,3,13,4,1167,1188
E01030135,3,16,7,24,1408,1458
E01030142,12,9,16,74,1601,1712
E01030143,3,12,29,190,1358,1592
E01030144,1,1,9,29,1195,1235
E01030147,1,7,10,40,1400,1458
E01033048,0,5,21,25,1223,1274
E01033049,6,5,14,12,1155,1192
E01030099,2,2,3,13,1964,1984
E01030101,1,1,10,7,2009,2028
E01030150,3,8,10,10,2161,2192
E01030120,13,178,86,94,2631,3002
E01030122,0,8,29,20,1960,2017
E01030151,6,58,39,45,2086,2234
E01030109,4,11,19,42,1788,1864
E01030110,14,13,43,62,2707,2839
E01030111,2,2,13,22,1353,1392
E01030112,6,23,24,27,1621,1701
E01030115,2,8,28,25,2301,2364
E01030116,0,34,34,73,2158,2299
E01030117,1,15,11,32,1573,1632
E01030118,6,29,26,64,1554,1679
E01030105,10,40,34,39,1674,1797
E01030106,4,31,34,63,2322,2454
E01030107,1,9,8,12,1590,1620
E01030108,2,34,37,54,1758,1885
E01030113,0,28,27,28,1817,1900
E01030114,3,27,23,17,1545,1615
E01030201,0,2,12,10,2052,2076
E01030219,3,2,21,6,1934,1966
E01030222,2,1,9,11,1878,1901
E01030154,0,4,10,9,2121,2144
E01030172,0,0,12,19,1626,1657
E01030173,4,3,27,100,1551,1685
E01030174,1,2,11,11,1377,1402
E01030176,2,3,8,10,1954,1977
E01030186,0,0,9,1,1439,1449
E01030208,1,1,11,5,1251,1269
E01030209,2,0,9,19,1490,1520
E01030210,1,5,24,7,2087,2124
E01030212,4,2,10,4,1891,1911
E01030152,0,0,7,5,1989,2001
E01030153,0,1,10,14,1199,1224
E01030187,0,1,16,30,1534,1581
E01030188,0,1,19,34,1585,1639
E01030189,2,1,17,24,1647,1691
E01030193,1,5,26,14,1592,1638
E01030194,2,5,21,16,1568,1612
E01030195,2,6,19,7,1599,1633
E01030220,1,5,20,4,2126,2156
E01030175,1,5,17,17,2266,2306
E01030200,1,4,22,11,2234,2272
E01030221,0,1,13,17,1934,1965
E01030199,4,10,13,13,1790,1830
E01033443,7,26,23,17,1666,1739
E01033445,3,3,23,23,1651,1703
E01033446,8,86,52,48,2279,2473
E01033448,2,6,7,11,1249,1275
E01033449,1,6,18,18,1642,1685
E01030155,2,6,21,40,2004,2073
E01030185,2,6,33,40,2040,2121
E01030203,1,6,31,31,1898,1967
E01030211,0,15,35,21,1864,1935
E01030179,11,28,44,118,2485,2686
E01030180,0,8,15,42,1333,1398
E01030183,0,5,26,20,1914,1965
E01030184,8,9,35,35,1684,1771
E01030207,2,5,14,28,1426,1475
E01030181,11,18,55,106,1803,1993
E01030190,1,3,8,21,1762,1795
E01030191,9,9,31,55,1517,1621
E01030192,4,10,21,21,1425,1481
E01030198,0,1,4,7,1282,1294
E01033442,2,26,44,72,1478,1622
E01033444,5,10,30,79,1385,1509
E01033447,2,6,9,35,1406,1458
E01030196,11,28,36,70,1545,1690
E01030197,3,17,21,32,1545,1618
E01030204,14,6,38,61,1731,1850
E01030205,6,24,14,46,1224,1314
E01030206,6,5,27,63,1445,1546
E01030171,5,6,20,31,1880,1942
E01030214,1,8,9,20,1289,1327
E01030215,0,1,12,6,1296,1315
E01030216,2,3,10,7,1463,1485
E01030217,2,6,15,5,1288,1316
E01030218,0,3,12,14,1451,1480
E01030158,5,2,32,10,1382,1431
E01030159,10,8,19,24,1438,1499
E01030164,6,3,13,24,1470,1516
E01030166,3,10,14,23,1469,1519
E01033450,1,1,10,25,2342,2379
E01030160,3,7,21,10,1365,1406
E01030161,2,3,30,7,1351,1393
E01030168,2,3,36,17,1401,1459
E01030169,3,7,18,30,1488,1546
E01030170,1,3,26,18,1655,1703
E01030162,6,10,36,49,1290,1391
E01030163,4,11,24,28,1458,1525
E01030165,8,7,22,57,1486,1580
E01030167,2,6,26,49,1317,1400
E01030240,1,2,9,13,1540,1565
E01030241,0,8,8,11,1413,1440
E01030242,3,4,12,13,1363,1395
E01030259,0,3,5,2,1122,1132
E01030260,1,72,50,47,1266,1436
E01030261,0,8,19,22,1370,1419
E01030262,0,9,16,4,1212,1241
E01030277,4,3,8,13,1164,1192
E01030279,1,2,10,7,1371,1391
E01030281,2,3,39,18,2344,2406
E01030266,7,3,9,7,1650,1676
E01030267,1,2,13,14,1328,1358
E01030271,0,3,7,6,1440,1456
E01030278,0,9,11,7,1551,1578
E01030280,1,0,10,10,1379,1400
E01030246,0,3,12,23,1374,1412
E01030248,0,8,30,11,1438,1487
E01030249,6,16,24,25,1575,1646
E01030250,6,7,34,47,1712,1806
E01030264,2,0,12,33,1380,1427
E01030265,1,2,17,16,1410,1446
E01030255,1,3,32,18,1303,1357
E01030263,1,4,14,11,1335,1365
E01030270,3,4,16,15,1504,1542
E01030289,0,9,19,9,1408,1445
E01030290,0,3,11,7,1487,1508
E01030233,1,5,7,5,1494,1512
E01030235,0,2,20,8,1452,1482
E01030268,1,1,8,13,1330,1353
E01030269,0,3,16,2,1600,1621
E01030288,1,0,8,9,1396,1414
E01030247,2,11,22,37,1395,1467
E01030254,7,11,23,20,1402,1463
E01030256,7,11,37,13,1443,1511
E01030258,8,3,28,29,1460,1528
E01030276,0,1,4,5,1219,1229
E01030257,0,7,17,8,1548,1580
E01030274,0,1,11,2,1173,1187
E01030275,2,1,14,7,1107,1131
E01030287,0,14,10,12,1389,1425
E01030291,0,9,11,5,1452,1477
E01030234,3,4,25,16,1544,1592
E01030236,0,12,16,12,1697,1737
E01030237,1,10,30,25,2836,2902
E01030238,2,7,27,14,1798,1848
E01030223,4,3,11,8,1689,1715
E01030224,2,3,23,11,1636,1675
E01030225,11,0,16,16,1572,1615
E01030227,1,7,11,3,1419,1441
E01030228,2,0,13,6,1752,1773
E01030226,1,5,23,18,1857,1904
E01030286,0,4,7,6,2168,2185
E01030292,1,2,4,5,1473,1485
E01030293,0,5,18,21,1656,1700
E01030294,0,1,19,10,1458,1488
E01030239,2,2,19,25,1970,2018
E01030251,1,2,15,11,1543,1572
E01030252,3,0,11,7,1724,1745
E01030253,1,2,23,16,1746,1788
E01030272,0,4,11,15,1466,1496
E01030273,1,2,8,12,1497,1520
E01030230,6,4,33,17,1770,1830
E01030231,2,1,19,12,1534,1568
E01030232,1,2,18,15,1693,1729
E01030285,0,2,16,6,2218,2242
E01030282,0,1,19,3,1075,1098
E01030283,0,3,23,38,1295,1359
E01030284,2,2,12,3,1204,1223
E01030295,0,3,16,5,2200,2224
E01030229,2,2,13,9,2124,2150
E01030243,2,0,11,2,1446,1461
E01030244,0,2,7,6,1662,1677
E01030245,1,2,15,2,1568,1588
E01000907,40,113,104,122,1051,1430
E01000908,74,127,137,98,1145,1581
E01000909,47,46,89,75,1357,1614
E01000912,44,146,89,81,1229,1589
E01000913,12,22,87,81,1508,1710
E01000893,24,16,71,75,1380,1566
E01000894,34,21,48,116,1170,1389
E01000895,35,50,114,130,1301,1630
E01000896,28,38,78,113,1435,1692
E01000899,28,23,65,99,1452,1667
E01000910,25,43,103,62,1239,1472
E01000911,47,109,82,105,1216,1559
E01000921,38,119,153,154,1502,1966
E01000923,30,81,94,107,1182,1494
E01000928,53,112,104,159,1253,1681
E01000878,63,67,107,275,1112,1624
E01000879,54,33,70,129,1172,1458
E01000880,62,35,99,192,1214,1602
E01000884,40,32,85,139,1173,1469
E01000885,76,20,106,158,1124,1484
E01000871,96,79,116,204,1169,1664
E01000872,79,141,134,275,1273,1902
E01000873,55,75,65,112,1332,1639
E01000874,88,36,73,184,1178,1559
E01000877,60,51,83,135,1245,1574
E01000886,27,37,104,80,1197,1445
E01000887,64,40,92,144,1146,1486
E01000888,37,78,106,139,1245,1605
E01000892,48,107,109,208,1371,1843
E01000903,35,73,74,190,1067,1439
E01000889,71,195,140,247,1017,1670
E01000890,82,240,90,228,1000,1640
E01000891,60,247,97,278,893,1575
E01000901,102,273,150,467,985,1977
E01000922,35,167,117,110,1118,1547
E01000927,42,98,113,150,1335,1738
E01000881,39,78,121,247,1025,1510
E01000882,45,21,73,150,1224,1513
E01000883,56,31,69,320,850,1326
E01000897,41,14,98,175,1269,1597
E01000898,76,153,151,337,1012,1729
E01000866,91,185,128,193,1433,2030
E01000870,25,174,99,128,1267,1693
E01000924,33,87,93,135,1289,1637
E01000925,34,297,74,293,865,1563
E01000926,148,136,80,365,1062,1791
E01000969,68,58,114,279,1513,2032
E01000970,42,45,63,119,1175,1444
E01000971,35,28,73,146,1196,1478
E01000972,93,328,127,317,1144,2009
E01000973,65,199,118,311,1192,1885
E01000842,42,34,66,133,1169,1444
E01000844,45,38,100,251,1338,1772
E01000848,75,27,74,161,1251,1588
E01000849,48,44,88,196,1193,1569
E01000900,59,198,88,156,1300,1801
E01000902,92,218,115,255,771,1451
E01000904,66,236,146,267,1405,2120
E01000905,78,387,97,417,1065,2044
E01000906,54,66,83,142,1187,1532
E01000875,69,142,105,221,1117,1654
E01000876,103,274,127,224,1020,1748
E01000931,152,294,115,223,1126,1910
E01000932,81,153,91,231,1282,1838
E01000974,88,259,116,202,1042,1707
E01000843,49,117,102,215,1195,1678
E01000845,24,64,72,161,1143,1464
E01000846,62,263,84,211,881,1501
E01000847,70,187,95,335,999,1686
E01000864,52,126,82,145,1132,1537
E01000865,20,54,63,250,1118,1505
E01000867,48,160,90,357,953,1608
E01000868,31,372,98,254,687,1442
E01000869,51,187,154,189,1529,2110
E01000962,46,49,67,241,1189,1592
E01000964,51,83,67,199,1177,1577
E01000965,69,78,76,213,1086,1522
E01000966,33,13,52,146,1268,1512
E01000968,42,70,82,189,1122,1505
E01000960,88,90,87,424,1085,1774
E01000961,100,180,68,389,854,1591
E01000963,158,106,73,591,995,1923
E01000967,48,54,57,185,1065,1409
E01000857,30,40,70,138,1169,1447
E01000858,84,278,138,285,1076,1861
E01000859,20,31,81,76,1378,1586
E01000860,32,52,50,90,1083,1307
E01000862,71,51,69,117,1404,1712
E01000856,49,179,119,358,940,1645
E01000861,36,130,83,231,1094,1574
E01000957,66,258,90,258,1057,1729
E01000958,138,282,171,451,1222,2264
E01000959,52,212,79,399,928,1670
E01000929,153,274,103,250,895,1675
E01000930,234,269,91,201,1115,1910
E01000933,102,91,85,173,1220,1671
E01000934,91,244,79,370,835,1619
E01000935,88,323,79,185,740,1415
E01000863,33,113,55,146,1134,1481
E01000946,82,114,66,274,980,1516
E01000947,68,212,95,334,1245,1954
E01000948,63,135,86,168,1284,1736
E01000952,66,259,90,429,885,1729
E01000953,63,216,61,534,769,1643
E01000954,83,319,94,429,731,1656
E01000955,74,219,119,361,822,1595
E01000956,61,212,86,542,631,1532
E01000944,166,176,95,546,916,1899
E01000945,69,193,88,618,853,1821
E01000949,44,171,84,357,977,1633
E01000950,88,173,47,555,568,1431
E01000951,86,186,64,489,713,1538
E01000936,48,280,135,476,900,1839
E01000938,89,322,90,443,808,1752
E01000939,40,164,62,548,409,1223
E01000940,42,106,70,332,580,1130
E01000853,34,189,98,337,973,1631
E01000937,52,118,71,476,787,1504
E01000941,54,151,60,381,584,1230
E01000942,63,78,113,581,1276,2111
E01000943,43,61,49,230,671,1054
E01000850,69,72,88,382,1083,1694
E01000851,85,119,106,598,1475,2383
E01000852,56,57,67,474,933,1587
E01000854,147,229,77,615,765,1833
E01000915,49,140,72,508,758,1527
E01000916,70,140,105,357,1124,1796
E01000917,61,241,110,502,974,1888
E01000920,52,122,104,336,1332,1946
E01000855,67,65,64,306,1262,1764
E01000914,51,100,78,336,1197,1762
E01000918,78,130,134,440,1308,2090
E01000919,93,117,143,515,1146,2014
E01000001,34,11,54,128,1238,1465
E01000002,9,4,54,95,1274,1436
E01000003,23,45,55,168,1055,1346
E01000005,46,100,59,274,506,985
E01032739,23,9,37,162,813,1044
E01032740,19,24,30,113,913,1099
E01001808,198,76,41,62,1461,1838
E01001809,265,192,72,105,1343,1977
E01001814,170,208,78,137,1067,1660
E01001823,223,278,80,97,1087,1765
E01001825,162,78,24,34,1300,1598
E01001714,94,387,96,173,740,1490
E01001811,110,452,92,201,648,1503
E01001813,107,363,92,172,516,1250
E01033701,171,578,154,207,739,1849
E01001799,142,129,46,73,1192,1582
E01001802,120,169,46,108,851,1294
E01001804,109,134,69,106,1110,1528
E01001807,141,356,95,113,1101,1806
E01001812,153,231,86,69,1207,1746
E01001725,177,275,72,211,1174,1909
E01001726,112,411,71,203,560,1357
E01001800,159,324,67,93,954,1597
E01001824,120,330,90,114,863,1517
E01001826,203,296,70,104,1067,1740
E01001723,118,189,89,395,1153,1944
E01001724,80,248,132,348,1411,2219
E01001727,158,244,63,250,1205,1920
E01001768,80,353,94,261,1037,1825
E01001769,78,360,115,185,856,1594
E01001715,57,144,94,95,931,1321
E01001716,61,259,75,176,747,1318
E01001717,95,163,55,189,720,1222
E01001718,64,92,108,177,1346,1787
E01001719,88,278,74,107,592,1139
E01001720,50,143,118,114,1311,1736
E01001742,73,376,158,197,1006,1810
E01001801,99,196,75,96,1198,1664
E01001803,118,120,123,92,1410,1863
E01001806,65,302,107,86,986,1546
E01001741,63,133,77,134,1083,1490
E01001805,47,148,58,118,835,1206
E01001829,32,141,94,140,1387,1794
E01001831,52,259,117,193,1056,1677
E01001832,54,242,104,306,913,1619
E01001764,97,413,117,233,828,1688
E01001765,88,691,147,256,535,1717
E01001767,56,355,118,244,830,1603
E01001770,89,561,146,239,703,1738
E01033703,82,337,71,181,739,1410
E01033713,49,275,129,182,711,1346
E01001792,61,366,104,439,810,1780
E01001793,49,424,97,249,866,1685
E01001794,39,312,111,418,1029,1909
E01001795,36,273,90,228,837,1464
E01001796,75,384,148,218,822,1647
E01001736,65,268,118,102,1103,1656
E01001737,64,214,133,150,1281,1842
E01001738,91,195,111,77,1284,1758
E01001739,42,251,127,96,1574,2090
E01001786,79,986,113,157,490,1825
E01001787,117,654,90,124,604,1589
E01001788,75,682,108,177,540,1582
E01001790,82,711,87,137,326,1343
E01001740,135,487,106,197,641,1566
E01001747,122,409,133,172,1301,2137
E01001830,110,498,167,156,973,1904
E01001833,71,520,168,247,1137,2143
E01001834,93,415,136,193,1222,2059
E01001835,44,192,62,156,795,1249
E01001733,48,374,157,201,1042,1822
E01001785,58,410,97,157,764,1486
E01001789,55,459,107,196,922,1739
E01001791,71,534,147,213,569,1534
E01001745,107,781,137,229,995,2249
E01001746,126,644,123,206,557,1656
E01001757,72,780,125,339,401,1717
E01001758,151,699,152,271,814,2087
E01001759,94,525,129,167,889,1804
E01001761,59,494,128,185,913,1779
E01001731,84,689,181,263,1083,2300
E01001734,53,462,132,169,1005,1821
E01001760,89,470,141,185,869,1754
E01001762,66,301,134,133,1131,1765
E01001846,38,469,69,120,520,1216
E01001847,35,325,97,123,549,1129
E01001848,49,520,96,79,910,1654
E01001849,150,689,175,224,1126,2364
E01001729,69,860,180,235,677,2021
E01001730,143,670,183,221,704,1921
E01001732,89,713,131,186,596,1715
E01001735,47,433,107,120,925,1632
E01001838,109,693,137,243,564,1746
E01001850,104,854,120,187,545,1810
E01001748,98,447,133,243,1385,2306
E01001749,55,272,71,108,1211,1717
E01001763,49,446,85,138,924,1642
E01001816,42,370,107,91,1015,1625
E01001819,37,252,95,120,1073,1577
E01001744,109,500,64,128,1078,1879
E01001750,106,327,100,207,1098,1838
E01001751,29,72,91,61,1294,1547
E01001756,49,210,143,141,1612,2155
E01033698,98,349,72,167,573,1259
E01033699,53,213,104,153,694,1217
E01033700,65,239,142,164,956,1566
E01033707,83,294,71,152,703,1303
E01001836,77,400,111,101,1177,1866
E01001840,55,551,92,218,760,1676
E01001841,22,214,72,68,1035,1411
E01001844,72,330,132,176,1296,2006
E01001845,63,541,104,115,732,1555
E01001837,19,120,82,131,1136,1488
E01001839,104,389,180,192,1346,2211
E01001842,69,511,145,184,680,1589
E01001843,43,309,90,118,684,1244
E01033704,78,211,91,130,1121,1631
E01033712,53,321,84,169,951,1578
E01001772,54,406,75,134,377,1046
E01001774,106,455,108,237,1189,2095
E01001775,135,494,98,296,753,1776
E01001815,47,585,121,244,777,1774
E01001820,65,527,75,124,672,1463
E01001821,94,484,107,107,668,1460
E01001752,57,493,136,235,1386,2307
E01001753,119,648,132,139,591,1629
E01001754,106,499,173,240,1361,2379
E01001755,103,501,154,178,852,1788
E01001773,111,512,137,305,987,2052
E01001776,100,441,79,149,670,1439
E01001779,154,557,165,350,1211,2437
E01001781,88,395,111,181,892,1667
E01001782,114,281,167,245,1493,2300
E01001783,158,656,117,208,758,1897
E01001777,111,559,142,253,1293,2358
E01001780,106,428,181,162,948,1825
E01001784,123,503,121,340,1186,2273
E01033706,53,132,100,158,1096,1539
E01033708,46,74,139,136,1204,1599
E01033709,76,368,106,190,930,1670
E01033711,55,115,76,155,704,1105
E01001798,122,562,147,345,609,1785
E01001828,122,804,159,215,757,2057
E01033702,77,264,105,173,574,1193
E01033705,79,534,134,172,498,1417
E01033710,54,288,94,128,595,1159
E01001722,106,598,155,242,927,2028
E01001728,173,396,75,207,1164,2015
E01001822,166,515,109,245,750,1785
E01001827,106,518,117,178,997,1916
E01001874,127,354,131,256,1187,2055
E01001875,158,382,113,223,978,1854
E01001876,301,486,148,388,909,2232
E01001877,91,365,100,183,606,1345
E01001878,148,350,138,146,907,1689
E01001955,139,499,139,158,872,1807
E01001957,139,602,84,223,568,1616
E01001958,172,671,115,185,528,1671
E01001961,142,607,125,167,523,1564
E01001954,82,276,102,128,937,1525
E01001956,93,205,97,143,1055,1593
E01001959,195,346,126,193,868,1728
E01001960,104,228,116,171,1266,1885
E01001943,123,276,121,244,1190,1954
E01001944,127,637,139,132,654,1689
E01001945,100,231,82,137,1202,1752
E01001946,61,267,114,138,1053,1633
E01001862,139,342,141,125,1021,1768
E01001940,106,319,119,147,910,1601
E01001941,94,179,91,215,1098,1677
E01001942,102,248,103,229,1187,1869
E01001858,85,235,118,201,1154,1793
E01001860,108,348,125,234,954,1769
E01001861,88,329,100,136,845,1498
E01001863,52,192,57,88,1142,1531
E01001864,77,192,86,111,1112,1578
E01001852,98,128,95,155,1316,1792
E01001853,44,100,78,103,1208,1533
E01001854,61,168,107,168,1228,1732
E01001857,128,347,90,132,780,1477
E01001859,154,508,180,216,1483,2541
E01001865,76,118,111,168,1209,1682
E01001927,21,31,86,104,1262,1504
E01001930,111,194,90,141,1318,1854
E01001895,75,175,117,119,1108,1594
E01001896,80,221,101,171,975,1548
E01001897,53,117,60,92,1139,1461
E01001929,28,43,57,51,1081,1260
E01001851,31,96,82,58,1365,1632
E01001855,68,97,62,126,1324,1677
E01001856,116,255,84,142,1078,1675
E01001869,47,50,41,94,1102,1334
E01001873,77,143,96,129,1005,1450
E01001928,77,199,109,111,1228,1724
E01001931,155,198,88,160,897,1498
E01001932,138,137,54,136,1156,1621
E01001933,62,117,83,99,963,1324
E01001866,192,85,73,197,1032,1579
E01001867,164,71,85,277,765,1362
E01001868,109,256,89,155,732,1341
E01001870,136,132,86,382,1196,1932
E01001871,254,73,88,218,971,1604
E01001872,122,94,106,214,1078,1614
E01001893,82,216,93,112,741,1244
E01001894,45,243,61,111,860,1320
E01001898,95,147,96,175,1078,1591
E01001899,113,208,112,109,838,1380
E01001900,108,265,100,167,1145,1785
E01001889,45,95,41,144,1065,1390
E01001910,79,113,77,181,1062,1512
E01001913,52,23,64,99,1307,1545
E01001914,109,140,92,222,1152,1715
E01001885,141,371,93,133,581,1319
E01001908,82,93,79,235,1147,1636
E01001909,73,171,110,156,1312,1822
E01001911,162,409,111,189,890,1761
E01001912,181,336,91,234,756,1598
E01001886,52,223,100,146,1051,1572
E01001887,71,168,75,166,1039,1519
E01001890,105,177,77,405,1051,1815
E01001892,83,225,81,86,891,1366
E01001880,68,110,65,136,1118,1497
E01001881,53,79,64,116,1303,1615
E01001882,68,98,67,162,1367,1762
E01001883,78,115,81,168,1043,1485
E01001884,102,198,103,219,1221,1843
E01001888,49,55,71,144,1295,1614
E01001891,99,96,85,286,1464,2030
E01001917,48,59,47,79,1229,1462
E01001918,44,74,75,98,1228,1519
E01001919,77,52,96,54,1351,1630
E01001879,55,167,82,100,1071,1475
E01001901,47,55,84,80,1359,1625
E01001902,52,117,70,105,1355,1699
E01001903,131,194,88,141,1095,1649
E01001920,90,149,76,97,1101,1513
E01001921,41,83,51,80,1281,1536
E01001922,69,60,66,65,1345,1605
E01001923,78,81,79,100,1141,1479
E01001924,54,19,66,75,1382,1596
E01001947,98,367,121,125,737,1448
E01001948,79,141,93,101,1598,2012
E01001949,31,36,50,50,1380,1547
E01001950,33,42,66,66,1389,1596
E01001951,58,101,65,102,1283,1609
E01001953,78,132,68,114,974,1366
E01001904,32,75,45,95,1340,1587
E01001905,20,58,82,99,1443,1702
E01001906,30,64,62,98,1185,1439
E01001907,27,40,45,84,1107,1303
E01001935,63,162,101,118,1615,2059
E01001939,86,276,154,254,1551,2321
E01032788,29,157,70,83,767,1106
E01032789,114,143,73,178,643,1151
E01032790,109,160,80,121,648,1118
E01001915,40,44,38,66,1294,1482
E01001916,36,11,35,48,1260,1390
E01001926,14,21,66,82,1273,1456
E01001952,65,82,69,112,1295,1623
E01001925,40,47,84,88,1369,1628
E01001934,80,209,96,142,1095,1622
E01001937,48,76,77,107,1515,1823
E01001938,66,258,107,108,1021,1560
E01001969,84,273,119,213,1199,1888
E01001971,100,520,182,216,994,2012
E01001974,111,226,125,296,1440,2198
E01001975,85,219,92,169,1152,1717
E01002036,88,665,115,124,627,1619
E01002037,102,721,123,185,701,1832
E01002039,84,661,112,115,638,1610
E01002040,82,912,141,164,763,2062
E01001962,50,179,131,137,1261,1758
E01001970,99,525,126,256,975,1981
E01001972,79,300,122,138,1033,1672
E01001973,77,292,153,267,1468,2257
E01002090,99,364,104,210,824,1601
E01002093,89,483,124,165,934,1795
E01002096,105,417,129,161,833,1645
E01002097,125,447,176,174,771,1693
E01002091,142,507,120,139,894,1802
E01002092,115,642,118,140,682,1697
E01002094,116,473,115,154,696,1554
E01002095,107,468,140,181,748,1644
E01002098,49,149,82,144,925,1349
E01002101,113,257,146,210,1190,1916
E01002102,127,281,106,233,1135,1882
E01002105,68,289,116,337,1242,2052
E01002099,121,579,149,245,1014,2108
E01002100,100,358,144,369,938,1909
E01002103,104,284,133,297,1044,1862
E01002104,73,261,108,234,760,1436
E01001963,38,99,92,95,1496,1820
E01001964,30,115,107,131,1205,1588
E01001965,29,79,116,61,1342,1627
E01001966,35,59,79,84,1256,1513
E01002027,51,265,94,243,884,1537
E01002028,79,309,144,220,1015,1767
E01002032,100,351,142,223,997,1813
E01002033,107,382,126,286,1007,1908
E01001976,60,584,120,162,702,1628
E01001977,71,496,121,176,716,1580
E01001978,114,711,141,202,737,1905
E01001979,207,704,126,277,885,2199
E01002074,170,879,146,135,792,2122
E01002077,141,614,134,215,975,2079
E01002079,126,467,96,187,766,1642
E01002081,126,574,120,226,723,1769
E01002082,95,705,79,126,503,1508
E01002086,106,448,109,150,833,1646
E01002088,89,250,126,248,1140,1853
E01002089,92,769,87,73,499,1520
E01001967,43,53,124,66,1369,1655
E01001968,79,68,131,104,1452,1834
E01001996,29,69,76,74,1377,1625
E01001997,45,41,92,87,1314,1579
E01002075,108,597,114,197,761,1777
E01002076,104,614,128,268,774,1888
E01002078,116,733,166,207,972,2194
E01002080,54,441,103,345,650,1593
E01002026,90,505,120,179,725,1619
E01002029,104,395,118,207,901,1725
E01002030,115,268,99,216,942,1640
E01002031,91,282,93,290,1174,1930
E01001991,28,73,116,98,1378,1693
E01001992,31,26,74,121,1457,1709
E01001993,19,18,95,63,1491,1686
E01001995,83,290,226,195,1618,2412
E01001980,90,610,125,290,871,1986
E01001981,114,544,139,217,747,1761
E01001982,61,585,105,173,848,1772
E01001983,73,384,127,188,880,1652
E01002083,71,180,63,275,851,1440
E01002084,91,203,95,232,1002,1623
E01002085,126,367,153,304,1218,2168
E01002087,81,258,135,202,938,1614
E01002014,59,162,105,145,1248,1719
E01002015,34,241,116,122,967,1480
E01002018,45,157,88,91,1039,1420
E01033085,102,253,149,142,1134,1780
E01033086,85,269,98,74,565,1091
E01002020,46,141,113,56,1208,1564
E01002022,46,60,85,81,1649,1921
E01002023,21,73,65,60,1255,1474
E01002025,37,52,108,75,1445,1717
E01002013,16,76,73,75,1161,1401
E01002019,22,30,62,55,1140,1309
E01002021,20,65,73,55,1266,1479
E01002024,31,79,65,75,1070,1320
E01001998,85,180,99,287,1407,2058
E01001999,100,231,134,220,1316,2001
E01002003,137,367,134,273,1249,2160
E01002004,80,205,126,266,1212,1889
E01002067,91,465,118,176,844,1694
E01002069,112,474,102,269,980,1937
E01002070,95,450,161,270,1062,2038
E01002073,90,464,165,167,877,1763
E01002066,131,679,160,180,693,1843
E01002068,72,548,109,163,930,1822
E01002071,133,564,108,186,624,1615
E01002072,117,562,126,190,873,1868
E01002043,90,402,166,275,1087,2020
E01002045,154,645,135,256,1009,2199
E01002046,70,577,86,187,805,1725
E01002049,108,541,135,239,858,1881
E01002042,73,244,88,172,882,1459
E01002044,108,164,115,212,1130,1729
E01002047,75,158,120,221,1096,1670
E01002048,112,373,103,281,1086,1955
E01002016,66,274,128,126,1365,1959
E01002017,87,236,120,105,1261,1809
E01002059,45,203,134,71,1218,1671
E01002060,38,119,108,60,1434,1759
E01002050,173,217,58,152,1295,1895
E01002051,122,429,124,131,877,1683
E01002052,246,232,62,104,1376,2020
E01002055,152,127,71,111,1197,1658
E01001994,60,82,88,205,1349,1784
E01002008,46,45,73,111,1296,1571
E01002010,57,122,112,90,1277,1658
E01002011,55,123,89,128,1323,1718
E01002000,53,199,120,147,1178,1697
E01002001,102,151,106,148,1154,1661
E01002002,71,235,129,191,1180,1806
E01002058,107,245,94,204,1040,1690
E01002053,90,516,162,173,804,1745
E01002054,101,560,122,147,802,1732
E01002056,114,509,112,123,1106,1964
E01002057,73,397,68,145,898,1581
E01001984,45,90,96,109,1250,1590
E01001985,11,45,86,71,1477,1690
E01001987,42,45,94,107,1559,1847
E01001989,38,115,99,92,1381,1725
E01001986,59,89,109,48,1330,1635
E01001988,42,74,104,95,1456,1771
E01001990,90,77,117,144,1709,2137
E01002062,62,190,118,118,1386,1874
E01002005,40,53,112,119,1364,1688
E01002006,47,83,73,96,1303,1602
E01002007,16,67,94,92,1407,1676
E01002009,37,33,87,94,1468,1719
E01002061,49,122,94,69,1353,1687
E01002063,71,209,92,78,1137,1587
E01002064,73,307,75,114,945,1514
E01002065,41,181,91,109,1244,1666
E01002034,95,782,157,160,665,1859
E01002038,119,534,129,98,773,1653
E01002041,111,751,132,131,761,1886
E01032575,106,795,146,147,714,1908
E01002755,61,219,112,89,845,1326
E01002756,35,168,93,75,961,1332
E01002758,86,335,146,149,860,1576
E01002804,80,413,101,148,927,1669
E01002807,74,328,116,155,1061,1734
E01002811,81,357,122,78,907,1545
E01002753,45,268,109,113,894,1429
E01002754,25,117,87,84,1195,1508
E01002757,55,202,99,125,952,1433
E01002759,31,156,99,105,1256,1647
E01002760,66,342,147,136,852,1543
E01002772,70,271,103,149,1255,1848
E01002735,45,305,141,177,977,1645
E01002805,39,196,108,123,1103,1569
E01002806,24,247,98,77,1149,1595
E01002808,56,213,107,171,1360,1907
E01002809,57,207,118,220,1038,1640
E01002810,70,345,128,108,1001,1652
E01002768,48,139,113,110,1194,1604
E01002770,25,177,116,153,1070,1541
E01002771,38,215,123,101,1006,1483
E01002773,80,237,110,124,835,1386
E01002774,78,251,163,152,1466,2110
E01002732,86,478,126,241,914,1845
E01002734,94,533,187,145,733,1692
E01002736,84,443,111,179,763,1580
E01002737,93,522,185,182,975,1957
E01002751,107,473,122,209,885,1796
E01002742,20,97,91,75,1278,1561
E01002747,34,135,95,137,1234,1635
E01002748,54,344,88,189,792,1467
E01002749,36,213,108,128,831,1316
E01033493,18,46,63,99,1075,1301
E01033494,39,129,67,104,1159,1498
E01002730,72,192,109,209,1199,1781
E01002731,132,259,197,255,1623,2466
E01002733,38,118,87,137,1012,1392
E01002763,54,151,74,167,991,1437
E01002769,56,108,131,235,1523,2053
E01002785,49,166,126,122,1505,1968
E01002788,40,120,120,104,1467,1851
E01002789,18,90,106,73,1587,1874
E01002738,40,184,105,95,1361,1785
E01002741,79,294,70,90,980,1513
E01002743,46,250,122,121,1133,1672
E01002744,49,111,79,68,1135,1442
E01002752,65,206,106,159,986,1522
E01002764,57,217,141,135,1229,1779
E01002783,43,225,91,76,1052,1487
E01002784,50,327,136,136,1146,1795
E01002786,46,360,103,165,1131,1805
E01002787,79,252,121,141,1027,1620
E01002762,57,146,107,165,1474,1949
E01002767,84,299,149,173,1339,2044
E01033486,53,156,77,109,641,1036
E01033487,53,133,87,211,742,1226
E01033488,56,181,93,157,718,1205
E01033491,53,205,150,140,1132,1680
E01033492,21,142,84,165,936,1348
E01002777,40,156,100,77,1253,1626
E01002778,140,423,213,152,859,1787
E01002779,78,139,105,160,1409,1891
E01002781,63,297,88,77,825,1350
E01002782,78,454,128,129,744,1533
E01002739,43,102,93,99,1498,1835
E01002740,14,92,103,101,1516,1826
E01002745,37,93,97,69,1171,1467
E01002795,69,267,166,184,1311,1997
E01002796,28,63,52,83,813,1039
E01002716,107,346,215,181,1451,2300
E01002718,30,88,94,79,1370,1661
E01002721,43,130,113,67,1314,1667
E01002775,58,109,79,82,1101,1429
E01002776,61,228,128,108,1136,1661
E01002780,48,202,136,122,1132,1640
E01002708,62,217,111,285,1304,1979
E01002712,43,246,138,201,1152,1780
E01002713,42,258,96,85,1078,1559
E01002765,138,437,194,318,1426,2513
E01002766,75,354,115,238,1012,1794
E01002717,28,127,55,113,992,1315
E01002719,24,79,82,81,1224,1490
E01002720,127,451,201,202,1353,2334
E01002790,53,200,84,93,1005,1435
E01002791,30,77,75,73,1288,1543
E01002793,73,196,98,147,1391,1905
E01002698,45,169,133,133,1583,2063
E01002699,21,64,66,89,1267,1507
E01002700,19,35,42,84,1298,1478
E01002714,28,76,68,121,1405,1698
E01002792,33,126,147,115,1448,1869
E01002722,45,144,78,75,963,1305
E01002797,83,204,141,176,1269,1873
E01002798,55,107,93,94,1616,1965
E01002799,57,285,97,140,1260,1839
E01002800,61,193,46,115,634,1049
E01002694,64,265,117,236,850,1532
E01002697,117,346,122,512,1001,2098
E01002709,61,229,96,269,1099,1754
E01002710,71,302,76,250,977,1676
E01002715,84,302,86,204,835,1511
E01002696,15,87,95,113,1503,1813
E01002794,35,115,89,153,1373,1765
E01002801,28,106,62,90,1267,1553
E01002802,23,55,72,103,1227,1480
E01002803,59,119,119,238,1528,2063
E01002695,42,150,128,212,1178,1710
E01002711,73,200,147,291,1228,1939
E01002727,35,114,79,144,1252,1624
E01002728,61,186,94,349,945,1635
E01002729,24,132,83,89,1265,1593
E01002707,57,152,81,217,1219,1726
E01002723,60,194,61,177,1037,1529
E01002724,37,87,83,279,1487,1973
E01002725,63,176,73,194,938,1444
E01002726,43,185,95,169,1200,1692
E01033489,48,63,84,312,1325,1832
E01033490,61,142,77,403,1010,1693
E01002701,67,213,68,190,1044,1582
E01002702,79,317,107,306,1148,1957
E01002703,61,238,118,209,1009,1635
E01002704,83,333,150,197,1435,2198
E01002706,89,239,134,162,1392,2016
E01002852,279,482,127,229,791,1908
E01002853,184,259,65,70,515,1093
E01002854,145,269,78,93,536,1121
E01002855,267,417,158,121,765,1728
E01002857,213,332,110,146,548,1349
E01002904,149,275,115,101,533,1173
E01002905,151,269,115,140,893,1568
E01002906,136,215,130,124,1076,1681
E01002907,173,232,147,107,717,1376
E01002876,56,135,113,63,1365,1732
E01002877,249,317,120,163,861,1710
E01002878,107,185,121,116,1100,1629
E01002908,77,111,92,93,1018,1391
E01002909,91,175,156,143,1589,2154
E01002829,81,199,112,121,953,1466
E01002830,95,291,134,172,1081,1773
E01002831,146,300,151,132,1248,1977
E01002832,150,247,129,113,1062,1701
E01002856,94,252,183,80,1129,1738
E01002870,140,266,93,63,824,1386
E01002872,123,124,131,91,977,1446
E01002879,186,367,104,152,719,1528
E01002880,249,399,101,208,583,1540
E01002881,157,217,78,107,839,1398
E01002882,32,84,58,71,1089,1334
E01002883,118,61,72,139,1446,1836
E01002884,63,52,80,192,1016,1403
E01002885,67,55,99,155,1162,1538
E01002886,55,49,63,125,1256,1548
E01002833,34,55,80,110,1181,1460
E01002871,60,28,88,98,1411,1685
E01002873,69,71,67,80,1044,1331
E01002874,73,112,101,77,1076,1439
E01002875,44,42,98,85,1119,1388
E01002824,78,29,81,113,1218,1519
E01002825,135,83,113,211,1399,1941
E01002826,95,18,69,150,1219,1551
E01002827,44,21,90,169,1511,1835
E01002828,60,32,65,92,1083,1332
E01002864,198,35,66,189,1012,1500
E01002866,157,107,113,208,1159,1744
E01002867,326,139,114,274,1128,1981
E01002868,95,25,66,163,1303,1652
E01002869,139,72,126,122,1048,1507
E01002887,102,20,42,217,1020,1401
E01002889,94,28,53,167,937,1279
E01002890,76,20,76,204,1436,1812
E01002891,130,47,77,164,1028,1446
E01002892,135,51,111,287,1247,1831
E01002813,71,23,108,163,1402,1767
E01002815,173,15,91,228,917,1424
E01002816,74,11,58,185,1027,1355
E01002817,127,29,83,146,1209,1594
E01002865,150,15,70,154,994,1383
E01002818,201,49,93,234,1425,2002
E01002819,76,20,79,161,1250,1586
E01002859,90,11,68,114,1345,1628
E01002860,63,14,56,76,1293,1502
E01002863,84,18,51,131,1157,1441
E01002812,151,60,119,355,1232,1917
E01002834,87,34,68,201,1040,1430
E01002839,147,89,94,230,1008,1568
E01002850,132,60,80,335,844,1451
E01002888,149,44,77,458,1350,2078
E01002821,75,21,68,184,1077,1425
E01002823,95,75,86,131,982,1369
E01002858,135,111,84,174,750,1254
E01002861,72,28,63,91,1170,1424
E01002862,125,88,110,206,1014,1543
E01002814,385,110,128,373,960,1956
E01002847,90,54,78,229,1148,1599
E01002848,139,86,106,226,1015,1572
E01002851,197,145,84,310,906,1642
E01002820,79,18,65,150,939,1251
E01002822,42,3,46,102,1013,1206
E01002835,67,34,75,206,1173,1555
E01002836,47,22,79,162,1080,1390
E01002837,37,12,63,92,1155,1359
E01002846,107,73,86,184,865,1315
E01002849,103,48,84,189,1101,1525
E01002893,62,78,93,172,1370,1775
E01002894,65,46,59,158,1072,1400
E01002898,59,29,88,117,1316,1609
E01002899,68,57,64,90,1076,1355
E01002900,39,20,58,82,1231,1430
E01002901,37,11,29,65,1108,1250
E01002902,82,57,63,120,1382,1704
E01002903,36,15,45,77,1340,1513
E01002844,64,30,54,97,1125,1370
E01002845,68,70,51,118,1051,1358
E01002910,80,32,58,87,1131,1388
E01002911,68,26,71,65,1421,1651
E01002914,45,17,39,116,1347,1564
E01002838,45,19,44,262,1261,1631
E01002895,29,22,31,63,1250,1395
E01002896,60,17,90,134,1451,1752
E01002897,95,30,49,94,1046,1314
E01002912,64,59,72,125,1370,1690
E01002840,127,105,108,146,897,1383
E01002841,70,92,91,100,1015,1368
E01002842,203,137,96,243,574,1253
E01002843,110,172,107,133,710,1232
E01002913,129,101,95,207,1362,1894
E01003015,65,485,153,112,779,1594
E01003108,37,497,147,96,778,1555
E01003110,27,282,114,112,1338,1873
E01003111,50,645,100,138,597,1530
E01003112,55,456,95,140,756,1502
E01003101,42,391,127,95,913,1568
E01003105,57,537,129,138,812,1673
E01003106,47,439,128,88,1260,1962
E01003107,35,299,134,110,1334,1912
E01003109,94,585,184,190,1202,2255
E01003102,51,233,103,153,1198,1738
E01003104,59,283,108,118,1040,1608
E01003122,74,418,107,134,1080,1813
E01003129,48,370,119,131,1171,1839
E01033207,45,405,110,90,1058,1708
E01033208,99,236,118,279,991,1723
E01003098,29,396,82,79,972,1558
E01003099,48,375,131,109,927,1590
E01003100,66,154,133,85,1504,1942
E01003180,48,470,139,71,778,1506
E01003183,34,537,118,107,702,1498
E01003097,56,443,105,140,927,1671
E01003121,36,720,162,67,639,1624
E01003123,19,187,94,60,1129,1489
E01003124,44,329,100,92,879,1444
E01003125,95,709,133,137,688,1762
E01003181,57,422,132,103,758,1472
E01003184,49,731,126,78,430,1414
E01003185,76,385,129,78,987,1655
E01003186,44,404,139,112,1249,1948
E01003187,44,792,124,89,438,1487
E01003089,90,701,134,160,789,1874
E01003091,38,427,144,149,909,1667
E01003092,49,604,120,133,881,1787
E01003126,47,516,97,75,797,1532
E01003128,44,546,122,61,728,1501
E01003046,46,957,144,45,549,1741
E01003048,73,1001,142,57,491,1764
E01003075,76,783,135,101,538,1633
E01003182,50,622,164,94,892,1822
E01003188,41,646,110,85,459,1341
E01003088,37,533,162,96,989,1817
E01003093,92,1015,241,141,882,2371
E01003094,25,378,107,85,944,1539
E01003096,35,315,130,107,1484,2071
E01003127,41,417,132,65,1118,1773
E01003045,100,1046,223,94,508,1971
E01003047,51,566,121,137,752,1627
E01003049,61,753,146,91,644,1695
E01003059,67,649,112,124,682,1634
E01003060,54,717,96,119,572,1558
E01003061,64,322,131,75,654,1246
E01003034,25,309,113,81,1223,1751
E01003035,31,220,89,64,1153,1557
E01003036,24,319,90,77,1098,1608
E01003090,42,362,155,150,1570,2279
E01003095,25,288,120,75,1330,1838
E01003037,33,402,110,66,776,1387
E01003038,5,99,81,63,1258,1506
E01003039,33,123,115,112,1659,2042
E01003040,19,195,59,59,956,1288
E01003042,16,162,69,43,753,1043
E01003072,26,182,118,70,1452,1848
E01003073,55,587,156,44,855,1697
E01003076,97,397,145,205,1071,1915
E01003077,63,446,149,132,1002,1792
E01003078,31,160,111,117,1161,1580
E01003019,41,396,142,77,1434,2090
E01003053,27,270,100,86,1245,1728
E01003054,23,185,95,66,1463,1832
E01003056,28,429,128,98,1252,1935
E01003058,35,389,126,82,1299,1931
E01003020,36,469,131,86,1053,1775
E01003050,23,413,139,82,993,1650
E01003052,42,975,155,125,524,1821
E01003055,27,328,107,88,940,1490
E01003176,46,758,198,94,810,1906
E01003029,21,250,100,75,1362,1808
E01003032,37,439,103,106,1062,1747
E01003041,43,460,128,100,882,1613
E01003057,40,586,116,84,852,1678
E01003043,20,445,144,59,966,1634
E01003044,28,788,93,36,293,1238
E01003051,54,700,146,108,635,1643
E01003071,24,374,186,119,1575,2278
E01003074,56,550,220,63,1475,2364
E01003026,13,110,47,77,1237,1484
E01003027,3,46,53,58,1213,1373
E01003028,9,164,81,67,1148,1469
E01003030,12,94,108,85,1496,1795
E01003033,33,183,72,84,1146,1518
E01003018,32,303,165,82,1497,2079
E01003171,36,504,134,70,1001,1745
E01003173,38,352,151,81,988,1610
E01003177,30,467,140,89,922,1648
E01003178,17,303,144,55,1086,1605
E01003021,44,565,149,93,1052,1903
E01003022,38,377,131,86,1114,1746
E01003023,54,522,213,142,1449,2380
E01003024,63,812,168,103,652,1798
E01003025,48,676,190,135,1022,2071
E01003136,28,397,139,70,949,1583
E01003137,67,470,164,112,662,1475
E01003159,69,486,108,68,742,1473
E01003160,72,679,126,76,509,1462
E01003162,119,1003,169,102,733,2126
E01003031,27,326,128,110,1067,1658
E01003156,10,250,88,72,1135,1555
E01003157,14,212,81,112,1130,1549
E01003158,12,86,66,32,1400,1596
E01003161,39,214,66,100,831,1250
E01003163,51,246,88,159,971,1515
E01003132,56,592,118,59,697,1522
E01003172,44,734,214,84,873,1949
E01003174,68,1063,171,101,642,2045
E01003175,58,747,109,97,599,1610
E01003179,82,798,155,71,547,1653
E01003164,54,516,238,121,1191,2120
E01003165,26,318,104,148,1014,1610
E01003168,26,469,142,44,903,1584
E01003169,44,615,254,108,1434,2455
E01003170,10,184,101,124,1440,1859
E01003130,52,283,135,162,1108,1740
E01003131,27,211,68,92,1049,1447
E01003135,36,387,132,102,1027,1684
E01003138,19,125,62,74,1257,1537
E01003151,56,752,183,180,790,1961
E01003079,37,591,177,134,858,1797
E01003080,30,353,135,96,989,1603
E01003133,41,290,182,64,1142,1719
E01003134,36,333,117,101,969,1556
E01003152,58,433,151,166,1137,1945
E01003064,17,235,131,63,1090,1536
E01003066,33,583,152,76,844,1688
E01003081,34,555,156,133,905,1783
E01003166,79,498,176,158,1379,2290
E01003167,21,173,102,101,1326,1723
E01003116,10,273,77,286,952,1598
E01003117,52,303,184,184,1203,1926
E01003118,23,166,123,270,1153,1735
E01003153,60,296,112,185,1413,2066
E01003155,46,293,152,196,1109,1796
E01003083,20,365,110,121,892,1508
E01003084,19,328,178,87,999,1611
E01003085,41,364,159,107,1063,1734
E01003149,28,299,168,214,1082,1791
E01003154,35,604,140,136,924,1839
E01003065,28,606,143,69,626,1472
E01003068,42,475,181,64,830,1592
E01003082,38,500,144,66,704,1452
E01003086,29,719,155,71,637,1611
E01003087,48,698,148,102,668,1664
E01003113,32,442,194,163,1157,1988
E01003114,38,376,119,174,1110,1817
E01003119,40,286,131,177,1251,1885
E01003120,49,465,133,153,1183,1983
E01003148,35,437,123,94,1103,1792
E01003150,33,499,157,109,918,1716
E01003062,31,308,147,74,1108,1668
E01003063,39,511,128,66,688,1432
E01003067,18,314,112,67,960,1471
E01003069,17,378,118,51,797,1361
E01003070,35,605,165,73,614,1492
E01003115,35,480,115,114,874,1618
E01003141,24,531,150,213,797,1715
E01003144,32,271,99,173,994,1569
E01003145,29,331,141,216,982,1699
E01003147,67,466,148,248,1061,1990
E01003139,23,396,120,324,701,1564
E01003140,27,479,94,329,560,1489
E01003142,44,331,111,336,537,1359
E01003143,17,520,83,303,511,1434
E01003146,20,542,109,181,665,1517
E01003013,49,84,83,580,843,1639
E01003014,42,207,91,134,1060,1534
E01003016,44,153,89,379,687,1352
E01003017,18,237,108,165,1135,1663
E01032582,55,335,111,288,1104,1893
E01003244,40,812,115,197,465,1629
E01003245,46,591,135,213,574,1559
E01003247,51,222,102,293,1005,1673
E01003249,60,552,143,229,944,1928
E01003250,25,604,101,272,753,1755
E01003246,35,569,99,215,521,1439
E01003248,54,579,103,253,633,1622
E01003251,76,837,150,341,599,2003
E01003252,59,704,94,338,362,1557
E01003253,25,489,78,217,629,1438
E01003297,34,630,141,122,611,1538
E01003299,79,516,121,124,783,1623
E01003301,66,661,147,336,956,2166
E01003302,36,673,102,205,493,1509
E01003305,39,483,87,104,659,1372
E01003207,40,524,85,154,596,1399
E01003209,87,654,202,139,925,2007
E01003210,21,369,110,133,1113,1746
E01003212,55,547,150,108,1116,1976
E01003215,59,380,159,300,1052,1950
E01003338,66,785,119,234,580,1784
E01003339,107,508,133,109,903,1760
E01003340,83,266,124,110,1323,1906
E01003341,41,210,131,79,1047,1508
E01003343,37,290,114,101,814,1356
E01003199,19,139,94,148,1328,1728
E01003201,43,343,148,99,1031,1664
E01003204,33,255,87,97,919,1391
E01003205,38,561,107,148,478,1332
E01003206,61,152,101,102,1166,1582
E01003211,26,306,123,74,1037,1566
E01003213,25,365,135,139,1274,1938
E01003214,38,561,152,100,921,1772
E01033324,53,358,101,125,960,1597
E01033325,28,47,46,315,769,1205
E01003198,16,198,75,55,1117,1461
E01003200,34,34,60,106,1319,1553
E01003202,10,49,62,118,1320,1559
E01003203,38,353,99,160,1119,1769
E01003336,34,691,123,95,435,1378
E01003337,31,846,173,108,478,1636
E01003342,67,428,140,120,886,1641
E01003344,86,443,126,150,926,1731
E01003345,83,451,116,154,910,1714
E01003273,38,428,265,374,895,2000
E01003277,25,433,138,72,1046,1714
E01003278,65,559,141,201,921,1887
E01003279,25,307,102,132,1027,1593
E01003288,48,512,127,263,860,1810
E01003290,50,574,146,138,822,1730
E01003291,39,572,142,138,621,1512
E01003296,51,466,120,413,996,2046
E01033327,67,339,97,214,810,1527
E01033341,75,374,125,194,535,1303
E01003282,132,438,195,245,1408,2418
E01003283,19,173,100,89,1727,2108
E01003284,36,352,115,121,1133,1757
E01003286,20,382,95,149,987,1633
E01003272,78,349,139,152,1248,1966
E01003274,36,398,156,166,968,1724
E01003275,61,551,113,207,795,1727
E01003276,59,445,201,168,1031,1904
E01003225,35,295,98,111,968,1507
E01003231,48,444,150,117,847,1606
E01003232,85,338,139,156,1001,1719
E01003233,25,386,122,187,982,1702
E01003280,26,419,91,246,824,1606
E01003281,17,237,91,156,1033,1534
E01003285,25,200,72,218,1093,1608
E01003287,19,190,97,143,1460,1909
E01003292,32,408,96,189,840,1565
E01003293,17,505,131,156,709,1518
E01003295,60,536,107,132,837,1672
E01033320,44,457,111,152,732,1496
E01033322,17,298,92,172,688,1267
E01003319,118,673,151,218,671,1831
E01003320,35,640,151,96,572,1494
E01003323,52,575,96,143,619,1485
E01003325,82,700,160,143,644,1729
E01003226,21,284,131,153,1153,1742
E01003227,35,271,123,94,1135,1658
E01003228,22,231,111,61,1087,1512
E01003229,41,449,109,109,850,1558
E01003230,24,611,189,106,1003,1933
E01003317,32,574,251,144,881,1882
E01003318,35,612,114,213,664,1638
E01003321,30,716,214,119,882,1961
E01003322,39,487,119,145,639,1429
E01003324,30,660,88,158,531,1467
E01003254,23,166,80,86,1082,1437
E01003255,42,307,130,161,1246,1886
E01003260,39,358,162,174,1091,1824
E01003261,16,297,101,92,989,1495
E01003262,21,273,104,105,862,1365
E01003217,46,619,140,194,671,1670
E01003218,47,527,94,127,703,1498
E01003220,74,506,127,112,735,1554
E01003222,19,644,123,139,707,1632
E01003224,44,601,138,147,731,1661
E01003263,63,337,105,138,1032,1675
E01003268,69,324,89,157,1031,1670
E01003269,37,264,104,166,983,1554
E01003270,46,289,113,160,1030,1638
E01003271,54,189,89,167,1168,1667
E01003307,19,405,115,109,873,1521
E01003308,50,445,221,96,1012,1824
E01003314,36,387,124,95,957,1599
E01003315,22,299,88,125,753,1287
E01003316,20,286,110,124,942,1482
E01003216,63,631,160,191,830,1875
E01003219,49,620,110,189,679,1647
E01003221,28,666,213,220,835,1962
E01003223,43,557,124,213,778,1715
E01003346,22,479,96,140,800,1537
E01003349,47,345,98,89,833,1412
E01003351,30,424,101,72,836,1463
E01003354,46,664,93,176,696,1675
E01003309,30,471,115,104,790,1510
E01003310,44,420,116,109,870,1559
E01003311,27,328,120,119,952,1546
E01003312,63,354,140,112,1091,1760
E01003313,34,504,117,131,744,1530
E01003256,50,476,178,166,1185,2055
E01003257,16,388,126,94,1054,1678
E01003258,42,617,116,130,594,1499
E01003259,25,309,116,92,1073,1615
E01003193,15,494,97,72,890,1568
E01003194,58,587,122,114,797,1678
E01003195,27,599,110,114,697,1547
E01003196,73,514,114,116,856,1673
E01003197,24,528,114,157,805,1628
E01003347,60,688,153,179,655,1735
E01003348,19,369,124,181,766,1459
E01003350,59,443,108,133,669,1412
E01003352,32,573,129,196,886,1816
E01003353,47,439,98,242,914,1740
E01003264,68,324,92,102,1024,1610
E01003265,41,463,109,74,844,1531
E01003266,46,493,81,88,1027,1735
E01003267,36,317,93,103,1019,1568
E01003329,28,336,141,96,989,1590
E01003330,26,471,121,100,832,1550
E01003331,27,395,112,93,785,1412
E01003332,29,390,122,93,833,1467
E01003334,37,416,118,146,943,1660
E01003189,53,518,102,120,877,1670
E01003190,65,742,214,145,712,1878
E01003191,30,518,140,63,743,1494
E01003192,14,578,101,129,817,1639
E01003326,20,362,130,78,885,1475
E01003327,15,282,183,193,1123,1796
E01003328,47,363,112,122,1074,1718
E01003333,27,361,153,98,903,1542
E01003335,30,432,122,91,720,1395
E01003236,96,339,123,82,950,1590
E01003237,26,283,108,140,914,1471
E01003238,20,371,100,78,838,1407
E01003239,56,420,112,81,759,1428
E01032564,54,281,87,105,785,1312
E01003235,39,263,105,64,808,1279
E01003240,32,426,135,116,1080,1789
E01003241,39,464,103,166,769,1541
E01003243,23,361,74,146,754,1358
E01032565,110,273,81,86,842,1392
E01003298,27,596,83,215,371,1292
E01003300,30,633,90,177,426,1356
E01003303,40,546,88,281,595,1550
E01003304,68,573,142,311,796,1890
E01032579,38,459,96,215,652,1460
E01003543,123,493,144,763,952,2475
E01003544,64,576,135,500,663,1938
E01003546,78,670,69,734,389,1940
E01003550,69,446,95,636,534,1780
E01003576,61,493,82,949,369,1954
E01003581,67,326,61,1139,255,1848
E01003582,56,321,96,820,320,1613
E01003583,57,333,75,1108,393,1966
E01003578,71,361,68,1049,395,1944
E01003584,48,315,111,1006,593,2073
E01003586,46,236,66,1106,297,1751
E01003590,34,371,95,618,468,1586
E01003579,40,250,41,1275,244,1850
E01003585,62,191,20,1221,155,1649
E01003587,82,441,81,1347,485,2436
E01003591,83,405,99,1197,382,2166
E01003528,90,296,35,796,169,1386
E01003575,56,305,85,994,262,1702
E01003577,96,604,116,716,388,1920
E01003580,83,443,110,836,364,1836
E01003545,38,545,89,485,570,1727
E01003548,117,514,116,600,1006,2353
E01003549,82,492,105,605,821,2105
E01003557,79,439,74,894,545,2031
E01003547,59,324,131,518,907,1939
E01003555,55,198,59,1148,382,1842
E01003561,34,206,48,1438,154,1880
E01003567,42,273,52,1249,206,1822
E01003556,57,422,69,835,530,1913
E01003558,30,292,48,946,315,1631
E01003570,76,230,81,1401,277,2065
E01003571,46,232,68,1760,171,2277
E01003572,53,228,50,1247,201,1779
E01003551,102,408,109,624,590,1833
E01003553,64,487,125,567,684,1927
E01003554,86,311,88,542,834,1861
E01003559,124,474,156,650,1201,2605
E01003529,45,160,33,1999,142,2379
E01003530,59,91,43,1495,139,1827
E01003531,53,128,51,1557,208,1997
E01003532,59,141,26,1616,160,2002
E01003534,51,241,50,1808,245,2395
E01003533,53,185,38,1386,218,1880
E01003560,44,182,40,1407,169,1842
E01003563,65,235,31,1429,276,2036
E01003588,40,180,41,1385,140,1786
E01003589,60,183,63,1252,313,1871
E01003616,74,424,93,431,628,1650
E01003617,99,617,138,790,1125,2769
E01003618,106,321,115,610,1041,2193
E01003619,72,534,137,625,896,2264
E01003615,57,445,116,516,701,1835
E01033578,57,284,66,354,512,1273
E01033579,70,183,68,439,533,1293
E01033583,128,637,161,923,1232,3081
E01033586,56,344,90,347,573,1410
E01003562,37,206,38,1720,199,2200
E01003564,53,216,72,1864,255,2460
E01003565,24,139,53,1477,160,1853
E01003566,58,194,47,1306,187,1792
E01003625,76,159,87,1060,315,1697
E01003626,51,86,37,1215,201,1590
E01003627,41,137,28,1187,210,1603
E01003628,59,96,30,1218,262,1665
E01003629,75,86,31,1269,211,1672
E01003552,94,383,59,739,444,1719
E01003596,52,312,75,841,497,1777
E01003597,88,259,46,936,310,1639
E01003635,64,320,105,608,848,1945
E01003568,70,203,30,1774,225,2302
E01003569,22,178,57,1493,149,1899
E01003573,52,232,32,1647,191,2154
E01003574,61,361,63,1752,400,2637
E01003520,74,143,21,1501,262,2001
E01003521,48,110,68,1631,402,2259
E01003522,70,160,43,1376,259,1908
E01003525,76,214,56,1378,254,1978
E01003526,67,252,55,1223,330,1927
E01003488,118,496,92,801,367,1874
E01003489,67,317,79,1025,319,1807
E01003490,83,267,45,1180,282,1857
E01003524,75,228,84,1331,310,2028
E01003631,119,438,131,461,683,1832
E01003632,73,466,213,722,794,2268
E01003633,79,720,116,464,492,1871
E01003634,51,499,105,587,563,1805
E01003636,80,593,134,513,658,1978
E01003598,62,639,139,596,461,1897
E01003600,51,490,106,671,575,1893
E01003630,61,601,142,588,619,2011
E01003637,42,401,80,614,704,1841
E01003491,56,210,52,1424,235,1977
E01003592,85,329,78,885,465,1842
E01003599,37,275,66,869,364,1611
E01003606,96,441,91,950,574,2152
E01003535,64,475,80,506,566,1691
E01003536,58,422,112,679,572,1843
E01003621,120,166,82,1017,282,1667
E01003622,53,315,37,904,304,1613
E01003623,53,349,67,889,399,1757
E01003523,82,315,58,1112,476,2043
E01003527,72,250,102,761,588,1773
E01003537,81,287,98,886,710,2062
E01003542,96,462,121,718,577,1974
E01003624,68,308,70,683,453,1582
E01003492,57,275,91,1206,381,2010
E01003493,105,319,69,1290,516,2299
E01003494,96,276,107,968,601,2048
E01003495,80,318,98,817,797,2110
E01003594,98,389,78,674,490,1729
E01003595,51,372,93,528,488,1532
E01003602,52,511,79,708,635,1985
E01003607,68,381,100,549,550,1648
E01003496,59,480,92,347,467,1445
E01003498,49,486,99,372,735,1741
E01003500,44,628,121,331,919,2043
E01003593,34,461,114,474,467,1550
E01003601,55,549,115,627,784,2130
E01003603,85,405,76,708,673,1947
E01003605,71,489,52,993,507,2112
E01003608,103,408,123,629,809,2072
E01003538,72,541,130,755,586,2084
E01003539,114,474,125,824,680,2217
E01003540,46,467,96,542,682,1833
E01003541,66,396,121,638,650,1871
E01003499,73,637,132,540,898,2280
E01003501,47,551,123,530,789,2040
E01003502,37,620,73,399,707,1836
E01003503,30,654,108,320,598,1710
E01003507,61,549,117,458,928,2113
E01003508,56,418,72,390,669,1605
E01003509,83,411,94,222,1143,1953
E01003604,85,637,127,672,837,2358
E01003483,34,340,74,514,524,1486
E01003484,63,294,79,411,774,1621
E01003516,66,636,123,273,761,1859
E01003518,42,356,86,329,782,1595
E01003519,60,491,58,356,615,1580
E01003480,80,374,102,531,1085,2172
E01003482,94,571,145,724,1100,2634
E01003486,19,387,75,318,406,1205
E01003487,30,316,65,437,523,1371
E01003497,63,389,100,233,930,1715
E01003506,49,451,106,216,658,1480
E01033574,82,110,58,387,458,1095
E01033575,73,74,50,374,450,1021
E01033576,66,205,95,321,608,1295
E01033584,60,491,78,235,731,1595
E01033585,69,657,147,486,1086,2445
E01003479,37,288,64,229,887,1505
E01003481,42,314,64,295,859,1574
E01003485,49,265,69,407,783,1573
E01003513,36,317,118,307,810,1588
E01003511,49,531,82,186,546,1394
E01003512,64,505,89,228,919,1805
E01003514,43,388,88,169,824,1512
E01003515,47,601,123,250,777,1798
E01003517,61,535,86,246,746,1674
E01003609,86,668,143,576,1229,2702
E01003611,46,797,160,252,548,1803
E01033577,58,272,94,301,764,1489
E01033580,63,131,63,457,808,1522
E01033581,40,568,88,251,835,1782
E01033582,72,161,83,346,719,1381
E01004029,69,143,100,402,1121,1835
E01004032,52,61,82,456,1044,1695
E01004053,58,53,115,279,1331,1836
E01004054,42,73,71,266,1204,1656
E01004055,16,206,53,77,939,1291
E01003927,44,283,129,231,1690,2377
E01003929,58,276,109,192,1476,2111
E01003934,20,203,100,168,931,1422
E01003935,35,144,78,355,730,1342
E01003939,52,315,99,376,1008,1850
E01003976,73,407,123,186,1166,1955
E01004027,93,391,137,194,1257,2072
E01032637,21,32,50,189,955,1247
E01032638,25,11,31,106,986,1159
E01032640,33,42,50,140,983,1248
E01032646,61,176,77,162,1093,1569
E01032803,49,111,83,173,915,1331
E01032834,30,38,39,109,914,1130
E01003975,71,480,130,104,845,1630
E01003978,70,313,102,217,1138,1840
E01004022,77,372,152,263,1619,2483
E01004023,49,245,84,135,1027,1540
E01004028,41,401,93,135,981,1651
E01003938,59,528,100,246,881,1814
E01003940,59,548,104,185,587,1483
E01003941,66,323,73,238,1197,1897
E01003942,74,452,137,277,697,1637
E01003979,55,366,96,211,1056,1784
E01003981,57,307,88,290,933,1675
E01004030,39,191,73,131,1023,1457
E01004031,95,323,114,354,1174,2060
E01004033,40,375,67,172,865,1519
E01004034,64,330,66,112,969,1541
E01004036,69,593,119,239,994,2014
E01004056,62,201,91,241,1470,2065
E01004057,22,183,77,187,1031,1500
E01004058,31,52,61,294,1261,1699
E01004059,24,47,55,401,960,1487
E01004060,62,398,123,231,1087,1901
E01003936,38,96,91,365,1255,1845
E01003937,49,235,103,307,859,1553
E01003943,56,464,97,284,466,1367
E01032720,151,522,84,328,647,1732
E01003977,65,330,127,84,1066,1672
E01004037,104,490,106,144,1109,1953
E01004038,109,596,175,263,1197,2340
E01004042,41,299,75,93,1204,1712
E01004043,18,144,58,58,1088,1366
E01003986,43,347,71,110,664,1235
E01003987,46,479,72,136,1044,1777
E01004024,85,410,68,121,1176,1860
E01004035,61,420,90,119,932,1622
E01003960,54,364,131,201,1113,1863
E01003961,111,749,117,151,917,2045
E01003994,61,377,127,142,786,1493
E01032722,54,529,134,205,1211,2133
E01003980,55,405,104,194,1148,1906
E01004039,89,305,113,247,814,1568
E01004040,76,834,125,108,637,1780
E01004041,102,470,101,141,846,1660
E01004044,61,419,60,147,714,1401
E01003992,68,582,105,90,647,1492
E01003995,44,409,86,67,778,1384
E01003998,42,201,80,68,940,1331
E01003999,52,369,118,118,785,1442
E01032639,53,263,80,254,993,1643
E01032719,74,312,69,184,572,1211
E01003964,111,609,155,171,881,1927
E01003966,102,625,159,204,851,1941
E01003968,61,724,119,170,367,1441
E01003971,83,934,134,147,511,1809
E01003974,51,575,64,155,423,1268
E01003963,73,647,82,253,593,1648
E01003967,106,786,76,166,539,1673
E01003970,39,662,76,155,554,1486
E01003972,52,625,96,150,731,1654
E01003973,53,494,107,134,862,1650
E01003923,63,521,118,133,900,1735
E01003969,108,373,153,159,1065,1858
E01003991,42,365,49,128,624,1208
E01003993,85,844,116,123,545,1713
E01003997,53,332,95,91,648,1219
E01003983,85,1097,150,128,562,2022
E01003988,131,971,163,145,783,2193
E01003989,115,1035,121,117,572,1960
E01003990,101,1080,144,163,644,2132
E01004007,57,724,80,101,299,1261
E01003912,67,941,140,88,359,1595
E01004011,69,1294,157,190,402,2112
E01004012,93,1182,197,203,827,2502
E01004013,69,836,117,202,432,1656
E01004014,59,1006,118,110,491,1784
E01003911,99,821,133,195,737,1985
E01003916,117,697,165,162,1049,2190
E01003917,72,549,82,150,922,1775
E01003918,59,767,92,140,544,1602
E01003925,55,547,97,79,558,1336
E01003919,59,527,168,142,880,1776
E01003920,78,950,92,156,578,1854
E01003921,86,553,81,132,609,1461
E01003922,68,848,98,153,750,1917
E01003924,127,1006,124,155,516,1928
E01003926,53,655,82,125,508,1423
E01004008,82,1115,139,225,580,2141
E01004010,121,682,113,126,484,1526
E01004067,85,1041,120,270,649,2165
E01032805,106,1037,180,235,993,2551
E01003984,74,757,153,149,864,1997
E01004003,76,796,123,108,599,1702
E01004004,62,923,184,163,1167,2499
E01004005,83,1092,165,159,724,2223
E01004006,47,722,136,116,947,1968
E01003913,58,342,95,145,1207,1847
E01003914,42,425,119,129,1127,1842
E01003915,77,857,99,151,756,1940
E01004050,59,177,81,58,1100,1475
E01004052,48,276,94,132,1216,1766
E01004061,48,356,116,115,1115,1750
E01004062,36,620,126,240,963,1985
E01004063,42,520,121,93,1183,1959
E01004065,34,320,94,57,1020,1525
E01004066,67,748,166,157,1021,2159
E01004000,45,718,189,94,835,1881
E01004001,61,730,112,95,740,1738
E01004019,35,863,193,138,1090,2319
E01004064,69,736,147,125,898,1975
E01004068,38,903,118,169,819,2047
E01004045,39,828,123,103,425,1518
E01004047,96,631,128,168,572,1595
E01004048,33,342,112,135,965,1587
E01004049,59,568,111,248,686,1672
E01004051,17,153,73,103,1037,1383
E01003953,44,313,133,151,1441,2082
E01003955,39,294,133,109,1242,1817
E01004015,24,245,93,73,1123,1558
E01004021,37,288,106,86,1592,2109
E01004046,41,318,128,86,1060,1633
E01004002,28,334,120,80,1047,1609
E01004016,36,537,141,115,1520,2349
E01004017,19,214,88,53,1174,1548
E01004020,32,769,120,109,700,1730
E01003952,21,229,79,100,1211,1640
E01003954,24,250,109,75,1140,1598
E01003956,11,269,115,56,1234,1685
E01004071,20,265,86,93,1115,1579
E01004072,15,113,104,99,1407,1738
E01004069,15,39,91,140,1152,1437
E01004070,20,187,123,96,1559,1985
E01004073,16,161,85,99,1570,1931
E01004074,20,110,130,115,1508,1883
E01004075,16,46,97,96,1594,1849
E01003949,30,235,115,128,1362,1870
E01003950,44,642,122,110,988,1906
E01003957,28,231,106,91,1332,1788
E01003958,26,259,77,98,1251,1711
E01004018,39,221,102,69,1474,1905
E01003945,32,241,81,157,1152,1663
E01003946,27,337,116,163,1125,1768
E01003947,63,620,130,57,647,1517
E01003948,22,240,95,94,1115,1566
E01003951,11,131,81,205,1094,1522
E01003930,74,225,86,210,901,1496
E01003932,31,477,100,235,730,1573
E01003933,50,260,101,340,1000,1751
E01032583,51,213,69,200,1054,1587
E01032584,28,305,88,170,691,1282
E01004222,56,322,131,624,1347,2480
E01004223,33,279,104,424,1239,2079
E01004224,35,196,115,548,1106,2000
E01004226,30,198,76,547,887,1738
E01004197,68,189,140,756,1176,2329
E01004198,24,118,72,642,673,1529
E01004199,27,126,46,894,544,1637
E01004201,56,120,63,400,917,1556
E01004228,34,82,102,214,1425,1857
E01004230,34,200,89,563,1215,2101
E01004232,16,62,73,362,1152,1665
E01004233,37,180,62,660,882,1821
E01004234,20,151,129,265,1653,2218
E01004225,31,93,120,289,1645,2178
E01004229,31,112,65,586,690,1484
E01004231,44,150,112,836,651,1793
E01032764,42,95,72,250,843,1302
E01032765,38,144,115,325,866,1488
E01032784,29,87,75,369,956,1516
E01004200,35,60,86,402,983,1566
E01004202,45,99,82,596,883,1705
E01004203,52,65,94,534,1034,1779
E01004204,46,141,44,641,710,1582
E01004311,20,115,51,541,791,1518
E01004314,13,21,70,146,850,1100
E01004315,33,102,83,480,930,1628
E01004318,61,208,78,471,641,1459
E01004259,46,85,97,445,1050,1723
E01004260,64,128,73,766,759,1790
E01004263,46,98,46,526,703,1419
E01004266,23,77,67,391,987,1545
E01004235,38,178,54,794,308,1372
E01004236,29,190,54,1051,355,1679
E01004237,49,137,70,425,477,1158
E01004238,82,312,101,1500,738,2733
E01004239,27,226,67,800,529,1649
E01004312,37,147,62,767,601,1614
E01004313,60,153,80,805,945,2043
E01004316,24,55,38,484,537,1138
E01004317,48,112,135,823,1588,2706
E01004261,67,162,78,1188,1030,2525
E01004262,38,90,52,776,786,1742
E01004264,26,107,50,1060,294,1537
E01032785,23,143,111,265,806,1348
E01032786,35,103,50,584,789,1561
E01004207,25,99,74,643,575,1416
E01004209,19,106,33,850,358,1366
E01004212,48,129,54,766,783,1780
E01032787,32,199,82,1567,687,2567
E01004240,42,186,76,911,600,1815
E01004241,23,194,70,830,504,1621
E01004242,62,308,75,1234,774,2453
E01004267,44,202,74,593,854,1767
E01004268,54,213,66,902,549,1784
E01004205,35,154,42,1452,423,2106
E01004206,37,125,53,876,401,1492
E01004208,47,70,97,806,956,1976
E01004211,37,78,77,400,871,1463
E01004269,46,193,68,888,780,1975
E01004270,46,161,70,759,1200,2236
E01004271,15,193,55,907,419,1589
E01004272,23,201,80,1406,389,2099
E01004273,33,222,63,1234,352,1904
E01004306,42,69,60,808,820,1799
E01004307,68,65,80,492,1481,2186
E01004308,23,42,49,805,559,1478
E01004309,65,201,90,1471,1025,2852
E01004310,28,83,50,1039,771,1971
E01004283,48,121,71,1192,885,2317
E01004287,86,132,85,1129,739,2171
E01004289,66,121,64,866,727,1844
E01004290,42,64,69,373,754,1302
E01004322,50,87,47,605,503,1292
E01004323,38,39,43,761,585,1466
E01004324,25,69,41,1023,416,1574
E01004326,57,85,57,643,602,1444
E01004245,35,194,60,912,338,1539
E01004246,42,150,82,729,974,1977
E01004248,22,183,71,677,391,1344
E01004249,53,302,89,906,699,2049
E01004284,46,192,96,1206,762,2302
E01004285,28,158,84,1591,457,2318
E01004286,27,143,93,1262,839,2364
E01004288,13,123,60,937,487,1620
E01004243,40,200,73,860,616,1789
E01004244,34,251,59,817,724,1885
E01004247,43,187,71,881,752,1934
E01004250,42,267,93,1033,907,2342
E01004319,24,89,44,1335,394,1886
E01004321,38,96,32,1165,491,1822
E01004325,54,73,104,978,1278,2487
E01032766,56,85,56,504,606,1307
E01032767,83,34,47,376,1044,1584
E01004298,32,136,58,927,484,1637
E01004300,27,118,44,709,451,1349
E01004304,75,122,44,1248,468,1957
E01004305,60,133,54,1019,686,1952
E01004251,41,145,89,1054,753,2082
E01004254,62,79,53,525,1401,2120
E01004255,34,153,52,858,521,1618
E01004258,16,81,79,381,949,1506
E01004252,57,276,113,1210,1051,2707
E01004253,46,254,112,967,961,2340
E01004256,41,107,46,899,636,1729
E01004257,16,199,84,959,626,1884
E01004301,17,72,28,872,335,1324
E01004302,43,152,47,1385,360,1987
E01004303,27,253,100,922,1060,2362
E01032768,28,61,56,291,871,1307
E01032769,9,40,61,468,657,1235
E01004292,40,28,86,334,1250,1738
E01004294,34,73,87,514,1049,1757
E01004295,26,103,41,1026,320,1516
E01004296,26,70,67,720,722,1605
E01004291,44,35,59,309,1397,1844
E01004293,35,41,69,360,1620,2125
E01004297,31,51,66,290,1388,1826
E01004215,71,242,138,1009,1296,2756
E01004219,58,283,79,1233,641,2294
E01004221,29,114,68,583,1087,1881
E01032776,49,61,49,404,513,1076
E01032777,47,128,60,449,457,1141
E01032778,47,72,71,457,461,1108
E01032779,49,94,63,345,538,1089
E01032780,20,38,50,482,743,1333
E01004214,23,171,94,666,715,1669
E01004216,36,52,71,492,968,1619
E01004217,12,68,62,514,1089,1745
E01004218,62,67,89,397,1135,1750
E01004274,49,141,83,1004,696,1973
E01004275,27,72,88,410,1282,1879
E01004276,45,41,70,447,1421,2024
E01004281,36,44,70,581,1039,1770
E01032775,26,30,42,358,652,1108
E01032783,29,117,49,465,723,1383
E01004280,69,167,75,712,856,1879
E01032770,44,73,84,456,534,1191
E01032772,46,44,31,468,546,1135
E01032773,53,138,64,632,674,1561
E01032774,38,124,95,427,614,1298
E01004277,49,24,71,491,995,1630
E01032771,50,70,52,467,465,1104
E01032781,46,50,44,483,912,1535
E01032782,72,166,90,607,679,1614
E01004560,50,189,67,114,1534,1954
E01004566,39,55,59,59,1355,1567
E01004582,89,139,125,157,1637,2147
E01004583,64,141,83,113,1405,1806
E01004562,68,503,134,186,873,1764
E01004563,62,526,165,209,999,1961
E01004564,39,222,93,52,1362,1768
E01004567,97,790,157,291,1008,2343
E01033098,95,33,68,140,676,1012
E01033100,50,241,91,112,749,1243
E01033132,90,155,90,101,604,1040
E01004539,76,695,176,210,941,2098
E01004540,49,345,121,113,1455,2083
E01004577,32,171,80,86,1588,1957
E01004584,28,652,154,122,754,1710
E01004579,42,172,48,83,1270,1615
E01004580,46,266,118,153,1509,2092
E01004581,47,162,74,134,1400,1817
E01033099,35,227,62,75,629,1028
E01033101,72,36,52,157,874,1191
E01033133,51,140,70,109,823,1193
E01004565,28,159,93,62,1337,1679
E01004590,17,252,98,95,1287,1749
E01004591,38,274,98,100,1224,1734
E01004592,22,164,92,78,1272,1628
E01004604,15,14,45,31,1581,1686
E01004605,19,81,69,96,1463,1728
E01004606,19,9,33,76,1496,1633
E01004607,15,21,55,72,1566,1729
E01004608,26,73,92,75,1416,1682
E01004535,75,772,146,193,572,1758
E01004537,52,582,138,194,915,1881
E01004538,47,502,135,213,1104,2001
E01004541,48,570,108,157,754,1637
E01004534,21,92,78,94,1565,1850
E01004536,52,462,141,178,1217,2050
E01004552,21,77,79,105,1700,1982
E01004585,35,94,74,107,1530,1840
E01004588,44,92,83,80,1655,1954
E01004554,6,56,70,75,1400,1607
E01004556,10,48,66,43,1445,1612
E01004586,16,114,67,68,1547,1812
E01004587,24,75,81,89,1474,1743
E01004589,18,72,53,41,1516,1700
E01004509,78,120,81,218,1693,2190
E01004511,9,37,81,112,1483,1722
E01004602,6,52,50,117,1415,1640
E01004609,43,31,59,199,1815,2147
E01033093,25,46,46,106,1303,1526
E01033135,13,13,39,46,960,1071
E01004506,45,59,92,165,1562,1923
E01004638,9,25,57,72,1286,1449
E01004639,35,66,52,146,1425,1724
E01004640,32,46,66,102,1529,1775
E01004641,53,103,92,143,1519,1910
E01004508,33,140,77,131,1638,2019
E01004510,20,183,90,125,1527,1945
E01004514,24,97,50,73,1441,1685
E01004515,27,285,106,131,1143,1692
E01004551,28,260,101,136,1239,1764
E01004568,40,283,106,148,1088,1665
E01004574,79,402,173,207,950,1811
E01004575,51,220,97,193,1249,1810
E01004576,48,151,92,168,1105,1564
E01004500,42,57,64,145,1314,1622
E01004501,41,119,78,116,1228,1582
E01004503,51,79,70,130,1342,1672
E01004505,85,46,62,159,1264,1616
E01004507,49,61,85,180,1463,1838
E01004553,15,100,48,78,1399,1640
E01004557,21,76,59,55,1329,1540
E01004558,9,95,61,64,1481,1710
E01004559,13,73,46,33,1232,1397
E01004619,9,58,44,37,1289,1437
E01004572,61,201,51,158,1191,1662
E01004642,54,130,107,115,1450,1856
E01004643,82,235,139,267,1290,2013
E01004644,55,120,90,121,1551,1937
E01004645,60,385,127,183,1323,2078
E01004477,5,19,30,79,1539,1672
E01004478,16,51,70,99,1290,1526
E01004479,11,54,41,73,1369,1548
E01004550,38,140,90,83,1183,1534
E01004555,13,43,73,63,1496,1688
E01004494,32,176,100,158,1200,1666
E01004513,45,259,120,225,1217,1866
E01004600,53,641,153,290,925,2062
E01004601,40,160,112,363,1566,2241
E01004493,26,133,69,156,1377,1761
E01004512,17,67,57,106,1247,1494
E01004620,16,129,67,105,1330,1647
E01004621,14,89,63,116,1404,1686
E01004623,7,103,53,107,1463,1733
E01004627,12,102,55,62,1389,1620
E01004499,27,107,54,144,1259,1591
E01004502,19,26,83,154,1373,1655
E01004504,23,38,56,287,1119,1523
E01004594,17,26,47,221,1346,1657
E01004596,14,45,48,158,1356,1621
E01004629,40,47,82,237,1212,1618
E01004472,12,104,62,138,1430,1746
E01004474,37,186,78,171,1394,1866
E01004476,24,118,62,202,1230,1636
E01004542,9,104,63,61,1384,1621
E01004544,27,122,44,103,1237,1533
E01004628,44,208,93,396,1559,2300
E01004630,59,291,128,302,971,1751
E01004631,65,115,56,256,1045,1537
E01004633,58,316,132,257,855,1618
E01004569,69,276,154,274,1666,2439
E01004570,68,293,211,209,1123,1904
E01004571,74,241,79,188,1099,1681
E01004573,40,119,85,260,1092,1596
E01004495,38,407,82,267,742,1536
E01004496,29,81,70,167,1609,1956
E01004497,17,116,73,81,1158,1445
E01004622,44,336,154,185,1547,2266
E01004624,7,124,67,76,1318,1592
E01004593,45,71,76,229,1409,1830
E01004595,22,62,70,171,1432,1757
E01004597,25,134,61,164,1429,1813
E01004598,28,61,68,113,1490,1760
E01004599,6,29,57,88,1335,1515
E01004473,16,109,69,161,1343,1698
E01004475,16,153,71,135,1031,1406
E01004480,19,114,57,199,1264,1653
E01004483,31,237,103,349,1399,2119
E01004484,26,159,85,109,1144,1523
E01004486,13,102,71,110,1182,1478
E01004543,20,83,66,66,1556,1791
E01004545,15,65,53,126,1319,1578
E01004546,10,100,58,122,1216,1506
E01004549,17,146,106,205,1190,1664
E01004625,10,15,36,31,1305,1397
E01004626,22,109,79,165,1494,1869
E01004632,31,53,69,175,1199,1527
E01004634,57,124,52,154,1086,1473
E01004635,63,75,79,242,1186,1645
E01004636,44,91,79,214,1034,1462
E01004637,43,120,77,177,1054,1471
E01004481,36,129,86,279,1157,1687
E01004488,18,151,74,134,1134,1511
E01004547,27,230,68,129,946,1400
E01004548,26,140,99,273,1514,2052
E01004482,29,180,68,285,1026,1588
E01004485,19,148,92,178,1231,1668
E01004487,18,187,78,99,1178,1560
E01004489,19,134,81,108,1099,1441
E01004490,17,61,57,90,1285,1510
E01004491,77,356,96,471,1150,2150
E01004492,24,207,86,214,1188,1719
E01004498,14,60,58,117,1456,1705
E01004532,18,207,95,177,990,1487
E01004611,39,199,64,461,839,1602
E01004612,54,271,71,755,637,1788
E01004618,23,133,56,435,905,1552
E01004531,23,276,143,454,828,1724
E01004533,33,219,86,284,776,1398
E01004610,63,256,82,775,802,1978
E01004613,38,285,112,463,716,1614
E01004614,106,297,102,496,1064,2065
E01004615,41,468,128,277,884,1798
E01004616,78,331,129,566,1058,2162
E01004617,44,297,92,476,771,1680
E01004525,45,254,78,645,828,1850
E01004526,31,207,90,439,832,1599
E01004527,33,265,71,482,797,1648
E01004528,65,323,97,323,712,1520
E01004529,39,230,125,426,1266,2086
E01004530,36,226,94,415,1115,1886
E01004516,14,199,117,292,1188,1810
E01004518,34,234,109,238,1131,1746
E01004519,17,342,106,413,889,1767
E01004520,13,209,96,359,689,1366
E01004523,22,191,78,230,1061,1582
E01004517,51,412,159,224,1118,1964
E01004521,70,473,133,259,1017,1952
E01004522,41,358,96,264,887,1646
E01004524,30,418,112,272,839,1671
E01004647,141,60,55,244,980,1480
E01004649,214,69,49,429,947,1708
E01004724,176,52,67,347,1119,1761
E01004730,173,37,66,384,1011,1671
E01004646,149,66,52,270,1116,1653
E01004648,286,82,93,297,1640,2398
E01004650,158,49,77,300,1412,1996
E01004710,359,204,70,252,763,1648
E01004711,325,134,83,234,971,1747
E01004651,231,54,64,490,1176,2015
E01004725,339,139,76,351,710,1615
E01004726,247,72,64,382,1033,1798
E01004728,217,101,67,242,931,1558
E01004729,222,116,101,287,912,1638
E01004718,148,484,127,268,935,1962
E01004719,133,300,140,194,1142,1909
E01004720,198,302,151,219,1130,2000
E01004721,216,377,155,285,965,1998
E01004722,440,617,197,535,705,2494
E01004674,297,395,169,336,910,2107
E01004675,380,329,158,290,1127,2284
E01004677,108,301,114,212,1080,1815
E01004678,264,304,142,234,1056,2000
E01004679,312,399,166,246,1020,2143
E01004723,279,494,155,198,1074,2200
E01004676,202,259,104,175,945,1685
E01004706,95,57,87,161,1200,1600
E01004707,187,54,91,193,1429,1954
E01004708,136,171,101,154,1026,1588
E01004756,220,172,99,218,1091,1800
E01004701,227,37,90,162,1102,1618
E01004703,237,101,115,260,1595,2308
E01004705,102,34,62,154,1117,1469
E01004709,290,104,95,202,982,1673
E01033600,80,41,65,99,939,1224
E01033608,104,77,54,107,1074,1416
E01004659,157,68,83,365,1129,1802
E01004660,201,76,101,356,1047,1781
E01004712,132,30,80,273,1165,1680
E01004727,215,67,110,554,1080,2026
E01004670,672,452,175,771,639,2709
E01004702,668,308,137,467,1018,2598
E01033598,267,167,88,259,461,1242
E01033601,195,177,77,470,650,1569
E01033602,347,260,99,250,669,1625
E01033603,149,177,105,196,706,1333
E01033604,291,100,86,256,503,1236
E01033605,412,266,87,406,875,2046
E01004754,291,307,107,184,740,1629
E01004755,442,303,149,378,935,2207
E01004757,264,241,105,250,738,1598
E01032512,581,422,192,395,950,2540
E01032513,218,224,90,203,620,1355
E01004713,96,49,98,123,1463,1829
E01004714,243,82,84,251,1490,2150
E01004716,69,23,60,212,1059,1423
E01004717,74,10,64,150,1213,1511
E01004762,244,86,74,318,1348,2070
E01004657,159,18,57,148,1098,1480
E01004658,330,60,70,289,808,1557
E01004661,314,111,97,279,1046,1847
E01004662,173,42,94,293,1274,1876
E01004663,199,66,84,176,1123,1648
E01004715,110,127,87,356,1093,1773
E01004763,75,67,133,385,1467,2127
E01004765,152,129,101,285,1356,2023
E01033595,75,50,60,147,843,1175
E01033596,81,46,71,174,863,1235
E01004653,98,65,91,123,1435,1812
E01004654,130,85,113,263,1683,2274
E01004656,201,146,126,298,1336,2107
E01004760,189,208,106,177,950,1630
E01033606,100,72,64,117,715,1068
E01033607,83,47,80,86,903,1199
E01004680,177,25,58,193,1035,1488
E01004683,168,33,91,243,1127,1662
E01004684,492,108,81,307,629,1617
E01004686,559,56,77,243,594,1529
E01033593,292,117,58,235,428,1130
E01033594,234,94,50,212,778,1368
E01004681,224,58,122,390,1332,2126
E01004682,169,52,93,262,966,1542
E01004694,157,59,112,266,1219,1813
E01004697,161,36,88,180,1048,1513
E01004700,161,60,117,192,1233,1763
E01004652,276,93,113,334,1024,1840
E01004693,98,46,71,150,1033,1398
E01004695,120,74,74,217,812,1297
E01004696,285,137,119,219,826,1586
E01004698,161,68,82,237,1010,1558
E01004699,234,66,131,274,1562,2267
E01004734,88,71,71,503,1239,1972
E01004735,54,103,80,247,1345,1829
E01004736,49,39,49,275,1332,1744
E01004761,214,59,93,303,1276,1945
E01004687,95,26,53,103,1392,1669
E01004688,145,31,78,580,1116,1950
E01004689,101,36,62,105,869,1173
E01004690,60,42,51,107,1140,1400
E01004691,168,36,82,178,1044,1508
E01004692,259,51,65,308,887,1570
E01004731,69,81,67,233,1331,1781
E01004732,126,164,75,151,940,1456
E01004733,116,83,116,207,1524,2046
E01004744,50,122,66,130,979,1347
E01004748,34,54,46,141,1176,1451
E01004740,93,138,61,206,996,1494
E01004743,103,169,71,272,781,1396
E01004745,89,119,82,217,1607,2114
E01004746,104,100,94,224,918,1440
E01004747,117,157,100,268,1598,2240
E01004742,36,45,41,75,1194,1391
E01004749,125,99,99,302,1820,2445
E01004751,39,74,56,116,1488,1773
E01004752,87,100,74,122,1186,1569
E01004753,80,111,82,113,1427,1813
E01004666,70,90,55,183,705,1103
E01004667,71,87,71,168,951,1348
E01004668,104,83,64,188,1004,1443
E01004750,126,109,55,278,1201,1769
E01033597,93,96,45,105,651,990
E01033599,210,245,104,238,776,1573
E01004665,240,174,70,233,761,1478
E01004669,171,168,104,262,978,1683
E01004737,91,79,50,97,984,1301
E01004738,43,64,35,106,1103,1351
E01004739,18,24,25,129,1152,1348
E01004741,42,83,60,141,947,1273
E01000027,7,228,92,157,1225,1709
E01000028,20,336,80,216,897,1549
E01000029,27,211,41,300,1023,1602
E01000030,35,358,117,147,1258,1915
E01000031,47,255,81,428,806,1617
E01000032,35,205,62,312,1015,1629
E01000110,30,232,54,315,785,1416
E01000111,29,308,70,307,1119,1833
E01000112,33,331,93,481,933,1871
E01000113,50,287,73,441,828,1679
E01000034,8,234,33,65,1104,1444
E01000037,8,152,46,74,1408,1688
E01000038,5,107,36,91,1208,1447
E01000039,7,156,71,83,1286,1603
E01000063,14,231,54,127,1194,1620
E01000100,24,226,66,177,1160,1653
E01000101,15,240,43,147,1068,1513
E01000109,13,270,71,310,1022,1686
E01000114,14,478,79,289,1230,2090
E01000033,8,216,52,51,1034,1361
E01000060,17,420,50,129,1193,1809
E01000061,21,444,78,88,1145,1776
E01000062,2,466,62,164,1258,1952
E01000064,7,451,65,94,1276,1893
E01000065,22,312,55,109,1238,1736
E01000078,20,256,77,162,1151,1666
E01000080,20,289,80,90,1077,1556
E01000081,25,338,56,116,1153,1688
E01000082,15,287,59,127,1195,1683
E01000083,25,289,75,158,1153,1700
E01000102,14,239,76,121,1090,1540
E01000021,17,309,85,313,855,1579
E01000022,9,255,70,146,834,1314
E01000023,21,190,49,236,616,1112
E01000024,27,287,58,217,747,1336
E01000025,6,245,73,171,1114,1609
E01000077,12,295,31,137,970,1445
E01000015,43,480,74,154,1490,2241
E01000016,16,297,53,117,1154,1637
E01000017,18,309,51,110,1106,1594
E01000018,6,280,51,116,1144,1597
E01000079,11,275,51,141,1068,1546
E01000035,14,296,60,160,1080,1610
E01000036,4,290,33,242,784,1353
E01000107,15,280,42,141,1188,1666
E01000108,18,280,67,139,1054,1558
E01000066,44,179,77,709,919,1928
E01000067,38,252,48,717,914,1969
E01000069,31,107,82,733,810,1763
E01000070,29,150,117,850,829,1975
E01000071,69,281,103,932,868,2253
E01000057,24,340,75,86,971,1496
E01000073,17,241,67,148,1146,1619
E01000074,17,259,85,77,1129,1567
E01000075,8,238,84,137,1265,1732
E01000076,23,414,63,209,1279,1988
E01000013,5,284,67,165,1139,1660
E01000014,17,250,66,81,1242,1656
E01000059,12,277,65,65,1163,1582
E01000084,10,238,53,100,954,1355
E01000085,77,303,59,97,1182,1718
E01000086,12,298,52,122,947,1431
E01000103,35,473,69,107,1001,1685
E01000104,22,455,68,103,1133,1781
E01000105,17,458,113,108,1433,2129
E01000106,18,527,93,111,1219,1968
E01000007,28,389,88,447,439,1391
E01000008,53,574,83,349,485,1544
E01000010,94,580,149,1205,812,2840
E01000012,44,530,117,675,535,1901
E01000006,50,177,58,861,557,1703
E01000009,49,228,62,1012,422,1773
E01000011,47,143,28,1070,346,1634
E01000044,23,395,118,480,782,1798
E01000068,28,123,33,856,550,1590
E01000041,21,359,65,112,1125,1682
E01000042,43,358,95,322,970,1788
E01000045,26,402,100,147,975,1650
E01000046,29,269,63,109,1309,1779
E01000072,22,381,92,173,1323,1991
E01000054,12,323,50,109,1224,1718
E01000055,8,260,64,139,1082,1553
E01000056,18,313,61,122,1070,1584
E01000058,28,430,92,191,1108,1849
E01000095,25,500,57,187,803,1572
E01000040,38,287,63,280,901,1569
E01000043,27,200,41,376,714,1358
E01000050,53,300,87,581,640,1661
E01000052,33,433,98,514,936,2014
E01000092,79,794,126,566,1109,2674
E01000053,8,401,60,117,899,1485
E01000087,10,329,54,68,880,1341
E01000088,14,558,58,229,969,1828
E01000089,19,468,92,96,991,1666
E01000090,47,463,58,207,809,1584
E01000048,45,740,105,231,662,1783
E01000049,68,679,123,268,682,1820
E01000051,92,726,97,326,686,1927
E01033587,41,462,72,349,706,1630
E01033588,51,542,100,305,619,1617
E01000091,33,521,65,241,854,1714
E01000093,23,486,90,158,790,1547
E01000094,15,565,89,203,454,1326
E01000096,35,765,84,181,830,1895
E01000019,44,213,70,297,783,1407
E01000020,21,343,70,208,1192,1834
E01000097,27,200,74,227,1155,1683
E01000098,17,264,94,308,1063,1746
E01000099,16,217,83,198,1218,1732
E01032580,30,206,49,421,648,1354
E01000248,14,27,59,94,1467,1661
E01000249,10,24,45,139,1307,1525
E01000250,76,77,82,209,1788,2232
E01000254,8,19,68,82,1372,1549
E01000292,27,46,58,160,1176,1467
E01000293,38,49,72,203,1360,1722
E01000167,38,85,63,102,1019,1307
E01000246,33,51,59,122,1238,1503
E01000247,53,57,74,131,1376,1691
E01000251,78,97,105,191,1375,1846
E01000252,39,80,66,168,1256,1609
E01000166,49,96,75,191,1171,1582
E01000168,56,32,56,242,1178,1564
E01000169,25,56,60,105,1244,1490
E01000172,41,55,53,160,1368,1677
E01000285,39,92,79,164,1075,1449
E01000287,45,103,49,155,1237,1589
E01000288,30,78,81,248,1132,1569
E01000289,61,334,129,237,1056,1817
E01000291,69,233,103,208,962,1575
E01000294,50,66,83,175,1225,1599
E01000267,35,41,60,225,1159,1520
E01000268,67,162,105,191,1214,1739
E01000269,20,38,50,220,1097,1425
E01000270,35,56,68,177,1146,1482
E01000170,25,110,109,156,1236,1636
E01000171,63,161,108,187,1330,1849
E01000173,51,63,83,184,1338,1719
E01000174,60,119,112,198,1239,1728
E01000175,32,47,83,180,1243,1585
E01000228,70,89,50,339,933,1481
E01000253,42,49,58,212,1330,1691
E01000279,39,17,30,187,1176,1449
E01000280,35,15,55,210,1066,1381
E01000286,43,138,81,200,1109,1571
E01000290,29,56,64,172,1236,1557
E01000271,46,46,51,198,1128,1469
E01000272,41,19,48,167,1065,1340
E01000273,44,94,72,282,1028,1520
E01000281,69,137,38,158,858,1260
E01000282,54,51,101,357,1142,1705
E01000115,77,49,32,287,1039,1484
E01000116,60,49,94,241,1274,1718
E01000119,113,55,83,364,1065,1680
E01000120,83,45,70,304,1002,1504
E01000122,56,79,68,328,940,1471
E01000117,73,46,73,190,1437,1819
E01000118,56,92,135,260,1393,1936
E01000121,60,133,111,224,969,1497
E01000123,54,76,98,296,1140,1664
E01000124,74,190,91,313,953,1621
E01000265,62,170,105,271,1319,1927
E01000266,52,42,41,198,1194,1527
E01000274,52,121,99,344,1246,1862
E01000320,42,74,80,219,1060,1475
E01000322,85,66,94,274,1198,1717
E01000275,63,63,84,459,968,1637
E01000277,144,109,80,397,861,1591
E01000283,44,22,29,310,1025,1430
E01000284,76,67,97,313,1119,1672
E01000321,106,79,70,261,1119,1635
E01000195,86,353,99,280,970,1788
E01000229,60,267,87,272,981,1667
E01000230,51,82,43,394,1215,1785
E01000231,88,285,89,501,886,1849
E01000232,54,167,70,466,1080,1837
E01000233,65,168,86,403,1095,1817
E01000186,46,33,21,379,1133,1612
E01000187,67,110,48,283,1149,1657
E01000188,37,35,40,373,1069,1554
E01000189,95,445,164,364,746,1814
E01000190,61,91,53,277,1097,1579
E01000191,56,57,35,386,991,1525
E01000158,49,141,74,250,956,1470
E01000159,52,114,79,246,1286,1777
E01000160,87,166,113,424,1271,2061
E01000161,76,182,108,331,1124,1821
E01000162,49,122,96,338,994,1599
E01000324,58,101,96,279,1252,1786
E01000256,54,159,68,313,1194,1788
E01000258,42,83,67,224,1242,1658
E01000263,44,37,45,217,1238,1581
E01000264,74,154,97,315,1008,1648
E01000255,54,149,74,263,941,1481
E01000257,118,234,131,405,967,1855
E01000261,28,64,55,171,1283,1601
E01000262,134,258,164,411,1293,2260
E01000192,125,112,50,416,1147,1850
E01000193,79,121,43,415,1051,1709
E01000194,99,170,80,478,813,1640
E01000226,69,285,114,392,898,1758
E01000227,60,137,73,454,1130,1854
E01000299,90,92,94,507,1026,1809
E01000300,66,73,64,383,1046,1632
E01000302,105,89,109,458,1002,1763
E01000317,104,66,94,410,939,1613
E01000318,93,83,73,581,1010,1840
E01000323,110,159,95,474,1144,1982
E01000276,50,22,49,494,905,1520
E01000278,51,28,33,555,847,1514
E01000301,52,36,76,461,914,1539
E01000303,97,37,84,443,906,1567
E01000304,69,78,77,256,1076,1556
E01000130,54,328,91,349,781,1603
E01000132,69,222,97,324,766,1478
E01000133,54,262,68,367,850,1601
E01000234,62,147,75,262,1155,1701
E01000235,82,252,101,277,976,1688
E01000156,85,110,111,151,1418,1875
E01000157,56,98,108,120,1159,1541
E01000163,59,213,120,182,984,1558
E01000164,95,189,141,225,1036,1686
E01000165,123,124,135,490,990,1862
E01000315,70,173,134,318,1020,1715
E01000197,67,88,99,408,1168,1830
E01000295,71,69,86,451,1037,1714
E01000296,72,66,100,408,1061,1707
E01000298,100,59,98,387,1168,1812
E01000125,181,502,167,832,1097,2779
E01000127,63,267,81,341,753,1505
E01000128,73,302,99,480,915,1869
E01000129,83,234,111,517,837,1782
E01000131,100,184,73,624,825,1806
E01000134,57,298,79,387,811,1632
E01000198,150,116,68,292,1267,1893
E01000199,111,54,48,232,1172,1617
E01000204,100,57,66,287,1218,1728
E01000259,114,150,157,672,1504,2597
E01000260,105,236,114,416,1111,1982
E01000126,139,579,141,466,837,2162
E01000151,138,612,156,267,538,1711
E01000152,138,561,156,239,635,1729
E01000153,54,392,122,263,710,1541
E01000154,83,375,79,273,550,1360
E01000176,41,162,130,261,1019,1613
E01000178,49,76,89,165,1412,1791
E01000184,49,289,83,188,805,1414
E01000297,51,103,60,403,817,1434
E01000316,151,244,155,574,1188,2312
E01000319,44,45,75,300,1036,1500
E01000196,96,89,87,372,1158,1802
E01000200,141,82,48,290,1284,1845
E01000201,110,66,55,283,1017,1531
E01000202,84,63,95,254,1255,1751
E01000203,119,154,99,379,967,1718
E01000177,39,72,73,155,1289,1628
E01000179,32,78,88,180,1236,1614
E01000180,62,91,83,238,1133,1607
E01000181,58,31,96,138,1388,1711
E01000182,54,31,89,146,1371,1691
E01000185,91,296,87,267,706,1447
E01000147,67,91,75,853,648,1734
E01000148,116,316,97,603,741,1873
E01000155,64,253,84,636,843,1880
E01033572,93,148,73,614,660,1588
E01033573,119,290,112,430,671,1622
E01000239,150,250,107,488,975,1970
E01000240,104,184,113,441,828,1670
E01000241,136,82,61,273,1192,1744
E01000309,96,141,74,612,899,1822
E01000237,177,75,65,296,1425,2038
E01000242,97,141,50,206,1162,1656
E01000243,82,68,67,375,1292,1884
E01000244,104,135,68,438,960,1705
E01000245,153,230,131,329,1139,1982
E01000314,75,126,73,682,909,1865
E01000183,83,37,76,148,1129,1473
E01000206,85,41,43,212,1195,1576
E01000207,54,29,57,136,1307,1583
E01000208,104,31,42,181,1236,1594
E01000210,82,42,46,159,1219,1548
E01000213,59,20,33,72,1254,1438
E01000236,154,38,57,130,1481,1860
E01000238,203,99,77,280,1304,1963
E01000310,114,120,78,545,1172,2029
E01000311,82,70,31,136,1313,1632
E01000205,85,55,73,123,1186,1522
E01000209,39,14,52,61,1397,1563
E01000211,120,130,116,302,1346,2014
E01000212,39,35,46,148,1160,1428
E01000216,152,37,82,326,1371,1968
E01000217,94,67,35,142,1387,1725
E01000150,84,242,112,766,856,2060
E01000305,138,183,76,592,668,1657
E01000306,64,117,54,837,624,1696
E01000308,71,281,100,329,735,1516
E01000312,75,191,83,540,783,1672
E01000313,128,158,97,727,748,1858
E01000145,121,66,41,253,1036,1517
E01000215,156,86,45,248,1498,2033
E01000218,168,77,62,191,1320,1818
E01000219,160,57,47,335,1306,1905
E01000220,147,51,62,241,1370,1871
E01000225,160,35,40,142,1399,1776
E01000135,126,62,77,308,991,1564
E01000136,91,32,82,180,1147,1532
E01000144,116,49,65,388,920,1538
E01000146,142,83,113,337,1041,1716
E01000214,89,33,63,265,1213,1663
E01000141,186,299,119,374,1126,2104
E01000221,91,284,90,255,574,1294
E01000223,102,189,83,221,692,1287
E01000307,76,204,65,572,738,1655
E01000138,183,99,62,261,844,1449
E01000142,221,286,141,398,1335,2381
E01000222,214,195,86,331,756,1582
E01000224,208,197,97,348,709,1559
E01000137,134,262,126,236,971,1729
E01000139,132,78,69,195,955,1429
E01000140,121,106,75,264,1065,1631
E01000143,135,206,81,226,811,1459
E01000466,18,629,70,162,776,1655
E01000467,28,616,94,110,786,1634
E01000468,42,1418,132,138,993,2723
E01000469,12,691,63,123,765,1654
E01000416,16,496,50,226,759,1547
E01000418,23,424,60,275,1155,1937
E01000422,34,641,54,216,784,1729
E01000464,13,513,43,124,750,1443
E01000465,14,499,58,73,898,1542
E01000470,22,492,62,112,755,1443
E01000333,14,143,38,66,1405,1666
E01000335,33,424,84,164,1089,1794
E01000336,41,440,80,262,1063,1886
E01000337,12,210,80,116,1235,1653
E01000338,20,218,31,186,1296,1751
E01000403,20,328,79,121,1560,2108
E01000404,18,630,88,134,1364,2234
E01000405,14,303,57,86,950,1410
E01000408,37,293,50,305,951,1636
E01000332,19,143,43,164,1160,1529
E01000402,7,153,52,124,1200,1536
E01000406,12,348,47,167,1075,1649
E01000407,6,110,28,165,1171,1480
E01000334,19,143,33,150,1266,1611
E01000417,22,177,49,126,1265,1639
E01000419,4,59,29,130,1239,1461
E01000420,6,64,27,119,1335,1551
E01000442,12,80,20,118,1383,1613
E01000437,2,52,22,97,1149,1322
E01000438,14,97,33,100,1355,1599
E01000439,2,98,44,76,1148,1368
E01000440,7,45,26,142,1193,1413
E01000441,4,99,52,91,1352,1598
E01000373,25,386,81,60,1022,1574
E01000429,13,378,56,60,1132,1639
E01000430,16,507,50,67,1142,1782
E01000431,11,368,60,71,1162,1672
E01000432,31,263,42,70,1267,1673
E01000433,7,346,66,60,1331,1810
E01000434,10,185,36,48,1305,1584
E01000356,7,48,16,177,1298,1546
E01000357,22,43,20,145,1227,1457
E01000359,2,55,33,106,1084,1280
E01000421,22,27,13,123,1297,1482
E01000450,16,148,38,127,1503,1832
E01000451,6,121,24,134,1414,1699
E01000452,28,59,39,138,1164,1428
E01000367,4,179,30,82,1280,1575
E01000368,4,154,37,65,1279,1539
E01000372,14,195,25,145,1301,1680
E01000380,4,81,15,32,1323,1455
E01000435,5,211,43,42,1105,1406
E01000353,8,41,30,85,1522,1686
E01000354,5,59,36,128,1277,1505
E01000355,9,52,16,65,1322,1464
E01000358,5,39,20,114,1430,1608
E01000436,5,41,27,134,1478,1685
E01000401,8,114,34,141,1350,1647
E01000453,9,69,34,106,1254,1472
E01000454,24,52,30,163,1303,1572
E01000455,19,74,21,223,1368,1705
E01000456,16,57,20,126,1208,1427
E01000325,5,29,22,47,1507,1610
E01000326,7,73,22,32,1161,1295
E01000369,21,80,30,43,1444,1618
E01000370,11,57,43,59,1427,1597
E01000371,4,77,16,40,1408,1545
E01000360,14,41,43,146,1418,1662
E01000362,18,40,27,79,1318,1482
E01000365,6,59,26,112,1475,1678
E01000366,15,30,45,165,1330,1585
E01000394,11,43,39,96,1269,1458
E01000388,14,58,20,184,1255,1531
E01000392,28,143,59,169,1247,1646
E01000409,14,22,21,81,1511,1649
E01000411,14,78,24,82,1200,1398
E01000414,35,97,54,282,1240,1708
E01000415,18,58,31,159,1232,1498
E01000327,12,18,28,79,1406,1543
E01000328,8,30,17,56,1369,1480
E01000329,5,48,10,72,1181,1316
E01000330,6,41,28,91,1378,1544
E01000331,5,88,46,97,1394,1630
E01000340,5,36,12,70,1379,1502
E01000395,6,32,31,114,1245,1428
E01000396,27,43,14,133,1182,1399
E01000410,7,79,25,71,1386,1568
E01000412,11,87,19,130,1431,1678
E01000413,18,49,20,78,1136,1301
E01000374,8,128,37,86,1274,1533
E01000375,5,95,29,45,1302,1476
E01000376,8,62,37,89,1345,1541
E01000377,2,35,22,44,1317,1420
E01000378,11,119,44,93,1854,2121
E01000379,6,86,23,70,1495,1680
E01000348,9,18,30,65,1359,1481
E01000349,1,59,38,80,1481,1659
E01000361,3,61,27,54,1395,1540
E01000363,10,50,23,144,1214,1441
E01000389,5,28,19,181,1416,1649
E01000390,28,34,43,118,1067,1290
E01000393,10,76,38,121,1336,1581
E01000346,3,25,40,68,1486,1622
E01000347,20,38,39,58,1331,1486
E01000350,8,27,27,60,1379,1501
E01000352,13,41,47,82,1392,1575
E01000391,6,83,34,69,1517,1709
E01000341,2,28,18,53,1389,1490
E01000342,8,15,28,52,1492,1595
E01000343,4,12,22,74,1423,1535
E01000345,5,16,36,57,1241,1355
E01000460,5,20,19,71,1238,1353
E01000364,7,62,35,122,1351,1577
E01000444,5,18,43,163,1408,1637
E01000447,8,21,35,71,1400,1535
E01000448,2,15,21,43,1254,1335
E01000449,2,22,24,64,1383,1495
E01000351,6,22,30,79,1449,1586
E01000443,12,16,25,29,1194,1276
E01000445,8,21,17,98,1497,1641
E01000446,16,10,19,48,1479,1572
E01000461,15,42,16,105,1484,1662
E01000339,10,32,27,44,1417,1530
E01000344,6,40,29,36,1498,1609
E01000423,18,48,22,44,1506,1638
E01000425,5,21,20,73,1633,1752
E01000463,2,26,28,61,1137,1254
E01000424,7,15,34,77,1560,1693
E01000426,12,32,29,64,1538,1675
E01000427,14,32,38,76,1772,1932
E01000457,9,46,53,117,1558,1783
E01000462,14,47,26,82,1474,1643
E01000382,15,33,19,83,1374,1524
E01000384,3,26,36,55,1602,1722
E01000387,6,46,15,86,1382,1535
E01000428,6,75,63,158,1450,1752
E01000458,8,24,30,66,1334,1462
E01000459,4,27,50,86,1520,1687
E01000381,9,40,38,40,1471,1598
E01000383,8,35,30,48,1384,1505
E01000385,17,117,60,72,1600,1866
E01000386,14,111,60,110,1162,1457
E01000398,9,77,35,121,1357,1599
E01000399,20,96,30,129,1279,1554
E01000400,14,81,29,186,1237,1547
E01032566,15,128,67,101,1373,1684
E01000587,44,83,47,1039,495,1708
E01000589,87,165,54,1218,408,1932
E01000590,52,117,63,877,680,1789
E01000592,94,180,46,808,494,1622
E01000593,114,362,81,1015,562,2134
E01000594,29,136,47,1084,402,1698
E01000513,120,162,36,735,640,1693
E01000514,66,160,89,570,627,1512
E01000516,98,162,62,694,691,1707
E01000520,115,191,79,546,706,1637
E01000588,125,501,106,852,613,2197
E01000515,114,260,111,626,591,1702
E01000517,86,58,21,912,532,1609
E01000543,83,104,48,1015,346,1596
E01000591,131,133,65,1300,446,2075
E01033463,188,201,65,1639,846,2939
E01000536,53,64,56,921,479,1573
E01000538,77,57,22,877,549,1582
E01000539,50,53,38,831,569,1541
E01000540,55,59,41,862,479,1496
E01000541,35,82,33,879,377,1406
E01000518,95,224,70,663,610,1662
E01000519,211,247,89,755,621,1923
E01000623,118,161,54,773,666,1772
E01000624,90,222,73,650,655,1690
E01000629,124,187,38,878,684,1911
E01000480,200,163,48,733,605,1749
E01000484,85,361,56,343,383,1228
E01000485,63,199,70,612,431,1375
E01000486,194,75,108,738,587,1702
E01000487,164,213,70,844,599,1890
E01000572,37,169,64,765,446,1481
E01000573,93,132,65,773,533,1596
E01000574,51,128,75,604,497,1355
E01000575,113,174,74,915,579,1855
E01000577,208,613,113,929,557,2420
E01000562,74,124,45,922,383,1548
E01000563,86,99,54,843,398,1480
E01000566,87,146,44,786,472,1535
E01000568,70,187,61,1038,904,2260
E01000569,68,141,42,822,492,1565
E01000479,251,126,54,704,524,1659
E01000481,120,319,69,578,452,1538
E01000482,197,918,157,884,730,2886
E01000483,179,542,106,451,467,1745
E01000625,172,197,56,421,658,1504
E01000498,124,386,45,734,391,1680
E01000622,90,289,99,278,829,1585
E01000626,107,519,100,249,525,1500
E01033464,218,630,102,1351,721,3022
E01000497,122,355,67,443,769,1756
E01000499,165,342,103,520,602,1732
E01000501,156,539,148,340,691,1874
E01000502,97,256,62,356,622,1393
E01000503,161,348,93,365,1001,1968
E01000570,49,318,63,763,386,1579
E01000571,133,231,73,797,473,1707
E01000576,136,133,67,883,441,1660
E01000578,122,216,92,668,723,1821
E01000564,54,213,76,739,488,1570
E01000565,71,241,44,743,374,1473
E01000607,66,231,78,1372,476,2223
E01000608,117,338,96,1268,444,2263
E01000613,75,259,68,822,449,1673
E01000506,111,424,83,345,708,1671
E01000509,95,304,41,527,486,1453
E01000510,176,267,91,453,686,1673
E01000511,136,324,86,423,660,1629
E01000627,152,484,96,508,660,1900
E01000628,117,439,107,583,645,1891
E01000553,132,298,106,544,1020,2100
E01000554,102,290,128,287,1050,1857
E01000555,119,132,85,316,845,1497
E01000556,188,318,69,422,872,1869
E01000557,161,190,92,449,969,1861
E01000558,106,143,110,188,961,1508
E01000567,40,158,53,640,489,1380
E01000606,65,285,69,845,446,1710
E01000609,85,315,90,1049,540,2079
E01000611,57,227,41,839,251,1415
E01000615,87,460,70,617,369,1603
E01000617,89,274,51,921,415,1750
E01000618,54,410,57,719,399,1639
E01000619,67,479,64,754,288,1652
E01033424,87,399,94,535,393,1508
E01033457,130,152,75,878,477,1712
E01000504,106,234,117,226,993,1676
E01000505,135,297,76,480,672,1660
E01000507,140,225,89,485,695,1634
E01000512,63,187,94,290,1068,1702
E01000559,78,188,98,187,864,1415
E01000610,75,273,63,1128,396,1935
E01000612,51,154,57,996,394,1652
E01000631,44,167,37,1346,288,1882
E01000633,24,125,35,1608,178,1970
E01000634,82,454,79,1398,330,2343
E01000616,41,241,94,851,520,1747
E01000620,91,331,34,954,305,1715
E01000621,67,404,83,815,410,1779
E01000635,114,444,96,1320,441,2415
E01000636,47,259,59,1100,311,1776
E01000596,114,771,133,268,408,1694
E01000601,139,686,109,204,367,1505
E01000602,83,654,89,379,336,1541
E01000603,87,604,111,282,403,1487
E01000604,91,863,109,314,389,1766
E01000605,59,687,79,351,486,1662
E01000488,167,226,95,398,690,1576
E01000637,56,340,105,319,855,1675
E01000639,59,223,135,309,1031,1757
E01000642,92,263,133,369,1197,2054
E01000644,90,306,130,459,963,1948
E01000490,83,157,123,192,1051,1606
E01000494,186,195,113,291,953,1738
E01000495,119,219,102,168,966,1574
E01000560,54,107,114,152,1190,1617
E01000561,138,296,120,230,1021,1805
E01000638,109,332,133,482,883,1939
E01000640,146,364,144,603,866,2123
E01000641,77,475,164,402,827,1945
E01000643,150,696,158,394,748,2146
E01000508,85,775,95,328,678,1961
E01000521,156,764,153,466,640,2179
E01000522,88,756,135,207,737,1923
E01000526,117,1082,154,335,591,2279
E01000527,112,823,169,288,786,2178
E01000528,54,825,121,186,307,1493
E01000471,49,203,71,925,390,1638
E01000474,26,228,67,1472,206,1999
E01000476,37,201,38,1097,245,1618
E01000477,77,321,75,1002,441,1916
E01000630,82,472,94,1256,350,2254
E01000595,140,735,102,266,442,1685
E01000599,77,721,62,144,304,1308
E01000600,135,990,141,304,477,2047
E01033456,94,1262,135,356,361,2208
E01000545,106,188,146,218,1151,1809
E01000546,75,172,106,206,1086,1645
E01000547,84,263,97,221,1115,1780
E01000548,150,304,129,203,1258,2044
E01000549,79,201,155,197,1304,1936
E01000472,72,114,34,681,445,1346
E01000473,20,134,37,1528,164,1883
E01000475,65,242,44,1210,415,1976
E01000478,45,145,53,1147,251,1641
E01000632,62,115,43,1710,157,2087
E01000489,189,184,107,284,817,1581
E01000491,268,217,122,303,1086,1996
E01000492,75,127,70,247,796,1315
E01000493,93,191,114,275,964,1637
E01000581,59,218,92,140,1041,1550
E01000523,169,897,175,339,1030,2610
E01000524,146,994,163,416,795,2514
E01000525,75,719,173,235,784,1986
E01000533,70,743,160,343,943,2259
E01000535,81,502,164,298,1125,2170
E01033455,94,353,89,183,470,1189
E01033485,134,659,142,350,706,1991
E01000579,67,326,119,177,976,1665
E01000580,91,182,113,140,1454,1980
E01000582,82,142,127,118,1378,1847
E01000583,112,237,130,283,1511,2273
E01000586,198,397,217,338,1307,2457
E01000530,62,286,112,361,1003,1824
E01000531,123,465,175,224,1090,2077
E01000532,89,398,130,144,869,1630
E01000534,80,363,131,295,906,1775
E01000584,49,236,127,383,900,1695
E01000585,101,283,112,259,1059,1814
E01000544,184,652,137,209,595,1777
E01000550,128,543,121,264,910,1966
E01000551,191,965,168,239,652,2215
E01000552,203,897,120,179,418,1817
E01000779,9,68,44,124,988,1233
E01000780,17,174,54,92,1143,1480
E01000781,10,149,75,43,1168,1445
E01000782,10,189,59,63,1120,1441
E01000783,21,135,68,52,1227,1503
E01000785,2,104,35,56,1184,1381
E01000689,18,36,63,91,1167,1375
E01000690,10,39,40,91,1222,1402
E01000691,28,42,53,40,1275,1438
E01000692,13,31,30,42,1459,1575
E01000784,8,56,41,79,1320,1504
E01000799,12,320,100,143,1067,1642
E01000802,23,303,122,121,1160,1729
E01000803,30,280,113,75,1098,1596
E01000804,20,177,61,105,1073,1436
E01000805,26,214,93,76,1102,1511
E01000740,44,513,126,137,914,1734
E01000741,13,371,131,90,981,1586
E01000742,35,431,162,80,1311,2019
E01000745,24,381,137,121,1094,1757
E01000746,12,270,165,104,1307,1858
E01000709,16,48,38,92,1123,1317
E01000710,18,96,66,102,1323,1605
E01000711,26,88,50,117,1438,1719
E01000714,20,77,80,131,1557,1865
E01000718,49,273,129,156,1454,2061
E01000645,5,15,38,141,1176,1375
E01000649,20,92,53,199,1617,1981
E01000694,23,40,31,112,1421,1627
E01000695,5,20,27,42,1400,1494
E01000696,3,15,24,101,1371,1514
E01000697,18,18,29,90,1460,1615
E01000674,13,81,78,116,1276,1564
E01000676,35,111,93,148,1348,1735
E01000820,20,59,63,72,1191,1405
E01000822,20,125,99,72,1298,1614
E01000823,14,47,47,81,1487,1676
E01000824,21,63,57,47,1018,1206
E01000825,20,66,66,95,1326,1573
E01000743,33,433,155,70,1079,1770
E01000744,18,426,92,96,899,1531
E01000796,49,566,118,96,801,1630
E01000798,26,389,118,84,847,1464
E01000800,24,444,110,98,942,1618
E01000806,23,502,138,126,932,1721
E01000693,14,41,22,225,1307,1609
E01000698,11,51,38,110,972,1182
E01000736,13,48,50,40,1409,1560
E01000737,5,85,22,87,1178,1377
E01000672,29,64,65,103,1259,1520
E01000673,17,84,69,86,1315,1571
E01000716,21,45,59,70,1347,1542
E01000717,18,59,66,67,1399,1609
E01000828,12,58,63,133,1318,1584
E01000712,24,66,65,140,1346,1641
E01000713,20,129,51,89,1404,1693
E01000715,15,45,57,99,1441,1657
E01000770,16,23,44,61,1285,1429
E01000772,14,45,62,67,1328,1516
E01000700,5,119,75,67,1243,1509
E01000702,7,103,73,66,1072,1321
E01000703,3,72,74,76,1374,1599
E01000706,6,113,70,59,1045,1293
E01000797,22,76,85,56,1323,1562
E01000729,22,154,60,64,1483,1783
E01000730,3,162,71,42,1446,1724
E01000735,1,96,38,63,1286,1484
E01000738,16,104,46,54,1307,1527
E01000739,8,163,49,43,1260,1523
E01000699,14,282,99,100,947,1442
E01000701,19,170,75,68,995,1327
E01000704,13,199,75,74,1083,1444
E01000705,8,290,102,94,816,1310
E01000801,15,211,93,107,991,1417
E01000646,22,63,53,127,1376,1641
E01000647,14,49,41,98,1407,1609
E01000648,29,55,60,121,1479,1744
E01000653,24,34,42,115,1369,1584
E01000678,28,85,50,115,1429,1707
E01000670,39,97,88,220,1488,1932
E01000675,38,99,99,133,1255,1624
E01000677,27,99,71,115,1457,1769
E01000762,31,36,70,130,1356,1623
E01000829,41,80,70,118,1424,1733
E01000719,13,199,66,64,1554,1896
E01000720,18,194,69,46,1305,1632
E01000721,9,161,56,65,1036,1327
E01000724,10,272,64,58,1356,1760
E01000728,18,93,47,42,1271,1471
E01000651,13,21,53,85,1456,1628
E01000668,14,49,58,104,1395,1620
E01000669,0,50,75,45,1502,1672
E01000671,9,81,63,148,1443,1744
E01000679,14,73,70,64,1439,1660
E01000826,39,40,27,91,1428,1625
E01000827,31,59,53,169,1380,1692
E01000830,28,38,54,108,1322,1550
E01000831,28,30,50,116,1416,1640
E01000833,3,34,53,84,1288,1462
E01000650,31,56,56,197,1571,1911
E01000652,12,36,25,94,1458,1625
E01000807,7,29,46,67,1383,1532
E01000809,7,35,20,29,1426,1517
E01000722,6,78,38,71,1443,1636
E01000725,1,77,38,48,1477,1641
E01000731,6,109,49,51,1148,1363
E01000732,11,57,31,77,1299,1475
E01000733,20,76,31,43,1423,1593
E01000769,9,112,52,55,1189,1417
E01000773,13,56,62,56,1334,1521
E01000775,41,143,110,144,1828,2266
E01000777,13,109,64,58,1323,1567
E01000778,10,99,69,96,1306,1580
E01000808,7,19,31,106,1441,1604
E01000810,5,17,34,62,1385,1503
E01000811,5,9,32,68,1206,1320
E01000813,6,31,20,102,1451,1610
E01000815,11,28,29,52,1417,1537
E01000661,15,140,86,91,1262,1594
E01000662,12,117,76,88,1448,1741
E01000663,16,62,59,74,1416,1627
E01000664,8,83,52,73,1394,1610
E01000763,5,22,26,65,1334,1452
E01000764,4,87,31,53,1440,1615
E01000766,10,19,49,45,1591,1714
E01000767,4,26,43,49,1524,1646
E01000834,4,30,42,46,1206,1328
E01000727,6,46,30,63,1408,1553
E01000734,3,69,41,51,1196,1360
E01000790,21,78,69,222,1628,2018
E01000812,8,26,24,111,1328,1497
E01000814,3,18,24,125,1361,1531
E01000723,0,32,8,20,1187,1247
E01000726,9,52,17,47,1157,1282
E01000787,2,53,28,40,1282,1405
E01000788,19,88,54,105,1260,1526
E01000791,6,52,21,63,1303,1445
E01000832,12,48,45,109,1274,1488
E01000835,0,41,52,82,1439,1614
E01000836,12,29,68,45,1265,1419
E01000837,22,61,56,84,1289,1512
E01000838,7,29,53,53,1320,1462
E01000839,3,39,41,50,1355,1488
E01000840,8,35,26,33,1450,1552
E01000841,12,26,39,63,1419,1559
E01000753,11,21,23,62,1689,1806
E01000754,11,17,40,108,1499,1675
E01000755,17,14,34,59,1381,1505
E01000757,2,2,24,53,1418,1499
E01000758,10,23,20,88,1338,1479
E01000786,14,28,24,30,1325,1421
E01000789,5,207,72,84,1432,1800
E01000792,9,112,25,50,946,1142
E01000793,14,6,42,50,1477,1589
E01000795,2,40,50,35,1285,1412
E01000665,18,64,53,76,1604,1815
E01000666,10,26,23,44,1711,1814
E01000667,17,25,31,99,1448,1620
E01000756,12,22,38,107,1384,1563
E01000759,22,13,24,22,1461,1542
E01000760,7,26,35,30,1405,1503
E01000761,3,30,46,31,1442,1552
E01000765,14,33,35,29,1593,1704
E01000768,5,17,33,53,1447,1555
E01000681,18,24,37,83,1543,1705
E01000682,5,31,19,62,1407,1524
E01000683,14,38,42,163,1335,1592
E01000684,25,75,40,191,1705,2036
E01000794,16,23,27,49,1438,1553
E01000749,1,6,32,26,1523,1588
E01000750,10,32,39,51,1360,1492
E01000751,23,53,40,239,1652,2007
E01000752,4,23,22,32,1525,1606
E01000680,6,3,27,44,1529,1609
E01000685,16,32,18,53,1446,1565
E01000686,4,30,13,75,1386,1508
E01000687,3,12,41,49,1498,1603
E01000688,0,20,33,65,1247,1365
E01000654,1,9,24,27,1212,1273
E01000655,9,3,26,21,1264,1323
E01000656,20,21,31,13,1315,1400
E01000657,12,21,18,28,1508,1587
E01000659,2,14,17,13,1416,1462
E01000816,32,191,47,120,1091,1481
E01000818,15,123,49,93,1187,1467
E01000819,34,212,82,101,1281,1710
E01032562,10,221,84,84,1108,1507
E01032563,21,97,46,110,1209,1483
E01000707,11,22,66,31,1325,1455
E01000708,4,84,61,67,1327,1543
E01000771,27,45,99,126,1338,1635
E01000774,12,88,73,84,1216,1473
E01032568,10,143,65,61,1209,1488
E01000658,1,2,9,13,1333,1358
E01000747,7,25,60,23,1805,1920
E01000748,9,12,29,15,1537,1602
E01032570,0,16,21,19,1492,1548
E01001137,20,337,143,165,1104,1769
E01001138,12,287,130,122,1031,1582
E01001156,28,428,134,173,955,1718
E01001162,51,466,156,137,914,1724
E01001164,30,290,154,177,1252,1903
E01001084,40,255,97,497,939,1828
E01001157,31,454,95,410,713,1703
E01001159,38,412,130,297,924,1801
E01001160,61,430,99,704,587,1881
E01001163,55,470,160,197,1057,1939
E01001083,24,314,87,541,643,1609
E01001086,48,496,140,458,608,1750
E01001087,63,529,119,730,754,2195
E01001161,49,628,144,397,631,1849
E01001085,40,432,120,485,529,1606
E01001088,51,567,115,416,560,1709
E01001089,40,493,161,494,719,1907
E01001090,45,679,182,553,828,2287
E01001091,32,340,89,497,627,1585
E01001147,27,647,149,265,534,1622
E01001148,25,709,106,196,577,1613
E01001151,31,579,156,227,607,1600
E01001152,25,704,154,299,489,1671
E01001158,15,491,134,119,805,1564
E01001146,12,812,139,182,470,1615
E01001149,32,675,116,131,618,1572
E01001150,31,644,159,155,666,1655
E01001153,49,743,157,235,435,1619
E01001154,53,853,158,278,627,1969
E01001136,44,622,176,235,803,1880
E01001139,35,559,115,173,720,1602
E01001140,31,421,161,108,892,1613
E01001142,3,572,95,125,731,1526
E01001144,26,658,175,160,654,1673
E01001141,19,489,108,104,526,1246
E01001143,37,802,155,148,799,1941
E01001145,22,648,182,215,619,1686
E01001191,67,716,176,156,649,1764
E01001192,9,667,164,99,705,1644
E01000994,22,558,119,427,466,1592
E01000995,41,528,89,600,373,1631
E01000996,12,499,81,359,303,1254
E01000997,46,431,106,440,373,1396
E01000999,22,354,76,603,277,1332
E01001002,8,532,89,382,332,1343
E01000998,48,586,129,351,437,1551
E01001000,37,463,64,394,309,1267
E01001003,39,597,115,282,478,1511
E01001111,36,648,158,211,554,1607
E01001155,55,723,111,300,414,1603
E01001174,52,464,78,693,333,1620
E01001175,31,573,101,462,375,1542
E01001176,49,549,133,847,324,1902
E01001182,22,419,74,547,360,1422
E01001183,49,510,116,659,238,1572
E01001184,29,460,74,503,283,1349
E01001001,25,531,79,209,351,1195
E01001109,39,637,148,331,884,2039
E01001112,37,707,194,135,645,1718
E01001113,49,733,191,180,675,1828
E01001114,29,586,124,210,451,1400
E01001116,26,477,130,255,471,1359
E01000992,29,579,149,232,989,1978
E01001185,29,362,143,144,958,1636
E01001186,35,650,147,161,752,1745
E01001188,22,704,166,185,756,1833
E01001193,19,631,237,239,681,1807
E01001004,53,823,185,467,601,2129
E01001115,75,547,119,464,501,1706
E01001117,59,816,214,928,744,2761
E01001178,52,481,95,331,406,1365
E01001181,66,586,155,507,515,1829
E01001006,25,419,133,402,579,1558
E01001007,57,396,58,985,472,1968
E01001177,37,444,104,606,426,1617
E01001179,25,375,81,652,401,1534
E01001180,44,459,119,660,455,1737
E01000980,12,349,105,183,758,1407
E01000981,21,337,133,172,979,1642
E01000982,22,290,111,213,968,1604
E01000983,25,239,140,223,1085,1712
E01001187,35,506,202,241,961,1945
E01000989,15,202,114,183,1193,1707
E01000991,15,175,54,187,1218,1649
E01001131,21,130,50,122,1240,1563
E01001132,22,92,52,166,1132,1464
E01001134,22,106,86,216,1187,1617
E01001005,41,396,55,819,376,1687
E01001008,49,359,128,486,586,1608
E01001009,33,511,126,794,382,1846
E01001010,17,357,107,306,727,1514
E01001011,66,455,150,732,465,1868
E01001012,62,548,141,675,496,1922
E01001013,100,586,178,471,683,2018
E01001048,69,434,157,567,715,1942
E01001110,38,596,149,364,640,1787
E01001118,45,641,175,373,648,1882
E01000985,22,162,69,174,1020,1447
E01000986,25,229,136,252,1096,1738
E01000987,14,159,90,178,990,1431
E01000993,24,233,101,176,1086,1620
E01000975,33,178,129,384,889,1613
E01000976,47,305,144,407,964,1867
E01000977,34,315,144,303,935,1731
E01000978,30,268,107,350,1020,1775
E01000979,36,160,115,413,979,1703
E01000984,44,308,214,320,943,1829
E01001044,32,182,73,562,1073,1922
E01001046,64,62,55,860,710,1751
E01001049,23,119,63,516,698,1419
E01001050,35,162,66,549,834,1646
E01001014,56,624,293,602,1088,2663
E01001042,51,325,183,246,1013,1818
E01001165,39,353,111,221,932,1656
E01001166,52,358,163,220,1021,1814
E01001168,36,293,147,244,1017,1737
E01001127,18,135,54,171,1229,1607
E01001128,29,444,80,179,879,1611
E01001130,32,709,140,209,686,1776
E01001135,25,132,81,220,1188,1646
E01001062,15,140,77,240,1095,1567
E01001063,8,132,78,186,1135,1539
E01001064,10,92,36,313,1117,1568
E01001129,16,100,56,123,1160,1455
E01001133,13,109,66,192,1177,1557
E01001035,31,240,94,306,1089,1760
E01001043,66,486,216,515,1295,2578
E01001045,23,228,92,412,1065,1820
E01001047,40,206,103,234,1090,1673
E01001170,59,351,150,283,1207,2050
E01001167,68,418,163,416,1128,2193
E01001169,25,355,123,254,923,1680
E01001171,23,340,106,309,860,1638
E01001172,46,347,137,237,981,1748
E01001173,71,490,181,423,1396,2561
E01001036,21,87,76,296,1041,1521
E01001037,27,210,116,144,899,1396
E01001038,34,230,111,245,1172,1792
E01001039,8,81,63,194,1128,1474
E01001040,35,163,129,161,1220,1708
E01001051,25,380,110,44,990,1549
E01001052,9,392,100,50,896,1447
E01001054,16,393,89,47,1165,1710
E01001056,16,450,169,89,1127,1851
E01001057,22,502,192,117,981,1814
E01001033,29,177,104,257,1049,1616
E01001034,17,156,116,140,1087,1516
E01001041,40,239,151,158,1023,1611
E01001095,29,195,74,200,970,1468
E01001100,19,131,53,148,1122,1473
E01001053,16,205,68,56,1168,1513
E01001055,9,254,71,57,1204,1595
E01001077,15,120,31,65,1165,1396
E01001078,18,221,52,60,1053,1404
E01001082,15,245,74,32,1261,1627
E01001120,8,108,44,120,983,1263
E01001122,9,124,47,286,1073,1539
E01001123,17,94,47,151,1205,1514
E01001124,5,44,45,148,1331,1573
E01001125,22,106,46,269,1207,1650
E01001058,8,105,40,96,1077,1326
E01001059,19,93,60,71,1153,1396
E01001060,6,138,71,96,1270,1581
E01001061,22,157,85,104,1165,1533
E01001065,11,82,39,76,1126,1334
E01001066,31,324,83,108,823,1369
E01001119,13,58,20,57,1322,1470
E01001126,8,63,59,80,1192,1402
E01001032,14,39,46,159,1138,1396
E01001101,16,46,48,128,1185,1423
E01001102,13,57,48,177,1168,1463
E01001107,14,81,79,257,1185,1616
E01001108,16,69,81,170,1375,1711
E01001076,20,216,119,75,1176,1606
E01001079,10,249,74,39,1309,1681
E01001080,35,306,87,59,1191,1678
E01001081,10,189,67,59,1084,1409
E01001073,8,86,84,194,1069,1441
E01001092,25,141,79,356,1176,1777
E01001093,62,200,137,340,999,1738
E01001096,12,116,105,211,1090,1534
E01001097,48,182,173,288,1412,2103
E01001098,13,73,81,170,1115,1452
E01001028,25,76,84,439,1006,1630
E01001029,20,105,70,302,1096,1593
E01001030,17,125,78,269,922,1411
E01001031,22,67,66,194,1117,1466
E01001094,25,47,57,413,1043,1585
E01001103,16,54,65,163,1382,1680
E01001105,8,113,74,74,1460,1729
E01001106,15,81,65,118,1211,1490
E01001121,14,31,27,140,1096,1308
E01001069,13,75,48,186,1063,1385
E01001070,23,200,95,180,1228,1726
E01001075,9,84,71,117,1266,1547
E01001099,25,126,102,159,1065,1477
E01001015,3,117,97,75,1148,1440
E01001016,36,110,82,136,1341,1705
E01001023,16,117,82,196,903,1314
E01001067,27,95,85,240,1184,1631
E01001074,39,190,152,213,1339,1933
E01001068,25,178,102,119,1500,1924
E01001071,19,100,89,101,1582,1891
E01001072,20,36,30,141,1261,1488
E01001104,25,86,53,177,1324,1665
E01001017,9,39,42,101,1433,1624
E01001024,6,82,77,121,1142,1428
E01001025,10,58,39,97,1092,1296
E01001026,8,70,77,54,1520,1729
E01001027,18,68,78,162,1256,1582
E01001018,6,31,48,39,1432,1556
E01001019,9,64,64,71,1303,1511
E01001020,12,83,83,90,1362,1630
E01001021,14,98,106,41,1073,1332
E01001022,5,47,49,83,1262,1446
E01000990,34,349,111,126,800,1420
E01001189,18,362,110,142,579,1211
E01001190,29,629,160,112,656,1586
E01001194,22,507,125,103,815,1572
E01032569,22,466,186,134,923,1731
E01001269,111,224,69,593,986,1983
E01001271,65,237,45,583,874,1804
E01001309,66,222,66,651,825,1830
E01001310,53,327,85,561,775,1801
E01001311,99,284,89,537,1073,2082
E01001307,82,199,57,595,900,1833
E01001308,126,159,68,929,760,2042
E01001312,96,149,39,835,720,1839
E01001313,69,177,45,811,599,1701
E01001314,84,151,62,525,763,1585
E01001315,35,251,79,490,606,1461
E01001316,77,338,68,444,656,1583
E01001317,98,286,87,482,909,1862
E01001318,124,248,92,437,889,1790
E01001320,98,338,74,314,724,1548
E01001321,103,315,94,449,1060,2021
E01001270,78,222,63,458,900,1721
E01001319,86,175,40,441,756,1498
E01001322,41,179,67,496,909,1692
E01001323,79,215,53,550,831,1728
E01001341,171,140,54,764,583,1712
E01001342,189,116,54,822,686,1867
E01001343,115,92,79,568,650,1504
E01001345,98,126,65,848,543,1680
E01001265,80,177,93,445,897,1692
E01001266,170,154,61,556,891,1832
E01001267,110,309,91,498,945,1953
E01001272,115,167,55,501,790,1628
E01001349,125,251,60,325,643,1404
E01001344,218,218,95,536,1094,2161
E01001346,229,129,77,394,1049,1878
E01001347,127,148,49,381,829,1534
E01001348,203,111,60,334,891,1599
E01001257,94,400,122,434,733,1783
E01001324,87,267,83,418,698,1553
E01001326,80,322,100,398,819,1719
E01001330,84,322,57,425,710,1598
E01001332,66,359,102,388,588,1503
E01001325,62,310,94,363,929,1758
E01001327,152,239,91,467,854,1803
E01001328,117,381,98,392,742,1730
E01001329,110,266,90,482,835,1783
E01001331,112,461,110,374,617,1674
E01001258,94,189,73,526,808,1690
E01001262,76,306,89,371,750,1592
E01001263,93,318,88,463,710,1672
E01001264,119,219,79,400,838,1655
E01032743,190,426,183,670,704,2173
E01032744,71,239,59,620,537,1526
E01001276,269,137,69,346,967,1788
E01001277,209,91,103,479,962,1844
E01001278,290,116,62,569,925,1962
E01001280,190,84,87,344,1035,1740
E01001218,104,382,78,708,636,1908
E01001260,169,140,54,697,839,1899
E01001261,145,262,95,708,968,2178
E01001268,162,112,74,360,1028,1736
E01001209,73,41,79,156,1363,1712
E01001211,86,61,91,214,1250,1702
E01001279,119,26,58,226,1044,1473
E01001281,58,35,76,172,1259,1600
E01001217,64,160,58,842,415,1539
E01001259,74,142,42,559,640,1457
E01001291,125,182,57,845,433,1642
E01001292,117,192,91,821,487,1708
E01001293,119,174,32,1029,244,1598
E01001196,163,335,139,246,883,1766
E01001238,349,436,187,593,1303,2868
E01001239,110,404,120,234,674,1542
E01001246,93,305,99,154,709,1360
E01001247,209,231,130,428,1172,2170
E01001210,148,309,101,368,753,1679
E01001282,104,193,90,255,915,1557
E01001283,129,193,100,269,904,1595
E01001285,78,207,126,241,1038,1690
E01001286,85,179,93,267,1050,1674
E01001287,94,388,78,266,611,1437
E01001294,135,99,60,1404,196,1894
E01001295,98,119,43,1357,209,1826
E01001296,117,104,45,990,225,1481
E01001297,112,95,25,1389,193,1814
E01001298,99,164,58,1307,306,1934
E01001204,95,92,86,256,1060,1589
E01001205,105,289,90,253,822,1559
E01001206,133,590,118,295,578,1714
E01001207,70,103,76,192,1129,1570
E01001208,70,43,64,143,1046,1366
E01001212,111,62,59,249,1186,1667
E01001222,143,200,140,432,1469,2384
E01001224,45,26,84,141,1320,1616
E01001226,74,95,84,259,1023,1535
E01001227,56,44,81,272,1061,1514
E01001228,85,79,89,304,1255,1812
E01001221,81,50,106,333,1291,1861
E01001223,45,41,52,256,1123,1517
E01001225,91,92,91,309,1207,1790
E01001235,71,71,69,280,1106,1597
E01001236,45,135,83,248,1079,1590
E01001273,142,50,72,533,826,1623
E01001274,197,51,86,697,599,1630
E01001275,90,171,95,306,1239,1901
E01001195,309,133,65,440,886,1833
E01001197,122,139,74,408,1010,1753
E01001198,59,147,91,115,1028,1440
E01001199,125,237,98,201,1043,1704
E01001284,63,105,72,244,1055,1539
E01001288,59,131,104,176,1028,1498
E01001289,39,134,81,183,946,1383
E01001290,63,139,90,246,1318,1856
E01001213,93,144,42,1384,167,1830
E01001214,121,108,14,1354,152,1749
E01001215,86,151,56,1297,175,1765
E01001216,72,141,34,1106,211,1564
E01001361,77,182,34,1382,127,1802
E01001240,184,246,102,302,781,1615
E01001241,282,123,86,239,771,1501
E01001242,299,168,55,178,755,1455
E01001243,278,328,77,259,800,1742
E01001244,247,500,121,556,1115,2539
E01001245,84,184,106,281,1259,1914
E01001200,101,133,67,192,1023,1516
E01001201,50,105,97,161,1148,1561
E01001202,226,310,113,343,1128,2120
E01001203,160,175,99,197,1103,1734
E01001351,109,249,106,323,1207,1994
E01001359,120,139,57,1807,78,2201
E01001360,84,65,31,1671,72,1923
E01001362,70,98,25,1589,153,1935
E01001363,63,147,28,1350,97,1685
E01001364,53,214,35,1181,193,1676
E01001365,63,132,37,1864,121,2217
E01001231,179,53,66,406,1162,1866
E01001234,69,92,102,237,901,1401
E01001350,108,64,76,231,1007,1486
E01001352,110,76,59,232,1033,1510
E01001354,84,99,84,279,1294,1840
E01001249,174,422,140,484,1150,2370
E01001250,120,297,86,302,1236,2041
E01001255,24,135,93,241,1117,1610
E01001383,58,119,79,317,1218,1791
E01001388,83,206,107,222,1022,1640
E01001389,70,99,59,321,1118,1667
E01001219,119,657,88,770,412,2046
E01001220,85,457,73,569,325,1509
E01001334,107,351,64,928,173,1623
E01001337,67,281,83,491,548,1470
E01001338,148,205,35,1316,249,1953
E01001339,115,387,93,884,362,1841
E01001340,90,496,137,435,731,1889
E01001251,54,130,66,221,1183,1654
E01001252,81,190,105,318,1244,1938
E01001253,53,137,80,191,1188,1649
E01001254,38,90,105,127,1325,1685
E01001229,73,169,114,166,1000,1522
E01001230,40,116,80,145,1107,1488
E01001232,73,124,91,242,1008,1538
E01001233,45,115,62,223,979,1424
E01001237,43,44,57,183,1266,1593
E01001386,24,66,80,140,1483,1793
E01001303,45,46,85,145,1318,1639
E01001382,42,60,80,165,1219,1566
E01001384,39,78,103,245,1180,1645
E01001385,27,44,107,199,1305,1682
E01001387,57,62,56,202,1169,1546
E01001353,101,221,80,214,1051,1667
E01001355,78,187,94,192,1113,1664
E01001356,184,654,126,318,687,1969
E01001357,95,319,42,194,491,1141
E01001358,172,524,85,300,521,1602
E01001375,18,18,61,109,1459,1665
E01001377,45,56,70,105,1494,1770
E01001379,18,22,68,106,1465,1679
E01001381,109,122,104,133,1181,1649
E01001248,76,141,81,272,1022,1592
E01001299,35,77,94,253,1374,1833
E01001305,49,71,47,238,1311,1716
E01001306,28,42,77,165,1295,1607
E01001366,120,221,37,1413,132,1923
E01001367,105,188,40,1275,156,1764
E01001368,103,191,29,1270,130,1723
E01001370,95,164,38,1484,199,1980
E01001371,112,340,51,1386,192,2081
E01001372,116,236,26,1237,148,1763
E01001373,62,192,43,1092,110,1499
E01001333,93,248,41,1298,223,1903
E01001335,112,67,48,1142,412,1781
E01001336,150,104,35,900,383,1572
E01001369,106,193,43,1314,190,1846
E01001300,34,54,91,194,1319,1692
E01001301,39,108,74,269,1292,1782
E01001302,22,94,89,197,1219,1621
E01001304,42,84,74,172,1255,1627
E01001374,45,170,70,148,1365,1798
E01001376,66,176,80,203,1054,1579
E01001380,25,80,79,153,1422,1759
E01032572,34,82,79,142,1238,1575
E01001444,73,359,102,87,1055,1676
E01001446,92,384,86,95,1160,1817
E01001546,80,352,108,82,1161,1783
E01001552,59,334,83,107,1222,1805
E01001442,62,418,114,106,984,1684
E01001545,76,412,106,144,1105,1843
E01001547,87,372,90,149,1060,1758
E01001548,79,426,111,121,1082,1819
E01001551,75,313,116,76,1153,1733
E01001445,126,580,170,190,1218,2284
E01001447,96,434,88,144,1174,1936
E01001448,129,561,116,111,914,1831
E01001449,74,420,89,105,947,1635
E01033148,110,670,125,156,889,1950
E01033150,86,509,182,172,707,1656
E01001408,19,101,59,74,1393,1646
E01001411,27,70,98,128,1517,1840
E01001412,53,152,57,79,1493,1834
E01001413,13,41,43,41,1494,1632
E01001414,65,164,100,138,1096,1563
E01001407,48,137,82,78,1292,1637
E01001409,81,307,116,223,1162,1889
E01001410,91,315,96,121,1098,1721
E01001516,87,334,124,201,1088,1834
E01001537,31,156,102,77,1388,1754
E01001439,122,462,147,184,1160,2075
E01001441,94,385,71,81,883,1514
E01001517,161,465,106,131,1027,1890
E01001549,135,498,152,146,1044,1975
E01001550,66,263,104,130,1098,1661
E01001433,56,339,133,118,1181,1827
E01001434,133,256,81,112,990,1572
E01001435,86,314,87,134,859,1480
E01001436,115,395,113,136,1127,1886
E01001438,83,421,115,110,930,1659
E01001469,53,116,67,144,1265,1645
E01001536,21,73,74,61,1488,1717
E01001540,21,103,66,135,1438,1763
E01001541,38,55,98,44,1269,1504
E01001542,32,148,97,99,1195,1571
E01001538,38,96,54,69,1403,1660
E01001539,36,91,77,82,1382,1668
E01001543,47,112,73,109,1331,1672
E01001544,54,67,47,103,1326,1597
E01001457,41,66,49,126,1351,1633
E01001468,39,119,67,151,963,1339
E01001471,46,85,51,164,1391,1737
E01001472,26,71,66,101,1418,1682
E01001474,27,64,67,141,1468,1767
E01001415,63,73,37,169,1199,1541
E01001417,51,92,68,237,1526,1974
E01001418,89,95,52,192,1222,1650
E01001422,48,67,72,214,1257,1658
E01001440,120,340,117,171,893,1641
E01001504,104,339,82,209,815,1549
E01001505,104,381,84,368,790,1727
E01001507,124,578,67,269,832,1870
E01001508,128,565,112,306,822,1933
E01001513,40,252,113,199,1166,1770
E01001416,58,55,67,297,1256,1733
E01001470,48,39,55,98,1358,1598
E01001473,66,105,69,135,1159,1534
E01001475,80,35,46,258,1285,1704
E01001437,144,584,172,232,1241,2373
E01001506,97,522,99,255,662,1635
E01001509,121,469,114,306,728,1738
E01001510,101,425,124,204,642,1496
E01001405,68,93,75,88,1367,1691
E01001406,77,215,98,102,1137,1629
E01001450,77,181,86,115,1419,1878
E01001512,63,152,119,112,1334,1780
E01001515,134,493,144,167,1008,1946
E01001401,51,110,65,140,957,1323
E01001478,76,280,91,172,919,1538
E01001484,78,221,77,154,841,1371
E01001511,56,187,101,230,1177,1751
E01001514,68,251,114,122,1213,1768
E01001518,65,203,95,160,1244,1767
E01001451,26,83,48,97,1387,1641
E01001452,56,50,46,145,1059,1356
E01001453,47,70,57,162,1341,1677
E01001454,49,54,72,142,1316,1633
E01001476,110,421,98,177,860,1666
E01001477,146,518,90,209,887,1850
E01001481,95,487,48,238,779,1647
E01001502,117,506,113,272,864,1872
E01001503,97,405,97,286,959,1844
E01001520,83,93,104,265,1135,1680
E01001522,95,131,138,230,1211,1805
E01001523,73,64,89,195,1318,1739
E01001524,84,175,77,283,912,1531
E01001526,56,65,60,206,1232,1619
E01001419,64,83,84,316,1399,1946
E01001420,63,101,89,183,1134,1570
E01001421,63,122,103,263,1165,1716
E01001519,131,171,135,525,1534,2496
E01001525,83,108,84,233,1299,1807
E01001398,22,106,78,87,1099,1392
E01001399,58,132,45,141,1061,1437
E01001400,39,112,56,152,1184,1543
E01001402,75,88,66,236,1368,1833
E01001403,57,191,73,180,1101,1602
E01001455,43,125,54,103,1166,1491
E01001456,27,50,49,92,1182,1400
E01001564,56,64,79,103,1364,1666
E01001567,27,56,63,117,1320,1583
E01001568,84,72,34,170,1223,1583
E01001569,85,99,101,110,1349,1744
E01001479,139,538,105,200,748,1730
E01001482,151,627,105,239,732,1854
E01001487,111,674,111,290,763,1949
E01001489,121,544,87,232,819,1803
E01001491,163,726,98,261,728,1976
E01001459,144,412,101,212,806,1675
E01001460,113,605,120,225,648,1711
E01001462,102,443,117,187,490,1339
E01001480,139,317,96,200,797,1549
E01001488,72,659,125,263,764,1883
E01001483,117,355,92,105,481,1150
E01001485,121,573,134,221,766,1815
E01001486,136,717,144,228,881,2106
E01001492,131,593,131,261,814,1930
E01033146,123,525,120,160,658,1586
E01033151,89,533,125,129,607,1483
E01001404,64,204,58,228,919,1473
E01001493,95,207,81,188,1202,1773
E01001494,113,182,98,247,880,1520
E01001496,132,173,86,233,1081,1705
E01001570,92,192,105,172,1294,1855
E01001423,144,460,100,317,784,1805
E01001425,131,652,103,229,747,1862
E01001428,139,430,118,251,739,1677
E01001461,126,544,89,220,737,1716
E01001464,76,285,72,151,746,1330
E01001521,69,50,125,289,1244,1777
E01001531,59,44,79,135,1181,1498
E01001532,56,75,112,173,1348,1764
E01001533,83,51,39,205,1190,1568
E01001535,48,71,76,293,994,1482
E01001495,44,118,104,122,1327,1715
E01001498,136,149,122,262,1277,1946
E01001563,79,120,110,130,1176,1615
E01001565,97,111,101,207,1120,1636
E01001566,62,71,90,132,1366,1721
E01001424,70,447,55,158,480,1210
E01001426,124,591,87,246,773,1821
E01001427,135,742,97,212,654,1840
E01001429,108,929,178,286,893,2394
E01001430,114,770,134,204,662,1884
E01001463,107,303,74,291,798,1573
E01001465,120,281,73,247,784,1505
E01001466,160,452,95,239,849,1795
E01001467,148,518,101,291,816,1874
E01001497,79,211,58,196,932,1476
E01001499,123,196,67,346,918,1650
E01001392,64,131,92,352,1185,1824
E01001528,63,271,114,250,747,1445
E01001529,73,204,88,260,921,1546
E01001530,63,76,84,329,738,1290
E01001534,74,120,60,372,1005,1631
E01001431,112,464,132,161,680,1549
E01001432,118,746,137,240,666,1907
E01001555,113,607,137,301,625,1783
E01001557,89,534,79,224,660,1586
E01001558,181,503,121,236,572,1613
E01001559,113,754,133,199,852,2051
E01001394,156,214,82,252,949,1653
E01001395,145,240,109,237,859,1590
E01001397,139,220,98,425,1042,1924
E01001500,124,117,92,198,996,1527
E01001556,107,233,86,229,924,1579
E01001560,158,320,82,275,764,1599
E01001390,62,120,117,366,1306,1971
E01001391,71,225,93,161,1014,1564
E01001393,74,217,136,348,1337,2112
E01001396,101,127,49,196,940,1413
E01001501,91,228,110,244,1177,1850
E01001527,52,123,94,204,1090,1563
E01001458,121,573,126,171,754,1745
E01001553,139,412,105,199,742,1597
E01001554,153,598,135,169,736,1791
E01001562,161,601,106,220,628,1716
E01032574,142,650,118,347,802,2059
E01001690,37,724,79,51,1041,1932
E01001692,17,499,58,66,751,1391
E01001693,10,688,82,95,683,1558
E01001694,27,764,75,59,760,1685
E01001687,27,381,71,142,585,1206
E01001688,32,1174,146,213,1058,2623
E01033739,23,652,79,139,550,1443
E01033740,47,654,92,237,547,1577
E01033741,52,915,165,281,1044,2457
E01033743,26,1154,121,144,593,2038
E01033745,38,837,85,112,748,1820
E01001575,19,654,86,107,841,1707
E01001576,33,596,73,73,964,1739
E01001577,34,661,94,119,949,1857
E01001578,43,726,85,196,1081,2131
E01001579,17,524,62,131,912,1646
E01001709,22,287,73,152,636,1170
E01001711,25,364,86,248,690,1413
E01001712,53,675,113,260,1036,2137
E01033731,27,161,72,133,624,1017
E01033734,24,233,89,142,832,1320
E01033735,46,281,68,181,497,1073
E01033736,24,124,61,130,786,1125
E01033737,67,470,69,280,609,1495
E01001705,33,727,134,220,879,1993
E01001706,11,370,96,255,608,1340
E01001708,15,205,82,134,1159,1595
E01001710,43,637,85,248,681,1694
E01001713,25,682,104,222,715,1748
E01001672,27,491,91,783,657,2049
E01001673,55,429,69,729,610,1892
E01001674,50,463,92,598,770,1973
E01001675,34,424,68,860,594,1980
E01001677,30,473,144,485,816,1948
E01001631,49,737,119,372,795,2072
E01001632,42,566,109,959,643,2319
E01001635,66,312,88,285,910,1661
E01001636,68,346,84,510,714,1722
E01033742,44,423,81,186,618,1352
E01033744,34,613,82,235,881,1845
E01001571,46,397,87,239,870,1639
E01001572,24,445,87,153,1002,1711
E01001573,30,325,84,263,803,1505
E01001574,32,470,120,135,1012,1769
E01001629,31,690,140,276,1039,2176
E01001633,35,465,97,224,786,1607
E01001634,36,490,88,171,929,1714
E01001637,32,343,95,372,861,1703
E01001695,23,452,93,398,660,1626
E01001696,39,546,79,205,481,1350
E01001697,43,611,120,452,868,2094
E01001700,54,551,120,538,756,2019
E01001703,30,980,78,334,512,1934
E01001704,43,352,88,279,889,1651
E01001588,19,216,82,258,1117,1692
E01001589,30,176,67,253,1078,1604
E01001591,38,458,131,244,1169,2040
E01001595,36,443,113,354,1033,1979
E01001590,35,184,116,312,1130,1777
E01001592,17,147,87,202,1265,1718
E01001593,17,85,66,79,1391,1638
E01001594,35,522,129,255,996,1937
E01001698,19,728,147,196,687,1777
E01001699,56,505,97,160,1030,1848
E01001701,39,345,65,107,968,1524
E01001702,45,694,103,271,563,1676
E01001581,30,116,71,115,1361,1693
E01001585,19,72,63,92,1286,1532
E01001586,17,145,71,77,1181,1491
E01001587,39,102,85,100,1564,1890
E01001678,16,277,78,194,1102,1667
E01001683,56,240,88,226,909,1519
E01001684,27,293,53,168,931,1472
E01001685,50,217,57,180,1018,1522
E01001646,39,576,191,308,1715,2829
E01001650,44,208,43,294,1144,1733
E01001651,38,310,95,208,1063,1714
E01001652,19,133,66,189,1148,1555
E01001679,21,244,75,83,923,1346
E01001680,46,117,62,152,1196,1573
E01001681,7,195,82,113,827,1224
E01001682,34,179,81,84,955,1333
E01001686,19,414,122,152,1070,1777
E01001580,17,60,51,111,1403,1642
E01001582,38,128,50,112,1147,1475
E01001583,8,74,64,75,1382,1603
E01001584,8,46,61,60,1374,1549
E01001645,43,299,85,142,1128,1697
E01001647,30,195,63,260,943,1491
E01001648,40,192,111,222,1186,1751
E01001649,25,206,48,88,1163,1530
E01001605,9,51,28,81,1415,1584
E01001606,18,24,42,84,1469,1637
E01001610,13,64,46,102,1444,1669
E01001611,17,65,62,52,1463,1659
E01001620,39,179,44,148,1181,1591
E01001621,16,89,67,77,1242,1491
E01001623,36,190,59,139,1272,1696
E01001624,10,84,32,65,1360,1551
E01001625,32,145,45,79,1276,1577
E01001604,13,22,48,109,1248,1440
E01001607,7,31,41,74,1321,1474
E01001608,3,21,30,35,1365,1454
E01001609,12,90,44,77,1379,1602
E01001613,30,90,43,88,1335,1586
E01001614,17,21,13,78,1280,1409
E01001615,29,112,55,129,1194,1519
E01001617,14,50,42,93,1375,1574
E01001653,8,128,79,70,1262,1547
E01001654,45,217,79,57,1148,1546
E01001655,11,165,63,43,1183,1465
E01001660,44,224,76,161,1095,1600
E01001661,60,122,43,113,1187,1525
E01001618,23,64,41,81,1395,1604
E01001619,15,90,61,140,1574,1880
E01033729,29,238,140,285,2277,2969
E01001597,56,116,68,146,1174,1560
E01001598,53,125,27,128,1254,1587
E01001602,36,146,81,58,1552,1873
E01001603,17,159,54,55,1370,1655
E01001596,34,58,49,113,1310,1564
E01001599,36,128,48,113,1376,1701
E01001600,22,108,47,95,1289,1561
E01001601,23,76,33,78,1351,1561
E01001669,33,475,106,174,1086,1874
E01001671,23,262,86,121,1086,1578
E01001676,39,576,87,279,810,1791
E01032567,22,321,91,180,1037,1651
E01001656,16,89,48,54,1065,1272
E01001657,46,111,55,90,1245,1547
E01001658,35,172,55,131,1156,1549
E01001659,45,197,69,224,919,1454
E01033726,81,506,108,284,1514,2493
E01001640,68,524,163,307,1272,2334
E01033727,68,558,176,463,1302,2567
E01033728,16,72,49,210,879,1226
E01033730,30,121,84,132,847,1214
E01001666,36,216,63,399,756,1470
E01001667,22,272,103,232,935,1564
E01001668,43,297,92,135,1702,2269
E01033732,21,111,100,258,563,1053
E01033733,21,37,50,336,690,1134
E01001662,22,71,102,73,1340,1608
E01001664,20,85,89,188,1488,1870
E01001665,37,124,101,191,1414,1867
E01033738,16,94,52,184,870,1216
E01001638,39,524,142,224,1045,1974
E01001641,35,204,91,133,1292,1755
E01001642,8,89,77,51,1556,1781
E01001644,38,222,128,206,1618,2212
E01033746,15,79,70,82,1218,1464
E01002112,42,77,32,686,1053,1890
E01002114,56,132,77,596,1132,1993
E01002225,33,37,24,300,1181,1575
E01002226,79,133,72,686,1258,2228
E01002113,43,111,48,470,875,1547
E01002115,33,94,61,627,694,1509
E01002116,65,69,35,508,991,1668
E01002117,108,204,68,955,770,2105
E01002118,63,183,79,512,922,1759
E01002227,96,246,90,451,926,1809
E01002228,87,172,89,747,1010,2105
E01002229,51,141,73,432,1020,1717
E01002230,41,84,50,643,977,1795
E01002144,43,121,52,482,873,1571
E01002146,21,30,53,501,876,1481
E01002147,23,23,19,512,792,1369
E01002149,17,11,37,562,734,1361
E01002140,31,204,81,499,891,1706
E01002141,66,110,69,504,1014,1763
E01002142,61,121,94,631,872,1779
E01002143,49,155,96,594,677,1571
E01002145,53,134,59,423,889,1558
E01002139,75,209,65,415,664,1428
E01002148,40,88,52,506,763,1449
E01002150,31,94,86,560,1112,1883
E01002151,74,196,101,355,800,1526
E01002152,19,37,44,543,981,1624
E01002119,67,227,61,689,664,1708
E01002120,63,240,64,403,526,1296
E01002121,63,149,68,875,606,1761
E01002122,36,157,69,787,657,1706
E01002123,64,154,39,805,673,1735
E01002106,92,136,74,850,875,2027
E01002108,54,102,28,1002,633,1819
E01002109,59,53,67,547,1063,1789
E01002110,27,60,43,925,707,1762
E01002111,74,194,74,1065,765,2172
E01002185,41,207,76,479,740,1543
E01002186,36,102,74,455,989,1656
E01002187,22,90,68,639,1024,1843
E01002190,30,34,37,606,965,1672
E01002124,51,150,46,1105,417,1769
E01002125,70,133,46,924,505,1678
E01002198,36,95,48,1197,444,1820
E01002200,67,93,41,1056,431,1688
E01002203,60,145,49,1062,435,1751
E01002232,72,229,83,758,831,1973
E01002233,114,299,110,783,725,2031
E01002234,68,299,82,633,659,1741
E01002235,113,318,56,732,703,1922
E01002236,87,248,99,797,572,1803
E01002107,48,115,63,903,645,1774
E01002197,23,65,24,838,444,1394
E01002199,24,104,54,997,354,1533
E01002201,43,113,43,1222,321,1742
E01002202,88,184,98,1117,569,2056
E01002179,99,364,124,925,738,2250
E01002180,79,331,122,779,774,2085
E01002183,81,306,53,960,706,2106
E01002184,50,241,93,722,779,1885
E01002231,77,295,58,717,777,1924
E01002154,62,156,83,778,942,2021
E01002156,31,71,42,577,801,1522
E01002162,82,175,120,638,864,1879
E01002163,35,140,70,700,691,1636
E01002188,22,24,49,229,1327,1651
E01002189,36,43,72,342,1168,1661
E01002192,23,26,52,428,1003,1532
E01002193,13,112,92,448,1132,1797
E01002165,42,102,36,1109,445,1734
E01002166,29,99,28,1137,370,1663
E01002167,59,100,40,968,462,1629
E01002168,46,149,73,730,494,1492
E01002169,34,104,66,1011,404,1619
E01002153,27,83,62,814,777,1763
E01002155,35,31,51,565,961,1643
E01002157,38,147,89,827,586,1687
E01002158,30,52,52,608,715,1457
E01002128,69,193,77,654,1032,2025
E01002130,98,216,108,1005,833,2260
E01002181,31,166,88,780,819,1884
E01002182,93,161,103,965,727,2049
E01002159,51,108,96,822,783,1860
E01002160,50,215,137,706,859,1967
E01002161,72,186,95,1011,666,2030
E01002164,66,138,107,476,976,1763
E01002191,30,67,76,934,857,1964
E01002194,21,46,57,409,1191,1724
E01002195,29,28,62,588,928,1635
E01002196,17,33,46,585,1078,1759
E01002126,107,189,127,1335,1023,2781
E01002127,73,77,56,819,662,1687
E01002129,44,222,133,673,971,2043
E01002131,45,210,80,657,632,1624
E01002237,36,203,100,470,817,1626
E01002238,61,108,78,687,870,1804
E01002240,33,170,79,534,923,1739
E01002242,65,100,73,1010,642,1890
E01002208,28,41,33,540,715,1357
E01002209,41,76,48,833,645,1643
E01002239,36,123,55,671,793,1678
E01002241,78,162,80,771,545,1636
E01002133,103,316,138,762,712,2031
E01002136,79,150,97,674,741,1741
E01002138,58,181,80,756,476,1551
E01002213,75,375,139,1370,953,2912
E01002211,30,243,103,590,578,1544
E01002212,50,200,81,883,535,1749
E01002216,31,115,60,1052,441,1699
E01002217,53,398,70,538,467,1526
E01002132,58,102,118,692,1042,2012
E01002134,62,70,55,549,726,1462
E01002135,51,167,87,677,783,1765
E01002137,15,53,71,236,1333,1708
E01002218,48,153,101,771,574,1647
E01002219,35,147,55,1059,517,1813
E01002221,55,152,96,733,528,1564
E01002222,44,221,70,736,537,1608
E01002214,63,188,64,887,661,1863
E01002215,42,218,62,525,688,1535
E01002220,67,207,63,683,608,1628
E01002223,57,188,93,973,562,1873
E01002224,44,262,86,528,610,1530
E01002204,49,102,56,1042,487,1736
E01002206,34,81,47,803,422,1387
E01002207,48,111,51,982,538,1730
E01002210,30,90,56,952,476,1604
E01032576,41,87,70,912,557,1667
E01002170,73,79,62,751,359,1324
E01002171,43,137,22,1049,426,1677
E01002172,41,162,68,758,550,1579
E01002173,22,144,55,1060,461,1742
E01002174,34,81,29,1067,371,1582
E01002175,26,62,34,955,325,1402
E01002176,40,151,54,1061,440,1746
E01002177,27,102,34,818,462,1443
E01002178,26,113,61,1026,453,1679
E01002276,16,107,37,55,1711,1926
E01002278,9,73,24,45,1448,1599
E01002312,2,82,15,30,1271,1400
E01002313,5,114,43,53,1311,1526
E01002277,2,47,19,37,1389,1494
E01002279,5,110,36,26,1407,1584
E01002281,5,95,38,38,1438,1614
E01002283,6,172,26,35,1278,1517
E01002299,11,99,22,78,1511,1721
E01002301,1,58,33,69,1400,1561
E01002303,9,160,63,82,1729,2043
E01002304,1,40,31,38,1304,1414
E01002306,9,130,42,97,1318,1596
E01002307,7,84,39,35,1508,1673
E01002280,8,172,52,46,1244,1522
E01002282,6,122,54,50,1362,1594
E01002284,5,186,55,67,1529,1842
E01002297,13,119,34,46,1272,1484
E01002314,13,170,50,37,1386,1656
E01002316,10,219,80,28,1208,1545
E01002302,0,60,23,57,1423,1563
E01002305,6,99,27,56,1331,1519
E01002308,14,82,33,71,1431,1631
E01002326,4,62,41,46,1343,1496
E01002331,10,78,26,74,1385,1573
E01002309,11,164,26,82,1256,1539
E01002310,9,149,34,46,1439,1677
E01002311,8,158,48,62,1414,1690
E01002315,21,172,38,67,1239,1537
E01002293,2,57,40,74,1418,1591
E01002294,4,41,27,36,1384,1492
E01002296,5,36,24,72,1536,1673
E01002298,7,56,29,48,1398,1538
E01002300,12,43,26,79,1433,1593
E01002333,4,41,10,30,1235,1320
E01002334,1,38,31,68,1525,1663
E01002336,3,39,23,37,1390,1492
E01002339,7,57,36,44,1466,1610
E01002341,8,20,16,57,1271,1372
E01002327,6,73,17,73,1307,1476
E01002328,11,72,34,120,1448,1685
E01002332,8,79,27,23,1494,1631
E01002335,2,21,9,57,1356,1445
E01002338,4,66,29,83,1189,1371
E01002340,11,58,26,66,1220,1381
E01002268,10,76,18,89,1157,1350
E01002269,3,54,27,109,1592,1785
E01002295,5,36,17,75,1425,1558
E01002377,5,58,37,142,1396,1638
E01002378,2,46,35,45,1550,1678
E01002383,16,58,25,87,1393,1579
E01002244,12,129,51,108,1397,1697
E01002245,9,96,29,70,1388,1592
E01002325,6,47,32,32,1592,1709
E01002329,13,72,37,93,1400,1615
E01002330,33,93,45,94,1465,1730
E01002337,12,14,18,83,1174,1301
E01002354,10,37,19,63,1243,1372
E01002376,4,24,17,88,1309,1442
E01002379,28,39,51,120,1228,1466
E01002380,7,83,62,78,1846,2076
E01002381,5,27,27,108,1372,1539
E01002243,24,172,72,159,1446,1873
E01002353,9,95,51,220,1635,2010
E01002356,19,201,94,225,1604,2143
E01032741,21,73,36,105,843,1078
E01032742,18,43,23,73,1153,1310
E01002272,11,43,19,34,1212,1319
E01002274,13,20,25,90,1490,1638
E01002317,11,34,24,67,1405,1541
E01002318,7,18,10,85,1496,1616
E01002355,3,41,37,49,1340,1470
E01002382,7,16,41,130,1582,1776
E01002270,18,54,22,463,1116,1673
E01002271,30,62,29,288,1082,1491
E01002273,7,46,24,153,1132,1362
E01002275,13,31,24,213,1078,1359
E01002319,8,81,33,76,1398,1596
E01002350,12,72,65,155,1247,1551
E01002351,4,48,50,88,1390,1580
E01002352,25,75,44,98,1393,1635
E01002358,7,112,37,161,1455,1772
E01002246,24,163,42,139,1332,1700
E01002247,14,199,61,185,1341,1800
E01002248,11,88,52,139,1107,1397
E01002249,30,189,61,338,1287,1905
E01002250,27,163,52,124,1197,1563
E01002251,16,134,46,113,1121,1430
E01002252,6,8,21,25,1451,1511
E01002256,7,14,31,27,1419,1498
E01002258,3,26,22,30,1595,1676
E01002259,6,14,20,41,1405,1486
E01002391,0,12,15,38,1557,1622
E01002253,3,6,21,46,1463,1539
E01002254,10,18,22,57,1509,1616
E01002257,6,20,14,61,1618,1719
E01002384,4,12,17,63,1426,1522
E01002359,19,23,13,23,1244,1322
E01002360,3,22,21,17,1366,1429
E01002361,8,35,41,71,1545,1700
E01002363,6,25,26,51,1482,1590
E01002367,9,22,19,40,1483,1573
E01002320,11,32,24,47,1366,1480
E01002321,5,31,37,116,1453,1642
E01002322,13,74,33,82,1738,1940
E01002323,3,85,36,58,1500,1682
E01002324,17,35,22,40,1341,1455
E01002255,6,17,33,65,1362,1483
E01002289,2,32,35,43,1502,1614
E01002292,5,42,27,43,1432,1549
E01002362,10,16,20,62,1386,1494
E01002386,5,46,47,62,1686,1846
E01002287,0,52,29,66,1411,1558
E01002291,7,24,23,89,1439,1582
E01002364,11,8,22,16,1389,1446
E01002365,4,71,27,41,1173,1316
E01002366,12,67,27,58,1300,1464
E01002385,5,16,14,12,1549,1596
E01002387,1,14,26,29,1535,1605
E01002388,9,16,16,37,1580,1658
E01002389,1,2,12,15,1505,1535
E01002390,12,8,15,39,1375,1449
E01002265,7,41,29,57,1338,1472
E01002285,3,20,14,27,1181,1245
E01002286,1,43,10,35,1561,1650
E01002288,3,17,12,81,1435,1548
E01002290,8,41,19,39,1409,1516
E01002260,2,125,33,173,1202,1535
E01002261,9,107,36,156,1341,1649
E01002262,1,111,31,87,1396,1626
E01002263,1,108,24,56,1410,1599
E01002264,3,81,32,31,1328,1475
E01002266,2,63,20,65,1289,1439
E01002267,5,95,48,63,1460,1671
E01002372,11,116,27,24,1433,1611
E01002373,3,91,48,55,1384,1581
E01002374,13,138,39,50,1286,1526
E01002368,22,276,48,53,1195,1594
E01002369,14,213,44,104,1516,1891
E01002370,18,185,53,73,1644,1973
E01002371,6,111,43,61,1406,1627
E01002375,2,165,51,64,1459,1741
E01002343,10,70,27,58,1540,1705
E01002344,14,110,26,67,1311,1528
E01002348,2,40,24,52,1413,1531
E01002349,6,33,15,15,1439,1508
E01002342,9,204,49,124,1202,1588
E01002345,8,201,88,91,1291,1679
E01002346,7,174,51,57,1214,1503
E01002347,15,115,50,143,1117,1440
E01002473,18,30,42,533,924,1547
E01002475,26,40,67,336,1028,1497
E01002476,31,40,41,616,848,1576
E01002477,20,26,61,397,748,1252
E01002482,20,37,63,531,956,1607
E01002472,12,45,35,372,1107,1571
E01002474,8,32,49,354,1064,1507
E01002478,19,46,80,268,1106,1519
E01002483,31,72,61,539,1036,1739
E01002484,20,34,64,252,1054,1424
E01002485,23,79,70,412,1129,1713
E01002438,12,24,34,84,1171,1325
E01002439,10,45,25,159,1332,1571
E01002440,9,40,31,59,1302,1441
E01002441,26,35,48,130,1311,1550
E01002442,32,29,27,64,1360,1512
E01002433,50,42,57,282,1395,1826
E01002436,12,28,68,214,1286,1608
E01002479,26,64,59,367,1186,1702
E01002480,19,34,57,405,1245,1760
E01002481,43,42,79,347,1122,1633
E01002533,26,38,52,91,1255,1462
E01002534,21,30,65,98,1251,1465
E01002538,20,15,46,156,1332,1569
E01002539,10,24,52,100,1338,1524
E01002418,43,50,81,232,1383,1789
E01002419,15,31,45,248,1192,1531
E01002431,20,28,58,285,1024,1415
E01002432,16,42,51,235,1217,1561
E01002437,5,14,26,269,1155,1469
E01002430,6,16,46,124,1277,1469
E01002434,20,11,19,126,1182,1358
E01002435,44,8,42,190,1152,1436
E01002470,22,35,64,219,1344,1684
E01002535,49,23,57,288,1350,1767
E01002416,28,54,37,156,1466,1741
E01002417,31,23,40,236,1266,1596
E01002420,9,53,50,209,1274,1595
E01002421,30,59,48,213,1346,1696
E01002471,14,36,58,167,1344,1619
E01002465,26,34,51,191,1274,1576
E01002467,8,43,48,129,1289,1517
E01002494,59,79,64,240,1254,1696
E01002536,22,56,53,187,1102,1420
E01002537,29,31,45,227,1072,1404
E01002415,14,46,76,143,1431,1710
E01002466,12,41,52,87,1488,1680
E01002468,16,44,54,136,1446,1696
E01002469,13,26,56,151,1424,1670
E01002495,39,86,73,341,1691,2230
E01002458,10,14,44,204,1144,1416
E01002459,24,17,33,132,1418,1624
E01002460,12,22,46,158,1100,1338
E01002462,14,11,48,244,1101,1418
E01002464,32,48,45,141,1320,1586
E01002461,62,43,29,396,905,1435
E01002463,41,12,53,327,1137,1570
E01002512,53,31,52,345,1260,1741
E01002513,21,50,42,249,979,1341
E01002516,74,48,59,431,842,1454
E01002450,11,65,82,269,994,1421
E01002451,39,56,57,327,1035,1514
E01002452,44,66,44,385,1000,1539
E01002453,59,74,63,329,1167,1692
E01002454,64,105,87,260,1261,1777
E01002414,131,412,133,855,1783,3314
E01002514,73,57,100,328,1318,1876
E01002515,43,109,66,208,1182,1608
E01033725,83,159,66,409,1669,2386
E01002520,54,87,80,272,1056,1549
E01002521,66,157,68,273,1152,1716
E01002523,39,79,107,470,930,1625
E01033724,219,471,219,1490,2534,4933
E01002410,40,100,49,454,1051,1694
E01002412,156,170,91,595,1279,2291
E01002456,34,72,96,324,1149,1675
E01002509,34,40,20,365,993,1452
E01002511,40,93,69,239,1081,1522
E01002422,41,140,60,371,824,1436
E01002423,39,119,54,406,1027,1645
E01002424,72,119,79,481,823,1574
E01002425,109,218,48,460,960,1795
E01002427,30,110,58,453,855,1506
E01002428,63,106,60,294,947,1470
E01002408,45,139,67,302,974,1527
E01002409,36,161,94,424,1058,1773
E01002429,23,223,52,259,856,1413
E01002455,32,188,85,436,987,1728
E01002457,40,133,94,423,870,1560
E01002392,63,308,85,315,904,1675
E01002393,58,360,113,566,891,1988
E01002540,58,297,83,470,768,1676
E01002542,84,414,100,671,644,1913
E01002543,78,266,75,563,746,1728
E01002394,78,147,63,790,541,1619
E01002395,63,191,51,692,410,1407
E01002397,76,235,64,990,330,1695
E01002398,106,157,35,1061,366,1725
E01002399,89,138,46,944,374,1591
E01002426,65,154,80,689,795,1783
E01002411,31,125,64,203,1289,1712
E01002413,28,106,44,228,1124,1530
E01002518,44,51,49,238,951,1333
E01002519,36,83,39,195,1138,1491
E01002550,90,143,63,256,1258,1810
E01002554,117,256,133,555,1502,2563
E01002541,103,169,96,529,1052,1949
E01002544,122,168,86,812,490,1678
E01002545,65,286,114,441,597,1503
E01002546,98,158,43,978,296,1573
E01002547,95,201,69,912,289,1566
E01002400,73,229,52,502,936,1792
E01002401,65,261,76,545,755,1702
E01002402,75,216,45,571,592,1499
E01002403,52,320,89,711,623,1795
E01002404,79,267,80,543,869,1838
E01002548,22,106,64,260,1223,1675
E01002549,37,133,59,386,1136,1751
E01002551,64,109,72,440,1220,1905
E01002552,35,108,37,336,1066,1582
E01002553,73,103,60,268,1189,1693
E01002396,127,191,38,954,439,1749
E01002501,92,200,46,747,586,1671
E01002502,63,165,78,511,772,1589
E01002505,77,297,67,567,686,1694
E01002508,96,266,92,781,720,1955
E01002405,61,250,62,637,909,1919
E01002406,86,352,77,883,737,2135
E01002503,71,175,54,777,604,1681
E01002504,42,254,94,637,997,2024
E01002506,51,367,72,904,442,1836
E01002507,64,224,35,901,432,1656
E01002486,109,288,96,832,867,2192
E01002487,91,272,72,857,529,1821
E01002526,42,193,89,403,1198,1925
E01002528,29,127,58,383,1088,1685
E01002532,88,227,101,443,1430,2289
E01002445,78,183,116,305,1021,1703
E01002525,25,62,58,230,1238,1613
E01002529,84,271,106,505,1120,2086
E01002530,35,142,85,219,1153,1634
E01002531,19,48,65,281,1204,1617
E01002407,89,421,99,1180,565,2354
E01002488,59,175,33,805,657,1729
E01002489,77,172,53,1132,390,1824
E01002490,90,201,86,1041,664,2082
E01002492,77,133,75,964,398,1647
E01002444,81,174,85,543,950,1833
E01002446,37,74,70,404,1027,1612
E01002447,90,131,86,488,902,1697
E01002527,44,100,45,210,1122,1521
E01002443,97,89,60,885,494,1625
E01002448,60,159,93,695,950,1957
E01002449,72,150,81,719,750,1772
E01002491,72,222,63,718,529,1604
E01002493,100,348,81,676,663,1868
E01002496,44,114,70,258,1316,1802
E01002497,47,134,77,319,1255,1832
E01002498,13,47,65,231,1060,1416
E01002499,25,95,76,316,1193,1705
E01032577,29,60,65,269,1260,1683
E01002569,35,60,60,109,1500,1764
E01002570,58,65,46,135,1378,1682
E01002573,23,57,54,101,1415,1650
E01002574,50,15,83,136,1253,1537
E01002575,54,41,83,135,1432,1745
E01002562,47,125,80,197,930,1379
E01002564,69,218,120,259,1222,1888
E01002566,124,345,161,367,1126,2123
E01002568,102,396,181,464,1616,2759
E01033081,77,74,70,168,853,1242
E01033082,32,73,62,153,903,1223
E01002620,108,158,76,932,577,1851
E01002625,128,72,30,1196,255,1681
E01002626,119,89,49,994,375,1626
E01002627,138,243,78,782,421,1662
E01002631,114,93,78,1062,281,1628
E01002633,65,203,62,684,629,1643
E01002634,62,257,70,764,559,1712
E01002637,128,255,46,1022,208,1659
E01002638,73,205,59,1044,442,1823
E01002563,43,99,78,319,1103,1642
E01002565,67,220,168,276,2098,2829
E01002567,47,72,75,148,1391,1733
E01002684,95,170,134,355,1614,2368
E01002686,59,193,81,224,1208,1765
E01002571,41,29,46,94,1115,1325
E01002572,82,210,114,115,1122,1643
E01002577,48,64,79,150,1294,1635
E01002578,44,24,71,150,1213,1502
E01002689,50,126,69,140,1200,1585
E01002690,46,45,47,92,1240,1470
E01002576,63,130,105,144,1304,1746
E01002579,38,36,75,129,1468,1746
E01002580,42,98,54,107,1085,1386
E01002581,49,57,88,149,1517,1860
E01002582,14,44,67,84,1459,1668
E01002675,129,146,100,860,1221,2456
E01002678,84,58,82,878,753,1855
E01002679,122,40,66,681,872,1781
E01002680,97,85,94,727,949,1952
E01002619,89,70,76,1352,372,1959
E01002622,63,68,50,1181,369,1731
E01002632,104,85,50,1197,396,1832
E01002635,80,85,21,1251,316,1753
E01002636,89,101,35,1375,416,2016
E01002618,96,34,42,1257,329,1758
E01002621,72,122,44,1104,475,1817
E01002623,107,115,37,1057,351,1667
E01002628,101,79,61,1212,487,1940
E01002629,113,175,83,1185,531,2087
E01002630,115,90,45,1012,433,1695
E01002639,84,36,23,1123,437,1703
E01002640,80,51,36,1311,322,1800
E01002674,69,64,57,826,691,1707
E01002676,70,32,56,1053,504,1715
E01002583,77,117,48,1125,339,1706
E01002584,73,77,43,1210,288,1691
E01002585,70,133,43,934,471,1651
E01002586,81,64,37,1191,277,1650
E01002589,60,245,110,1039,528,1982
E01002668,40,140,101,347,1386,2014
E01002669,80,130,99,241,1232,1782
E01002681,107,220,121,453,1162,2063
E01002682,75,154,143,480,1473,2325
E01002683,83,137,136,508,1704,2568
E01002642,80,95,65,1275,490,2005
E01002643,68,164,107,952,998,2289
E01002645,80,157,83,957,777,2054
E01002658,23,57,65,190,998,1333
E01002677,54,106,55,403,947,1565
E01002587,58,131,41,1207,458,1895
E01002588,88,326,78,405,858,1755
E01002660,108,60,52,1189,349,1758
E01002661,103,52,30,1425,239,1849
E01002665,46,109,46,994,423,1618
E01002624,57,68,37,937,406,1505
E01002646,88,176,76,1145,531,2016
E01002662,55,43,48,1362,491,1999
E01002663,58,141,92,1183,600,2074
E01002664,50,139,65,1003,545,1802
E01002641,70,86,61,1147,568,1932
E01002648,118,142,77,1553,799,2689
E01002649,47,130,79,854,720,1830
E01002657,47,66,88,609,1066,1876
E01033083,32,47,32,1304,249,1664
E01033084,75,114,63,862,608,1722
E01002653,90,86,60,1011,566,1813
E01002654,75,80,64,647,919,1785
E01002655,42,60,98,718,967,1885
E01002656,40,40,47,275,916,1318
E01002659,24,83,59,401,831,1398
E01002667,50,102,74,217,1130,1573
E01002670,44,99,65,274,1255,1737
E01002671,36,65,58,130,1370,1659
E01002672,58,296,71,375,778,1578
E01002673,84,373,108,410,659,1634
E01002647,104,187,70,1192,660,2213
E01002650,116,224,106,1463,527,2436
E01002651,82,103,74,1160,359,1778
E01002652,46,80,56,1144,439,1765
E01002666,38,75,30,1014,401,1558
E01002555,40,76,82,711,1008,1917
E01002556,43,115,46,443,1034,1681
E01002590,40,112,77,379,1231,1839
E01002592,53,155,76,562,1153,1999
E01002595,44,138,80,449,1213,1924
E01002557,34,96,59,378,1218,1785
E01002558,44,176,61,387,1277,1945
E01002559,28,192,113,454,1492,2279
E01002560,21,84,52,352,1206,1715
E01002561,58,125,62,201,933,1379
E01002591,39,73,59,322,1236,1729
E01002593,55,98,61,602,1302,2118
E01002594,52,102,103,764,933,1954
E01002611,31,89,82,360,1223,1785
E01002612,69,97,72,331,1101,1670
E01002613,41,82,56,464,1118,1761
E01002598,31,144,117,298,1250,1840
E01002599,39,112,67,262,1127,1607
E01002600,11,116,42,239,1116,1524
E01002603,60,169,67,424,1204,1924
E01033000,37,299,125,307,1017,1785
E01033030,35,94,78,840,676,1723
E01002604,38,268,71,306,1050,1733
E01002605,54,117,67,350,1259,1847
E01002606,26,169,74,290,1082,1641
E01002607,63,154,117,360,1229,1923
E01002615,34,127,84,347,878,1470
E01002596,59,263,99,374,1201,1996
E01002601,28,98,74,299,1166,1665
E01002602,25,46,47,90,1269,1477
E01002614,34,79,79,334,1220,1746
E01002616,16,78,58,155,1075,1382
E01002608,53,133,87,275,1169,1717
E01002609,42,64,57,228,1339,1730
E01002610,50,111,95,221,1087,1564
E01002617,14,67,58,179,1276,1594
E01002687,30,38,80,166,1393,1707
E01002691,102,76,95,269,1054,1596
E01002692,86,95,118,215,1268,1782
E01002693,60,57,59,165,1353,1694
E01032573,36,53,75,168,1282,1614
E01003006,53,14,54,187,1192,1500
E01003007,30,11,83,158,1231,1513
E01003008,25,20,88,136,1163,1432
E01003009,30,40,106,178,1541,1895
E01003010,20,7,48,106,1316,1497
E01002952,88,30,49,336,1038,1541
E01002953,53,34,87,337,797,1308
E01002955,146,45,59,288,839,1377
E01002956,129,57,70,290,1065,1611
E01002959,45,42,59,396,891,1433
E01002935,50,27,70,281,1342,1770
E01002938,35,30,89,152,1629,1935
E01002951,90,27,47,175,1175,1514
E01002954,88,50,70,253,828,1289
E01002957,112,141,100,426,938,1717
E01002933,37,38,105,192,1623,1995
E01002934,36,24,58,185,1518,1821
E01002937,24,31,88,127,1459,1729
E01003011,55,20,86,130,1450,1741
E01033568,110,47,123,284,897,1461
E01033569,69,39,77,219,1258,1662
E01002964,64,108,89,275,1695,2231
E01002969,87,178,106,416,961,1748
E01002971,42,74,56,158,1379,1709
E01002972,81,62,87,259,1320,1809
E01002974,60,94,92,297,1350,1893
E01002932,84,100,96,356,1121,1757
E01002960,64,25,80,499,959,1627
E01002962,52,46,51,419,960,1528
E01002970,49,66,58,281,1122,1576
E01002973,55,74,51,352,840,1372
E01002929,31,19,63,274,1246,1633
E01002930,38,56,62,437,1116,1709
E01002931,37,27,98,478,1210,1850
E01002963,44,33,53,442,1160,1732
E01002985,47,39,44,804,728,1662
E01002927,44,34,46,374,1058,1556
E01002928,29,28,53,428,1066,1604
E01002958,26,23,58,232,1341,1680
E01002961,64,17,85,398,1186,1750
E01002986,31,17,47,376,802,1273
E01002965,112,64,97,323,1729,2325
E01002967,39,33,84,167,1535,1858
E01002968,125,83,121,492,1810,2631
E01002990,46,21,61,210,1342,1680
E01002991,32,27,67,163,1324,1613
E01002922,20,12,55,139,1406,1632
E01002926,22,35,56,136,1286,1535
E01002966,21,31,76,134,1648,1910
E01002992,28,87,91,221,1325,1752
E01002921,39,29,52,244,1191,1555
E01002987,42,84,53,225,1298,1702
E01002988,35,109,103,241,1418,1906
E01002989,31,20,78,154,1547,1830
E01002975,50,32,49,552,698,1381
E01002977,54,54,53,378,1134,1673
E01002980,49,21,35,428,880,1413
E01002981,47,33,43,587,834,1544
E01002984,46,32,68,415,865,1426
E01002923,22,80,73,223,1172,1570
E01002925,36,30,55,137,1357,1615
E01002993,29,30,61,149,1250,1519
E01002995,24,16,62,198,1176,1476
E01002999,36,50,46,208,1109,1449
E01002915,27,27,43,321,886,1304
E01002916,37,20,66,286,1069,1478
E01002917,25,14,32,225,1101,1397
E01002920,34,17,64,183,1306,1604
E01002924,23,17,56,115,1319,1530
E01002976,31,29,44,214,1336,1654
E01002978,77,21,46,348,1269,1761
E01002979,47,16,36,240,1210,1549
E01002982,77,28,36,387,910,1438
E01002983,57,17,56,380,1116,1626
E01002994,27,49,64,143,1227,1510
E01002996,11,37,45,131,1289,1513
E01002997,24,18,53,142,1225,1462
E01002998,33,61,59,179,1198,1530
E01003002,39,48,95,237,1407,1826
E01002918,33,38,62,470,1155,1758
E01002919,45,105,60,519,976,1705
E01003000,43,30,53,341,1086,1553
E01003001,51,31,51,550,1148,1831
E01003003,26,33,52,373,1073,1557
E01002939,22,50,72,163,1241,1548
E01002941,9,23,23,128,1304,1487
E01002942,16,19,27,77,1231,1370
E01003004,31,60,62,239,1186,1578
E01003005,7,29,30,168,1254,1488
E01002944,22,44,54,129,1111,1360
E01002945,7,20,30,88,1414,1559
E01002946,12,12,44,82,1348,1498
E01002947,22,10,39,86,1457,1614
E01002940,22,30,52,151,1325,1580
E01002943,14,27,45,96,1214,1396
E01002948,47,65,87,183,1721,2103
E01002949,44,27,60,180,1551,1862
E01002950,18,42,41,83,1412,1596
E01003472,14,9,54,121,1146,1344
E01003473,24,23,43,198,1065,1353
E01003474,22,16,33,100,1240,1411
E01003475,42,172,128,384,1785,2511
E01003478,22,18,81,143,1375,1639
E01003460,18,23,41,83,1334,1499
E01003462,24,14,60,130,1236,1464
E01003464,55,12,46,233,1047,1393
E01003465,37,2,45,127,1089,1300
E01003400,25,33,64,191,1173,1486
E01003454,24,37,51,169,1081,1362
E01003456,24,58,62,190,1213,1547
E01003476,38,104,47,171,1044,1404
E01003477,26,23,54,170,1262,1535
E01003401,18,22,56,239,1011,1346
E01003402,43,33,70,270,1136,1552
E01003403,33,11,41,153,1308,1546
E01003404,21,23,67,246,1317,1674
E01003461,18,15,47,107,1357,1544
E01003367,34,162,90,690,1425,2401
E01003369,31,135,107,297,1086,1656
E01003370,37,152,132,398,1260,1979
E01003371,15,131,86,296,1030,1558
E01003455,28,93,82,181,1195,1579
E01003359,56,121,88,226,1242,1733
E01003360,34,48,58,204,1343,1687
E01003457,11,18,68,152,1373,1622
E01003458,20,40,56,207,1278,1601
E01003459,40,169,141,256,1481,2087
E01003394,33,306,78,681,833,1931
E01003395,25,360,68,493,525,1471
E01003396,35,288,74,544,651,1592
E01003397,27,277,92,507,649,1552
E01003398,45,380,108,557,651,1741
E01003368,42,247,71,470,756,1586
E01003372,28,260,90,293,861,1532
E01003393,39,199,62,371,858,1529
E01003406,44,345,109,315,828,1641
E01003407,46,165,80,489,1004,1784
E01003355,29,27,98,187,1240,1581
E01003356,38,37,95,249,1338,1757
E01003358,46,44,96,265,1372,1823
E01003383,35,25,71,202,1202,1535
E01003384,6,23,97,168,1227,1521
E01003442,34,39,61,203,1354,1691
E01003443,14,11,49,78,1412,1564
E01003444,14,31,45,116,1351,1557
E01003445,30,25,79,247,1332,1713
E01003463,24,15,26,254,972,1291
E01003380,24,26,68,168,1362,1648
E01003382,16,29,66,146,1282,1539
E01003385,25,22,101,136,1297,1581
E01003399,19,33,57,184,1080,1373
E01003423,28,22,55,143,1300,1548
E01003357,62,221,83,338,1038,1742
E01003376,23,287,86,302,855,1553
E01003377,24,390,84,321,743,1562
E01003408,42,105,100,311,1294,1852
E01003410,53,271,87,373,797,1581
E01003386,60,501,125,692,826,2204
E01003388,31,329,97,337,645,1439
E01003389,48,353,105,471,787,1764
E01003392,43,222,53,441,540,1299
E01003409,43,258,81,604,724,1710
E01003387,33,429,93,285,764,1604
E01003391,20,438,99,159,617,1333
E01003411,52,410,119,274,874,1729
E01003412,33,456,119,392,660,1660
E01003435,11,316,63,211,711,1312
E01003361,21,81,78,332,1134,1646
E01003424,8,33,56,169,1267,1533
E01003425,31,43,59,233,1074,1440
E01003426,60,59,64,569,997,1749
E01003428,31,45,66,138,1177,1457
E01003366,17,73,86,210,1116,1502
E01003381,24,16,42,142,1227,1451
E01003446,26,57,70,229,1286,1668
E01003447,37,99,67,263,1079,1545
E01003471,39,89,69,193,1186,1576
E01003413,34,530,153,429,754,1900
E01003414,34,432,93,508,524,1591
E01003415,53,483,83,390,623,1632
E01003416,25,343,70,318,756,1512
E01003434,43,409,87,291,659,1489
E01003373,25,343,108,295,694,1465
E01003378,39,515,114,310,1014,1992
E01003379,40,405,91,414,896,1846
E01003390,64,480,91,350,612,1597
E01003405,45,301,105,440,814,1705
E01003429,28,455,74,190,709,1456
E01003430,26,696,113,100,508,1443
E01003431,33,553,85,194,641,1506
E01003432,18,497,107,255,679,1556
E01003433,28,585,90,241,581,1525
E01003466,23,45,69,246,1209,1592
E01003467,22,52,57,212,1275,1618
E01003468,31,41,72,181,1374,1699
E01003469,41,65,69,626,819,1620
E01003470,43,29,59,585,1041,1757
E01003362,14,29,36,170,1074,1323
E01003363,20,62,62,268,1226,1638
E01003364,21,85,64,212,1349,1731
E01003365,11,25,46,325,1002,1409
E01003421,9,54,59,287,1191,1600
E01003374,32,311,76,215,806,1440
E01003375,31,207,77,286,1015,1616
E01003437,24,135,95,476,1149,1879
E01003440,28,204,64,288,952,1536
E01003441,42,340,98,380,998,1858
E01003427,67,39,88,668,896,1758
E01003436,22,141,78,290,1034,1565
E01003439,35,95,76,406,827,1439
E01003448,45,120,78,381,1077,1701
E01003453,40,95,45,475,1040,1695
E01003438,19,130,59,349,1134,1691
E01003449,28,122,88,554,967,1759
E01003450,28,169,68,244,1102,1611
E01003451,11,99,35,284,1237,1666
E01003452,31,207,57,336,1351,1982
E01003417,14,40,44,161,1300,1559
E01003418,10,91,55,128,1187,1471
E01003419,21,97,56,222,1307,1703
E01003420,32,55,52,172,1069,1380
E01003422,17,66,43,204,1047,1377
E01003744,13,46,28,167,1083,1337
E01003745,9,17,23,277,1109,1435
E01003746,12,40,55,124,1255,1486
E01003747,2,36,55,206,1044,1343
E01003748,21,54,44,195,1231,1545
E01003749,41,65,80,260,1159,1605
E01003750,35,54,68,176,1338,1671
E01003720,8,168,69,233,1299,1777
E01003722,25,170,88,219,1270,1772
E01003723,21,163,107,197,1254,1742
E01003726,24,185,107,210,998,1524
E01003721,39,186,91,353,990,1659
E01003724,26,91,73,256,935,1381
E01003725,20,151,86,153,1088,1498
E01003727,24,102,57,159,1258,1600
E01003654,36,137,89,276,1025,1563
E01003655,5,55,75,211,1164,1510
E01003658,49,225,96,298,981,1649
E01003660,12,67,69,154,1416,1718
E01003656,14,106,81,176,1112,1489
E01003657,19,132,106,230,1602,2089
E01003659,26,148,103,283,1080,1640
E01003698,17,67,41,262,998,1385
E01003699,22,92,47,216,1038,1415
E01003700,57,155,75,607,1346,2240
E01003701,45,125,55,685,878,1788
E01003702,30,119,39,273,1159,1620
E01003703,44,166,123,479,1689,2501
E01003704,48,118,85,321,1109,1681
E01003668,38,49,61,250,1224,1622
E01003669,25,49,94,132,1228,1528
E01003670,15,82,57,240,1102,1496
E01003671,17,64,64,205,1183,1533
E01003672,34,121,101,217,957,1430
E01003673,18,54,118,280,1308,1778
E01003674,35,96,110,429,1459,2129
E01003707,41,145,39,491,619,1335
E01003708,58,231,80,326,781,1476
E01003709,48,126,60,524,869,1627
E01003710,47,90,44,692,642,1515
E01003759,29,53,47,305,1025,1459
E01003760,53,228,108,358,1036,1783
E01003761,64,475,145,316,771,1771
E01003762,27,120,109,136,1228,1620
E01003763,39,221,115,553,947,1875
E01003764,46,101,97,305,1413,1962
E01003765,27,65,79,259,1144,1574
E01003705,39,156,82,698,1217,2192
E01003706,39,112,71,510,862,1594
E01003711,84,114,69,576,969,1812
E01003712,30,184,74,382,689,1359
E01003646,51,138,85,990,485,1749
E01003648,32,44,35,514,812,1437
E01003649,61,110,40,811,611,1633
E01003651,49,76,42,852,452,1471
E01003639,57,150,75,671,805,1758
E01003640,53,178,78,658,804,1771
E01003641,60,176,57,889,522,1704
E01003642,39,176,85,769,626,1695
E01003774,33,57,87,252,1335,1764
E01003775,51,59,84,534,1008,1736
E01003776,15,150,104,216,1168,1653
E01003777,24,48,66,307,1327,1772
E01003778,36,64,78,330,1331,1839
E01003779,18,66,63,202,1236,1585
E01003780,12,51,47,529,877,1516
E01003647,33,98,51,1126,478,1786
E01003650,42,115,36,627,693,1513
E01003652,61,73,69,801,545,1549
E01003653,37,99,79,823,433,1471
E01003638,14,146,50,580,821,1611
E01003643,52,99,52,880,750,1833
E01003644,41,100,45,920,456,1562
E01003645,83,204,132,1347,844,2610
E01003789,14,37,60,323,1010,1444
E01003794,14,83,70,290,1015,1472
E01003795,20,59,58,201,840,1178
E01003796,24,126,81,256,1079,1566
E01003661,34,294,61,723,823,1935
E01003662,37,331,118,626,747,1859
E01003663,32,221,81,489,999,1822
E01003664,48,309,74,496,849,1776
E01003665,46,234,92,542,734,1648
E01003666,41,451,168,669,869,2198
E01033590,16,216,103,361,415,1111
E01033592,48,309,102,740,709,1908
E01003751,48,151,72,1119,564,1954
E01003753,56,175,46,1262,437,1976
E01003754,78,127,44,1029,358,1636
E01003757,45,230,119,1080,522,1996
E01003769,82,193,78,1063,314,1730
E01003770,125,311,127,1164,882,2609
E01003771,66,188,94,1170,416,1934
E01003773,15,199,76,864,519,1673
E01003752,40,221,82,1498,651,2492
E01003755,101,109,62,1356,374,2002
E01003756,96,181,75,1342,429,2123
E01003758,91,453,152,1406,479,2581
E01003766,75,183,53,1253,336,1900
E01003767,69,228,58,1193,316,1864
E01003768,98,194,64,1034,364,1754
E01003772,63,167,65,1025,380,1700
E01003781,34,154,68,942,464,1662
E01003782,40,122,49,1291,253,1755
E01003786,26,136,53,751,453,1419
E01003787,25,135,67,965,344,1536
E01003790,16,107,111,218,965,1417
E01003791,28,83,69,212,1096,1488
E01003792,15,70,81,184,1072,1422
E01003793,40,174,103,240,999,1556
E01003783,77,244,84,1319,511,2235
E01003784,82,144,49,1170,315,1760
E01003785,90,163,100,1125,426,1904
E01003788,73,111,48,1223,397,1852
E01003683,62,218,61,1420,383,2144
E01003684,76,207,42,1130,325,1780
E01003685,67,179,39,1300,237,1822
E01003686,100,219,65,1334,234,1952
E01003688,55,172,53,1307,217,1804
E01003689,72,145,69,1058,236,1580
E01033589,41,174,79,1146,236,1676
E01033591,94,282,67,1022,443,1908
E01003737,69,88,63,1072,501,1793
E01003738,42,196,59,1203,608,2108
E01003739,67,225,87,1214,528,2121
E01003740,89,162,70,1230,504,2055
E01003741,28,136,46,787,740,1737
E01003742,69,218,83,1253,462,2085
E01003743,26,230,51,1157,309,1773
E01003728,85,329,73,1552,384,2423
E01003729,68,181,28,1257,217,1751
E01003730,78,205,20,1217,173,1693
E01003732,65,432,108,658,392,1655
E01003733,54,229,52,1127,305,1767
E01003731,57,199,64,866,275,1461
E01003734,97,196,43,1110,350,1796
E01003735,111,565,149,1093,421,2339
E01003736,47,285,69,1037,221,1659
E01003713,72,209,53,1067,343,1744
E01003714,106,260,69,1348,385,2168
E01003715,101,184,85,1259,359,1988
E01003716,55,160,62,940,495,1712
E01003718,96,211,51,1062,427,1847
E01003719,66,187,76,1181,448,1958
E01032581,52,225,102,493,780,1652
E01003690,43,91,51,904,622,1711
E01003691,39,186,56,886,267,1434
E01003692,37,136,44,941,434,1592
E01003693,64,123,52,968,334,1541
E01003694,6,96,28,1009,323,1462
E01003695,81,150,48,924,330,1533
E01003696,76,143,44,1108,506,1877
E01003697,46,110,61,1085,328,1630
E01003675,36,52,44,1076,411,1619
E01003676,29,86,44,1167,364,1690
E01003677,53,62,32,907,493,1547
E01003678,41,95,58,930,481,1605
E01003679,29,59,27,981,525,1621
E01003680,44,81,40,964,490,1619
E01003681,49,114,44,940,697,1844
E01003682,61,77,49,1131,378,1696
E01003797,24,9,44,46,1356,1479
E01003798,41,17,55,42,1348,1503
E01003799,20,13,41,66,1481,1621
E01003800,54,42,61,86,1330,1573
E01003801,43,10,55,111,1102,1321
E01003802,46,12,44,173,1053,1328
E01003803,49,55,76,136,1158,1474
E01003846,18,4,72,109,1531,1734
E01003847,36,7,46,132,1361,1582
E01003849,17,12,38,98,1369,1534
E01003851,16,5,49,73,1545,1688
E01003860,21,28,53,105,1484,1691
E01003864,14,23,69,131,1229,1466
E01003852,55,8,39,64,1158,1324
E01003853,27,19,86,56,1347,1535
E01003854,17,20,59,63,1254,1413
E01003855,42,58,68,111,1410,1689
E01003856,16,26,79,69,1378,1568
E01003857,27,24,83,69,1549,1752
E01003858,14,5,38,34,1547,1638
E01003848,25,37,72,120,1554,1808
E01003861,32,47,77,110,1485,1751
E01003862,39,34,71,149,1095,1388
E01003863,26,21,66,112,1195,1420
E01003865,22,20,64,133,1072,1311
E01033570,73,55,97,298,1029,1552
E01033571,43,36,63,98,1298,1538
E01003804,20,16,83,119,1520,1758
E01003807,36,12,59,66,1622,1795
E01003808,42,18,42,55,1625,1782
E01003809,16,11,42,62,1604,1735
E01003859,35,16,63,87,1421,1622
E01003873,26,14,65,110,1445,1660
E01003874,19,17,73,63,1357,1529
E01003875,50,16,79,135,1333,1613
E01003878,33,10,59,116,1176,1394
E01003866,10,17,52,44,1464,1587
E01003868,7,4,44,75,1376,1506
E01003871,40,26,91,60,1432,1649
E01003872,21,6,50,76,1298,1451
E01003821,20,19,59,132,1283,1513
E01003876,33,11,46,92,1409,1591
E01003877,16,6,48,65,1347,1482
E01003879,53,34,66,66,1332,1551
E01003892,43,13,69,122,1765,2012
E01003893,7,13,40,74,1482,1616
E01003894,8,15,57,82,1481,1643
E01003895,11,15,62,62,1568,1718
E01003905,31,24,38,196,1146,1435
E01003906,31,31,49,171,1336,1618
E01003907,46,57,78,322,1180,1683
E01003908,43,45,69,308,1352,1817
E01003909,18,38,75,189,1249,1569
E01003867,38,25,57,201,1171,1492
E01003869,15,15,51,137,1399,1617
E01003870,32,12,74,96,1656,1870
E01003910,52,13,56,117,1392,1630
E01003805,16,8,54,67,1528,1673
E01003806,16,7,47,47,1488,1605
E01003816,29,13,77,86,1502,1707
E01003817,52,67,46,160,1588,1913
E01003840,36,85,65,568,830,1584
E01003841,30,184,86,463,1169,1932
E01003842,27,28,64,156,1402,1677
E01003843,54,58,75,512,1345,2044
E01003844,19,18,43,190,1180,1450
E01003845,31,14,48,285,1248,1626
E01003882,28,15,61,81,1612,1797
E01003883,18,12,53,56,1636,1775
E01003896,10,13,44,99,1480,1646
E01003897,21,28,70,95,1547,1761
E01003898,14,8,41,59,1368,1490
E01003899,18,12,61,99,1187,1377
E01003900,37,24,58,190,1253,1562
E01003901,25,33,54,93,1435,1640
E01003902,19,35,74,139,1029,1296
E01003903,34,39,77,209,1268,1627
E01003904,22,35,69,106,1304,1536
E01003880,22,2,48,77,1319,1468
E01003881,11,26,77,78,1645,1837
E01003884,18,34,44,54,1444,1594
E01003885,16,10,52,73,1365,1516
E01003818,89,34,79,112,1246,1560
E01003819,47,48,48,131,1401,1675
E01003820,31,37,84,139,1658,1949
E01003811,6,14,35,36,1457,1548
E01003812,12,21,62,123,1618,1836
E01003890,19,8,49,57,1376,1509
E01003891,8,13,41,61,1592,1715
E01003810,16,10,45,61,1473,1605
E01003813,9,21,48,41,1511,1630
E01003814,29,16,39,82,1548,1714
E01003815,30,26,89,131,1522,1798
E01003828,10,14,32,90,1371,1517
E01003829,38,57,57,169,1354,1675
E01003830,17,36,70,169,1468,1760
E01003831,26,51,66,149,1326,1618
E01003832,13,37,65,152,1164,1431
E01003833,24,21,49,117,1175,1386
E01003886,24,14,46,86,1529,1699
E01003887,9,12,46,42,1615,1724
E01003888,29,32,98,110,1638,1907
E01003889,8,6,35,65,1662,1776
E01003834,45,30,53,92,1500,1720
E01003835,6,3,42,61,1415,1527
E01003836,26,35,43,65,1336,1505
E01003837,17,22,60,96,1617,1812
E01003838,21,25,63,101,1576,1786
E01003839,30,45,86,100,1610,1871
E01003822,9,15,32,115,1273,1444
E01003823,24,20,53,112,1429,1638
E01003824,7,5,38,125,1486,1661
E01003825,20,16,61,81,1584,1762
E01003826,18,27,61,122,1540,1768
E01003827,13,21,56,78,1544,1712
E01004125,34,97,45,155,1252,1583
E01004183,11,136,71,198,1251,1667
E01004184,31,123,76,145,1215,1590
E01004185,16,196,95,140,1005,1452
E01004189,24,135,77,254,1389,1879
E01004123,44,202,95,381,1404,2126
E01004124,18,90,83,245,1390,1826
E01004126,10,100,73,138,1188,1509
E01004128,25,154,51,163,1095,1488
E01004129,18,106,88,293,1267,1772
E01004130,12,102,42,198,1244,1598
E01004131,15,59,37,217,1304,1632
E01004134,16,51,46,266,1056,1435
E01004135,14,57,38,175,1164,1448
E01004136,34,46,48,254,1171,1553
E01004164,7,35,46,74,1314,1476
E01004166,9,50,72,101,1217,1449
E01004169,19,92,58,82,884,1135
E01004186,16,179,101,156,1272,1724
E01004188,28,153,82,163,1285,1711
E01004127,33,104,52,154,1302,1645
E01004163,4,78,53,104,1302,1541
E01004165,13,103,43,144,1365,1668
E01004167,24,136,63,106,989,1318
E01004187,6,121,48,106,1326,1607
E01004117,11,14,31,103,1305,1464
E01004121,25,28,53,222,1238,1566
E01004192,42,38,57,258,1536,1931
E01004193,49,57,117,262,1843,2328
E01004195,55,24,90,229,1180,1578
E01004144,15,75,85,215,1237,1627
E01004145,24,120,52,298,1637,2131
E01004146,16,90,63,205,1336,1710
E01004147,4,43,57,185,1296,1585
E01004116,13,27,32,144,1392,1608
E01004122,25,11,45,139,1152,1372
E01004190,25,14,52,125,1151,1367
E01004191,16,51,28,219,1337,1651
E01004194,6,23,42,134,1151,1356
E01004196,26,23,43,226,1126,1444
E01004115,13,35,54,261,1387,1750
E01004118,37,39,52,216,1331,1675
E01004119,7,17,31,122,1241,1418
E01004132,11,18,44,170,1293,1536
E01004133,11,24,34,204,1237,1510
E01004171,15,80,65,209,1149,1518
E01004172,19,105,92,166,1167,1549
E01004173,26,67,44,94,1154,1385
E01004175,17,76,53,93,1375,1614
E01004176,10,73,50,94,1192,1419
E01004076,15,180,69,161,1062,1487
E01004077,15,119,51,183,1192,1560
E01004078,16,137,53,81,1330,1617
E01004079,7,89,41,116,1146,1399
E01004080,9,108,45,196,974,1332
E01004081,7,93,71,168,1168,1507
E01004082,29,90,27,248,1013,1407
E01004137,30,55,56,195,1182,1518
E01004140,46,154,71,241,997,1509
E01004141,19,139,50,176,1171,1555
E01004142,40,143,86,264,1505,2038
E01004149,29,79,65,137,1400,1710
E01004101,4,36,47,84,1190,1361
E01004103,15,52,89,147,1274,1577
E01004138,17,71,61,162,1241,1552
E01004139,15,60,58,150,1085,1368
E01004168,15,46,36,107,1372,1576
E01004143,9,44,66,167,1167,1453
E01004148,22,86,88,217,1179,1592
E01004159,15,52,55,166,1240,1528
E01004160,15,64,72,201,1223,1575
E01004161,29,41,54,124,1196,1444
E01004097,19,53,47,122,1435,1676
E01004098,9,36,46,71,1094,1256
E01004099,17,57,64,39,1264,1441
E01004100,9,42,50,77,1176,1354
E01004102,10,19,37,75,1233,1374
E01004110,15,56,82,229,1446,1828
E01004111,15,22,44,206,1224,1511
E01004112,9,28,50,138,1411,1636
E01004120,7,20,23,136,1352,1538
E01004157,12,4,48,178,1032,1274
E01004087,27,42,39,293,1064,1465
E01004170,13,73,54,215,1366,1721
E01004174,5,54,92,134,1159,1444
E01004178,22,119,126,231,1481,1979
E01004179,16,64,60,173,1254,1567
E01004152,31,83,69,220,1159,1562
E01004155,33,67,49,228,1251,1628
E01004156,27,77,58,339,1186,1687
E01004158,23,72,54,187,1143,1479
E01004162,38,53,64,298,1096,1549
E01004083,37,143,79,121,1040,1420
E01004086,13,96,78,415,1015,1617
E01004088,11,159,141,110,1397,1818
E01004089,19,172,72,113,914,1290
E01004182,15,82,74,155,1220,1546
E01004104,11,37,53,86,1341,1528
E01004107,15,91,51,129,1243,1529
E01004177,19,123,71,157,1384,1754
E01004180,7,64,44,183,1413,1711
E01004181,17,111,65,174,1276,1643
E01004090,14,125,73,141,840,1193
E01004096,15,99,72,173,1067,1426
E01004150,49,93,66,181,1171,1560
E01004151,32,63,73,215,1328,1711
E01004153,98,73,70,310,1157,1708
E01004091,6,25,35,103,1113,1282
E01004092,27,46,39,239,1086,1437
E01004105,7,55,68,172,1517,1819
E01004106,6,32,23,168,1300,1529
E01004154,21,33,49,139,1188,1430
E01004084,15,59,38,297,1053,1462
E01004085,7,114,40,324,1110,1595
E01004108,21,68,46,208,1371,1714
E01004109,16,117,56,83,1324,1596
E01004093,28,37,34,300,1123,1522
E01004094,27,40,55,160,1395,1677
E01004095,16,32,50,217,1196,1511
E01004114,29,38,39,296,1333,1735
E01032623,36,37,64,381,1307,1825
E01004349,22,155,77,90,1095,1439
E01004350,28,127,64,92,1442,1753
E01004351,32,84,65,48,1372,1601
E01004356,47,146,72,153,1212,1630
E01004357,38,197,54,153,1114,1556
E01004352,26,56,53,55,1730,1920
E01004353,23,40,53,69,1621,1806
E01004354,12,73,96,74,1513,1768
E01004358,25,103,78,84,1357,1647
E01004359,19,107,69,110,1368,1673
E01004384,55,266,108,166,1228,1823
E01004385,39,160,88,104,993,1384
E01004386,27,79,66,89,1400,1661
E01004389,35,117,61,118,1282,1613
E01004390,37,163,75,77,1244,1596
E01004355,38,162,84,127,1188,1599
E01004360,43,65,50,113,1060,1331
E01004413,44,185,70,129,1136,1564
E01004415,57,167,70,159,1106,1559
E01004416,52,171,99,110,1265,1697
E01004361,42,103,52,71,1026,1294
E01004414,31,160,72,135,1209,1607
E01004417,60,212,101,166,1124,1663
E01004451,46,215,102,147,1216,1726
E01004452,44,194,91,158,1143,1630
E01004450,50,179,91,131,1204,1655
E01004453,53,294,104,235,939,1625
E01004454,77,257,65,251,1064,1714
E01004455,59,298,84,321,775,1537
E01004456,40,543,76,184,714,1557
E01004379,41,116,64,125,1084,1430
E01004380,23,105,87,138,1158,1511
E01004381,26,150,113,218,1308,1815
E01004383,56,119,96,139,1224,1634
E01004387,29,67,57,73,1274,1500
E01004388,34,106,50,113,1178,1481
E01004343,43,259,119,235,1138,1794
E01004344,82,487,135,396,740,1840
E01004382,65,335,76,162,712,1350
E01004418,52,225,112,208,1056,1653
E01004419,73,263,66,283,909,1594
E01004398,72,351,128,473,942,1966
E01004399,49,483,95,397,709,1733
E01004400,89,402,88,268,876,1723
E01004402,84,417,97,390,816,1804
E01004403,59,403,98,316,941,1817
E01004345,74,425,177,368,881,1925
E01004348,108,565,149,549,1317,2688
E01004377,41,292,103,291,1055,1782
E01004378,55,310,124,287,1057,1833
E01004342,134,361,140,538,970,2143
E01004346,77,280,80,253,1023,1713
E01004347,62,303,131,299,1188,1983
E01004460,72,338,129,484,932,1955
E01004462,71,313,77,646,688,1795
E01004396,80,170,80,589,935,1854
E01004457,89,309,99,490,907,1894
E01004458,89,268,74,571,860,1862
E01004459,97,432,81,369,656,1635
E01004463,66,256,129,203,1349,2003
E01004407,108,543,235,229,518,1633
E01004410,87,349,133,250,1079,1898
E01004464,64,419,113,335,648,1579
E01004469,83,393,110,399,655,1640
E01004470,61,338,102,267,756,1524
E01004471,87,407,88,314,828,1724
E01004391,81,232,93,355,1088,1849
E01004393,304,558,85,298,1146,2391
E01004401,85,397,113,382,1125,2102
E01004404,119,475,114,402,939,2049
E01004461,93,274,159,591,1008,2125
E01004412,44,177,98,339,1081,1739
E01004465,44,253,89,315,801,1502
E01004466,34,169,85,302,1033,1623
E01004467,129,523,108,434,961,2155
E01004468,34,251,77,311,948,1621
E01004406,86,295,102,509,867,1859
E01004408,49,247,78,402,973,1749
E01004409,64,172,89,391,945,1661
E01004411,87,212,85,542,795,1721
E01004443,66,204,67,924,572,1833
E01004447,53,295,67,682,778,1875
E01004392,121,263,117,722,1060,2283
E01004394,72,324,99,489,837,1821
E01004397,93,329,119,793,982,2316
E01004444,164,502,133,596,1142,2537
E01004446,119,290,84,506,916,1915
E01004395,74,216,67,344,912,1613
E01004421,123,373,109,1038,506,2149
E01004445,77,210,77,627,750,1741
E01004448,115,410,105,309,958,1897
E01004449,74,413,155,607,589,1838
E01004363,55,198,61,560,691,1565
E01004364,79,362,65,650,582,1738
E01004366,83,290,102,523,893,1891
E01004367,50,263,59,674,591,1637
E01004368,76,271,77,625,826,1875
E01004365,137,319,63,1149,621,2289
E01004405,60,275,91,516,710,1652
E01004420,97,431,74,876,656,2134
E01004423,104,458,85,583,673,1903
E01033153,159,910,126,683,738,2616
E01004362,71,226,85,233,999,1614
E01004436,79,220,72,478,863,1712
E01004437,80,300,103,398,1004,1885
E01004439,48,305,97,433,795,1678
E01004442,72,218,113,348,1003,1754
E01004422,88,386,66,408,714,1662
E01004424,104,519,107,564,539,1833
E01004425,107,576,147,342,918,2090
E01004426,59,481,75,559,613,1787
E01004427,131,543,156,378,905,2113
E01004369,90,262,120,430,864,1766
E01004370,87,362,74,396,867,1786
E01004372,160,314,91,232,1034,1831
E01004432,80,437,73,468,697,1755
E01004435,103,497,103,490,840,2033
E01004333,86,398,133,423,729,1769
E01004334,77,475,105,272,578,1507
E01004438,105,203,99,586,1072,2065
E01004440,94,313,151,541,1065,2164
E01004441,55,149,74,394,949,1621
E01004371,74,299,82,399,849,1703
E01004373,72,301,111,536,759,1779
E01004374,72,309,105,536,868,1890
E01004375,96,244,82,582,851,1855
E01004376,92,225,103,825,749,1994
E01004336,58,335,81,684,541,1699
E01004428,99,626,104,315,619,1763
E01004429,44,473,98,461,696,1772
E01004430,97,377,102,720,904,2200
E01004434,113,541,116,593,682,2045
E01004335,90,718,108,393,534,1843
E01004337,105,366,96,547,852,1966
E01004338,47,326,71,549,779,1772
E01004339,164,344,76,391,839,1814
E01004340,76,532,146,353,742,1849
E01004341,80,580,126,310,661,1757
E01004327,55,327,71,238,522,1213
E01004328,77,437,105,338,883,1840
E01004329,59,548,78,466,780,1931
E01004330,49,434,92,330,929,1834
E01004331,47,566,134,395,714,1856
E01004332,75,421,133,422,798,1849
E01016252,6,7,38,35,1324,1410
E01016253,6,7,32,64,1286,1395
E01032727,7,13,52,135,2804,3011
E01016184,10,64,34,89,1971,2168
E01016185,21,80,37,79,1159,1376
E01016186,2,34,31,36,1722,1825
E01016187,9,8,19,31,1569,1636
E01016188,4,13,23,54,1590,1684
E01016190,7,21,25,95,1386,1534
E01016238,1,5,7,58,1163,1234
E01016243,6,24,38,105,1325,1498
E01016245,6,27,46,132,2152,2363
E01016246,3,9,26,75,1471,1584
E01016247,10,17,40,67,1520,1654
E01016239,8,23,29,29,1401,1490
E01016240,2,45,34,69,1385,1535
E01016241,2,46,40,72,1456,1616
E01016242,4,44,36,71,1573,1728
E01016180,10,15,58,91,1325,1499
E01016181,15,10,43,54,1333,1455
E01016182,11,13,36,56,1404,1520
E01016183,15,6,40,82,1136,1279
E01016222,1,15,32,71,1150,1269
E01016191,14,32,35,66,1513,1660
E01016223,8,31,30,99,1266,1434
E01016224,3,50,40,93,1548,1734
E01016226,3,26,27,80,1225,1361
E01032724,15,48,24,145,1111,1343
E01032728,13,43,44,94,1198,1392
E01016225,23,73,66,135,1867,2164
E01016233,4,107,69,116,2011,2307
E01016248,6,46,33,61,1397,1543
E01016249,8,36,42,100,1281,1467
E01016250,3,43,22,133,1400,1601
E01016200,9,18,29,77,1218,1351
E01016201,1,29,29,38,1247,1344
E01016202,3,7,15,38,1128,1191
E01016203,5,17,26,68,1195,1311
E01016204,6,35,21,59,1091,1212
E01016209,12,56,24,53,1346,1491
E01016210,1,63,23,89,1048,1224
E01016213,3,39,34,51,1016,1143
E01016214,3,35,24,76,1236,1374
E01016215,6,77,30,83,1059,1255
E01032725,2,22,39,74,1448,1585
E01032726,7,27,32,47,1308,1421
E01016205,7,28,21,71,1200,1327
E01016217,2,16,45,54,1287,1404
E01016218,11,25,19,31,1289,1375
E01016231,12,50,59,102,1671,1894
E01016232,2,29,21,47,1311,1410
E01016212,6,44,8,57,1186,1301
E01016216,0,26,19,48,1203,1296
E01016219,2,41,23,39,1236,1341
E01016220,5,46,40,54,1234,1379
E01016221,4,23,23,27,1187,1264
E01016206,9,31,24,90,1635,1789
E01016208,7,77,22,66,1755,1927
E01016229,1,9,13,20,1138,1181
E01016230,3,19,49,86,1638,1795
E01016207,5,38,29,41,1424,1537
E01016234,2,5,24,31,1088,1150
E01016235,1,3,20,72,1243,1339
E01016236,13,13,36,135,1239,1436
E01016237,0,18,20,48,1105,1191
E01016192,4,11,36,67,1282,1400
E01016194,2,6,14,34,1195,1251
E01016195,12,13,25,28,1060,1138
E01016227,5,2,12,20,1301,1340
E01016228,3,12,17,32,1477,1541
E01016193,5,9,23,95,1096,1228
E01016196,34,59,54,465,1884,2496
E01016197,12,15,16,123,1185,1351
E01016198,1,4,12,68,1126,1211
E01016199,1,11,25,88,1117,1242
E01016924,11,4,31,35,1437,1518
E01016926,24,56,50,31,1369,1530
E01016927,10,12,55,38,1433,1548
E01016929,1,16,50,39,1481,1587
E01016931,3,9,11,17,1503,1543
E01016898,18,56,53,89,2030,2246
E01016899,56,143,154,479,2489,3321
E01016914,54,107,103,249,1867,2380
E01016915,24,50,72,81,1317,1544
E01016923,19,12,45,40,1470,1586
E01016928,9,8,44,29,1512,1602
E01016998,14,5,47,44,1394,1504
E01016999,18,9,43,66,1274,1410
E01017000,20,12,75,48,1567,1722
E01016925,9,16,60,51,1384,1520
E01016930,6,4,42,26,1765,1843
E01017001,6,19,54,35,1390,1504
E01017003,10,20,53,42,1522,1647
E01016916,2,12,29,30,1384,1457
E01016917,6,5,22,23,1312,1368
E01016918,6,19,39,37,1324,1425
E01016919,18,24,33,35,1269,1379
E01016920,8,12,38,44,1469,1571
E01016882,34,35,25,78,1282,1454
E01016883,34,23,34,20,1344,1455
E01016884,78,25,44,109,1338,1594
E01016885,65,27,78,77,1123,1370
E01016886,46,7,34,73,1397,1557
E01016980,18,19,56,65,1342,1500
E01016982,36,6,31,69,1160,1302
E01016983,49,13,58,109,1202,1431
E01016984,29,7,47,85,1307,1475
E01016985,36,17,64,73,1393,1583
E01016900,34,43,92,102,1407,1678
E01016902,13,30,47,95,1316,1501
E01016904,22,56,75,68,1368,1589
E01016905,28,42,78,80,1495,1723
E01016909,34,75,74,103,1605,1891
E01016906,20,16,49,32,1493,1610
E01016907,25,48,51,106,1581,1811
E01016908,24,38,41,54,1378,1535
E01016910,20,28,73,75,1331,1527
E01016911,18,52,53,50,1366,1539
E01016901,17,13,64,64,1503,1661
E01016903,14,30,100,73,1745,1962
E01016934,10,8,60,31,1295,1404
E01016939,7,8,44,47,1525,1631
E01016940,3,14,95,44,1546,1702
E01016981,19,11,64,80,1483,1657
E01017002,27,36,59,107,1474,1703
E01017004,15,22,81,49,1521,1688
E01017005,25,16,85,37,1539,1702
E01017006,17,25,51,50,1429,1572
E01016921,4,35,46,26,1442,1553
E01016922,15,7,21,32,1207,1282
E01016973,14,33,44,38,1399,1528
E01016977,17,27,36,41,1419,1540
E01016978,35,23,47,22,1544,1671
E01016879,23,30,74,60,1340,1527
E01016880,50,34,61,116,1096,1357
E01016881,36,50,50,47,1327,1510
E01016887,29,20,28,21,1327,1425
E01016888,28,10,50,38,1369,1495
E01016976,26,8,31,49,1546,1660
E01016932,11,10,56,56,1502,1635
E01016933,5,14,51,41,1395,1506
E01016935,11,12,71,63,1417,1574
E01016936,11,13,67,42,1501,1634
E01016937,21,46,73,107,1794,2041
E01016890,26,41,91,65,1524,1747
E01016966,28,38,77,77,1576,1796
E01016970,22,12,66,58,1478,1636
E01016971,20,33,97,72,1733,1955
E01016972,25,15,90,59,1661,1850
E01016979,31,24,70,45,1484,1654
E01016990,23,29,83,64,1479,1678
E01016991,13,21,90,71,1570,1765
E01016996,19,28,96,44,1476,1663
E01017007,11,11,44,40,1517,1623
E01017008,19,12,18,18,1568,1635
E01017009,12,5,34,44,1441,1536
E01017010,8,14,47,58,1655,1782
E01017011,12,12,38,29,1317,1408
E01017012,14,14,66,39,1676,1809
E01016892,14,20,55,61,1572,1722
E01016893,13,11,67,45,1764,1900
E01016912,17,61,73,96,1643,1890
E01016913,35,62,70,91,1487,1745
E01016946,6,18,57,55,1348,1484
E01016860,35,36,81,62,1310,1524
E01016871,71,28,76,53,1557,1785
E01016872,33,26,68,74,1625,1826
E01016873,54,37,55,90,1462,1698
E01016878,42,18,67,69,1675,1871
E01016870,24,23,76,50,1424,1597
E01016874,58,29,66,92,1573,1818
E01016875,15,13,52,36,1527,1643
E01016876,25,31,78,86,1405,1625
E01016877,22,16,98,99,1591,1826
E01016974,47,15,67,49,1459,1637
E01016975,30,16,47,90,1333,1516
E01016992,22,20,78,49,1429,1598
E01016994,57,18,64,61,1453,1653
E01016997,22,14,70,70,1406,1582
E01016889,9,28,79,57,1694,1867
E01016891,24,39,74,56,1577,1770
E01016894,28,28,95,104,1639,1894
E01016896,7,29,57,30,1644,1767
E01016897,16,13,77,64,1611,1781
E01016987,29,26,61,85,1656,1857
E01016989,21,23,65,46,1455,1610
E01016993,31,22,49,74,1262,1438
E01016995,28,15,74,74,1523,1714
E01016938,27,19,79,69,1590,1784
E01016950,11,12,71,33,1585,1712
E01016951,16,27,65,49,1278,1435
E01016967,24,30,79,63,1725,1921
E01016968,20,12,86,55,1412,1585
E01016864,18,42,43,40,1335,1478
E01016865,22,36,63,37,1428,1586
E01016866,25,33,35,37,1336,1466
E01016867,42,43,87,78,1200,1450
E01016868,31,21,64,72,1360,1548
E01016895,21,38,87,82,1330,1558
E01016849,22,11,47,53,1406,1539
E01016852,45,25,84,58,1381,1593
E01016853,30,29,61,54,1698,1872
E01016855,22,28,67,76,1540,1733
E01016856,39,19,72,66,1433,1629
E01016952,67,23,80,122,1333,1625
E01016953,15,24,76,64,1448,1627
E01016964,39,44,110,114,1794,2101
E01016969,32,33,108,118,1728,2019
E01033328,19,22,71,51,1288,1451
E01033329,76,69,118,322,1410,1995
E01016857,26,28,61,35,1373,1523
E01016858,15,22,65,29,1308,1439
E01016859,25,14,61,75,1279,1454
E01016986,19,29,81,61,1435,1625
E01016988,36,18,76,52,1349,1531
E01016850,29,14,104,108,1485,1740
E01016851,19,22,75,53,1540,1709
E01016854,30,31,61,60,1480,1662
E01016954,38,28,74,67,1604,1811
E01016955,41,29,63,128,1486,1747
E01016941,36,28,75,111,1667,1917
E01016945,22,31,57,67,1446,1623
E01016947,49,45,100,154,1259,1607
E01016948,18,38,83,38,1598,1775
E01016949,20,26,85,81,1511,1723
E01016861,15,16,57,61,1461,1610
E01016862,12,22,39,81,1424,1578
E01016942,29,30,34,168,1466,1727
E01016943,9,26,76,29,1445,1585
E01016944,8,17,61,75,1422,1583
E01016863,23,39,51,75,1391,1579
E01016869,21,16,70,90,1591,1788
E01016957,38,54,69,245,1368,1774
E01016963,20,40,92,79,1675,1906
E01016956,27,1,39,21,1467,1555
E01016958,18,9,56,52,1598,1733
E01016959,9,5,31,40,1385,1470
E01016960,5,10,48,41,1649,1753
E01016961,21,11,35,50,1650,1767
E01016962,19,13,57,76,1528,1693
E01017300,3,0,70,67,2094,2234
E01017303,5,1,17,29,1166,1218
E01017305,0,0,21,21,1344,1386
E01017306,4,0,12,8,1326,1350
E01017309,1,1,9,18,1613,1642
E01017301,6,1,7,17,1035,1066
E01017302,1,5,35,26,1680,1747
E01017304,1,1,9,4,1389,1404
E01017316,3,1,7,6,1665,1682
E01017329,2,1,28,11,2269,2311
E01017307,3,2,21,10,1913,1949
E01017308,3,0,17,13,1733,1766
E01033229,2,0,12,14,1353,1381
E01033237,5,0,17,21,1320,1363
E01017335,2,2,21,30,1465,1520
E01017336,2,6,34,30,1532,1604
E01017337,0,6,31,51,1523,1611
E01017346,0,3,28,9,1458,1498
E01017286,6,6,16,19,1490,1537
E01017287,3,3,14,10,1618,1648
E01017367,3,5,7,22,1881,1918
E01017368,2,7,9,22,1519,1559
E01017282,0,5,13,2,1384,1404
E01017283,0,3,15,10,1553,1581
E01017338,3,1,22,17,1347,1390
E01017341,0,4,13,8,1533,1558
E01017342,3,1,37,20,1670,1731
E01017339,3,2,20,30,1607,1662
E01017340,1,3,38,19,1723,1784
E01017343,1,1,20,3,1305,1330
E01017344,1,3,34,16,1598,1652
E01017345,0,3,100,43,1834,1980
E01017310,1,2,6,19,1383,1411
E01017311,3,6,6,3,1497,1515
E01017331,2,3,22,30,1416,1473
E01017332,0,0,9,14,1249,1272
E01017334,5,48,38,53,1648,1792
E01017295,5,0,12,11,1237,1265
E01017325,4,2,10,39,1250,1305
E01017326,6,6,17,35,1516,1580
E01017328,2,1,12,39,1390,1444
E01017333,13,98,63,70,2656,2900
E01017284,0,1,18,20,1736,1775
E01017285,1,3,10,6,1893,1913
E01017288,0,0,17,12,1184,1213
E01017351,1,4,20,27,1350,1402
E01017352,0,2,6,6,1133,1147
E01017292,2,0,21,16,1555,1594
E01017293,0,0,10,23,1984,2017
E01017296,0,0,10,8,1263,1281
E01017321,1,1,9,8,1169,1188
E01017322,2,3,18,23,1447,1493
E01017327,1,6,48,22,1576,1653
E01017312,0,2,28,3,1530,1563
E01017315,1,2,14,2,1481,1500
E01017354,1,1,9,5,1170,1186
E01017361,1,2,9,17,1407,1436
E01017362,0,1,14,36,1440,1491
E01033239,0,1,10,19,2276,2306
E01017290,1,1,4,5,1321,1332
E01017291,0,1,0,1,1155,1157
E01017294,1,1,3,5,1584,1594
E01017353,3,0,11,6,1205,1225
E01017289,1,1,14,8,2010,2034
E01017347,20,0,16,10,1590,1636
E01017348,0,1,17,20,1457,1495
E01017349,5,2,36,49,2057,2149
E01017350,1,2,19,25,1858,1905
E01017317,0,1,7,10,1531,1549
E01017320,4,0,15,10,1062,1091
E01017323,3,3,6,2,1144,1158
E01017324,2,1,12,7,1442,1464
E01017355,2,0,31,16,1479,1528
E01017358,2,0,19,3,1271,1295
E01017318,3,0,13,12,1158,1186
E01017319,2,2,8,6,1273,1291
E01017356,4,1,18,14,1514,1551
E01017357,3,1,21,5,1479,1509
E01017359,0,3,13,11,1456,1483
E01017360,4,1,37,22,1642,1706
E01017297,2,0,10,8,1417,1437
E01017298,1,0,10,1,1490,1502
E01017299,1,0,8,4,1206,1219
E01017369,2,1,11,8,1437,1459
E01017363,2,4,27,16,1494,1543
E01017364,0,0,55,32,1422,1509
E01017365,1,0,19,2,1433,1455
E01017366,1,2,8,1,1457,1469
E01017370,2,2,21,3,1725,1753
E01016070,1,19,11,15,1630,1676
E01016071,1,12,17,19,1599,1648
E01016072,2,20,11,24,1241,1298
E01016074,8,14,4,9,1653,1688
E01016142,3,10,11,11,1238,1273
E01016144,4,7,22,37,1432,1502
E01016145,4,13,20,25,1284,1346
E01016149,3,19,16,28,1369,1435
E01016073,1,2,18,33,1969,2023
E01016075,0,0,11,18,1406,1435
E01016076,5,44,22,63,2272,2406
E01016077,2,1,21,13,1445,1482
E01016143,6,35,25,36,2244,2346
E01016146,6,35,24,64,1890,2019
E01016147,5,25,13,92,1781,1916
E01016148,16,34,33,147,1738,1968
E01016133,2,23,16,124,1207,1372
E01016134,2,32,13,104,1278,1429
E01016138,10,28,5,118,1353,1514
E01016139,6,38,25,108,1506,1683
E01016135,3,26,34,56,1415,1534
E01016136,12,32,51,73,1399,1567
E01016137,6,25,25,99,1398,1553
E01016140,6,25,30,142,1224,1427
E01016141,11,43,48,130,1455,1687
E01016035,13,113,60,127,1549,1862
E01016112,47,82,69,184,2465,2847
E01032798,48,199,103,353,2846,3549
E01016151,17,67,27,71,1435,1617
E01016152,9,25,26,28,1396,1484
E01016153,8,44,29,35,1317,1433
E01016155,7,37,27,20,1462,1553
E01016033,9,52,21,79,984,1145
E01016036,33,273,79,361,1705,2451
E01016037,26,105,42,138,1398,1709
E01016039,16,108,50,135,1361,1670
E01016030,18,51,31,65,1694,1859
E01016032,2,18,31,31,1244,1326
E01016034,22,78,62,77,2329,2568
E01016038,51,38,67,43,1313,1512
E01016150,9,45,29,25,1497,1605
E01016154,9,43,32,75,1447,1606
E01016156,10,90,39,26,1512,1677
E01016157,3,41,36,38,1840,1958
E01016158,5,88,49,49,1952,2143
E01016031,47,108,48,125,1424,1752
E01016041,12,67,52,189,1340,1660
E01016045,27,30,53,276,1280,1666
E01016049,65,95,48,175,1539,1922
E01016040,12,90,26,133,1503,1764
E01016042,19,103,30,109,1249,1510
E01016043,3,46,48,41,1278,1416
E01016177,7,29,46,42,1443,1567
E01016178,9,25,45,70,1381,1530
E01016117,42,21,47,176,1478,1764
E01016129,28,42,59,122,1673,1924
E01016130,18,34,69,104,1666,1891
E01016131,6,21,30,44,1634,1735
E01016016,29,77,42,231,1142,1521
E01016017,15,108,61,258,1134,1576
E01016019,45,72,55,194,1500,1866
E01016110,24,87,65,277,1619,2072
E01016111,21,69,45,127,982,1244
E01016044,40,45,47,228,1344,1704
E01016046,8,35,38,166,1281,1528
E01016047,39,67,51,258,1310,1725
E01016048,41,65,35,261,1297,1699
E01016113,31,34,22,158,1241,1486
E01016114,6,22,58,88,1410,1584
E01016115,17,50,33,106,1738,1944
E01016118,12,56,50,68,1555,1741
E01016160,0,12,23,34,1405,1474
E01016161,4,10,27,21,1481,1543
E01016162,6,13,31,41,1555,1646
E01016163,5,21,18,30,1257,1331
E01016164,1,4,30,38,1422,1495
E01016165,3,11,19,50,1217,1300
E01016159,2,28,39,45,1267,1381
E01016174,15,75,21,116,1173,1400
E01016175,2,25,26,121,1666,1840
E01016179,12,7,24,59,1279,1381
E01016061,13,124,65,87,1406,1695
E01016063,33,86,46,105,1363,1633
E01016064,19,55,37,62,1393,1566
E01016069,58,135,82,169,1366,1810
E01016020,10,51,42,205,936,1244
E01016021,15,57,29,185,1241,1527
E01016022,17,66,40,438,866,1427
E01016125,20,52,38,154,1499,1763
E01016018,21,140,68,104,1653,1986
E01016023,11,88,50,30,1507,1686
E01016024,36,108,51,83,1680,1958
E01016062,8,105,26,59,1307,1505
E01016093,10,6,24,32,1476,1548
E01016096,4,10,12,39,1365,1430
E01016166,3,4,28,52,1363,1450
E01016167,2,0,22,45,1359,1428
E01016116,10,17,29,103,1673,1832
E01016127,16,22,28,33,1420,1519
E01016128,30,180,116,87,1655,2068
E01016132,8,25,48,70,1491,1642
E01016094,4,11,24,18,1399,1456
E01016095,6,25,27,31,1214,1303
E01016097,11,17,34,23,1363,1448
E01016098,24,17,33,54,1250,1378
E01016102,6,16,20,44,1359,1445
E01016119,2,26,33,272,1189,1522
E01016120,8,19,38,50,1259,1374
E01016124,7,17,37,202,1427,1690
E01016126,16,17,29,194,1435,1691
E01016025,18,42,22,78,1462,1622
E01016065,4,29,12,12,1353,1410
E01016066,13,40,34,23,1380,1490
E01016067,4,42,34,38,1493,1611
E01016068,10,85,32,13,1519,1659
E01016026,2,5,17,21,1213,1258
E01016027,15,12,16,24,1461,1528
E01016028,10,6,19,14,1308,1357
E01016029,3,6,9,11,1276,1305
E01016087,16,11,22,54,1578,1681
E01016088,8,15,46,78,1367,1514
E01016089,2,18,23,21,1516,1580
E01016090,3,8,24,21,1439,1495
E01016085,2,16,8,37,1552,1615
E01016086,9,10,14,72,1195,1300
E01016091,13,1,10,52,1438,1514
E01016176,8,12,23,183,1299,1525
E01016058,8,20,15,9,1421,1473
E01016059,8,30,19,22,1265,1344
E01016079,9,41,25,61,1217,1353
E01016083,4,41,33,25,1231,1334
E01016084,1,53,30,44,1390,1518
E01016101,15,9,14,41,1391,1470
E01016103,10,19,11,18,1400,1458
E01016104,2,14,13,23,1376,1428
E01016107,5,10,19,56,1457,1547
E01016121,3,29,22,64,1417,1535
E01016122,2,31,25,147,1324,1529
E01016123,3,30,16,44,1481,1574
E01016173,4,51,28,60,1447,1590
E01016078,1,38,28,18,1432,1517
E01016080,0,41,19,27,1426,1513
E01016081,2,71,28,50,1460,1611
E01016082,6,41,20,26,1494,1587
E01016050,12,8,33,80,1565,1698
E01016051,4,6,28,120,1441,1599
E01016052,14,20,22,127,1501,1684
E01016053,2,9,9,80,1448,1548
E01016054,9,9,16,107,1333,1474
E01016092,1,13,15,37,1487,1553
E01016099,9,5,9,29,1474,1526
E01016100,0,16,8,43,1466,1533
E01016105,5,15,26,40,1330,1416
E01016106,0,12,21,28,1389,1450
E01016168,6,40,27,23,1460,1556
E01016169,2,49,15,49,1594,1709
E01016171,0,38,28,23,1489,1578
E01016172,2,23,19,23,1381,1448
E01016055,1,20,22,36,1473,1552
E01016056,1,15,32,20,1323,1391
E01016057,8,12,12,18,1662,1712
E01016060,3,34,14,46,1510,1607
E01016170,2,33,38,40,1526,1639
E01016796,1,9,18,25,1473,1526
E01016797,3,21,20,25,1713,1782
E01016798,5,6,18,20,1875,1924
E01016799,0,6,22,14,1829,1871
E01016800,2,23,13,23,1571,1632
E01016759,2,10,29,12,1325,1378
E01016760,7,105,59,78,2137,2386
E01016761,1,4,21,22,1320,1368
E01016801,3,10,11,15,1311,1350
E01016802,2,13,13,12,1393,1433
E01016803,1,18,18,25,1257,1319
E01016786,1,13,26,29,1363,1432
E01016787,2,22,20,32,1582,1658
E01016788,1,11,23,19,1557,1611
E01016789,2,19,24,11,1278,1334
E01016790,3,13,11,42,1288,1357
E01016791,3,13,21,34,1366,1437
E01016792,6,13,25,49,1206,1299
E01016793,2,22,29,41,1854,1948
E01016794,11,1,23,28,1420,1483
E01016795,4,15,36,37,1467,1559
E01016762,3,68,53,41,1113,1278
E01016764,6,38,35,70,1282,1431
E01016766,10,75,37,155,1075,1352
E01016767,10,19,37,79,1179,1324
E01016771,6,145,33,219,967,1370
E01016806,5,197,104,92,1557,1955
E01016807,4,129,55,183,1362,1733
E01016809,15,129,50,186,1044,1424
E01016835,9,104,57,62,1400,1632
E01016763,5,40,20,106,1169,1340
E01016769,4,43,44,140,1169,1400
E01016770,20,102,56,183,1313,1674
E01016773,9,84,32,224,1452,1801
E01016836,6,43,39,241,1348,1677
E01016837,10,33,51,385,1379,1858
E01016838,2,37,59,221,1287,1606
E01016841,8,125,66,154,1764,2117
E01016721,8,319,78,246,1015,1666
E01016765,10,66,49,73,1474,1672
E01016772,7,159,62,203,954,1385
E01016804,10,222,75,168,1173,1648
E01016812,4,65,43,115,1335,1562
E01016817,3,43,29,90,1358,1523
E01016818,0,9,31,39,1620,1699
E01016840,6,169,99,220,2104,2598
E01016719,14,55,29,78,1282,1458
E01016722,8,100,68,168,1290,1634
E01016805,7,44,35,42,1214,1342
E01016808,14,81,30,125,1117,1367
E01016810,1,119,54,176,969,1319
E01016811,15,136,69,85,1202,1507
E01016819,12,101,35,181,829,1158
E01016839,6,121,59,98,1352,1636
E01016717,14,95,101,118,1217,1545
E01016720,8,130,56,82,1278,1554
E01016723,22,150,67,275,1224,1738
E01016724,13,188,67,270,1190,1728
E01016718,40,408,94,126,947,1615
E01016729,23,536,106,413,1135,2213
E01016768,14,224,56,251,1497,2042
E01033499,16,180,57,238,902,1393
E01033500,13,97,50,322,851,1333
E01016776,9,66,62,191,1140,1468
E01016813,11,88,44,213,1042,1398
E01016815,17,30,42,159,1076,1324
E01016816,5,30,46,214,1198,1493
E01016731,19,130,54,179,1115,1497
E01016732,12,113,43,222,1042,1432
E01016784,14,157,78,120,1246,1615
E01033501,15,229,89,196,1533,2062
E01033506,13,191,53,184,1596,2037
E01016783,14,205,60,177,1488,1944
E01016820,21,156,88,153,1230,1648
E01016821,12,110,61,152,1130,1465
E01016823,10,175,73,150,1295,1703
E01033503,7,78,40,129,1300,1554
E01033508,13,120,72,273,1238,1716
E01033509,14,289,73,217,1072,1665
E01033511,12,267,80,181,974,1514
E01033512,8,80,56,151,1373,1668
E01016726,11,420,77,201,1000,1709
E01016733,24,583,70,297,937,1911
E01016845,9,333,63,118,1371,1894
E01016846,17,202,46,302,1068,1635
E01016848,18,157,43,194,1085,1497
E01016780,17,94,79,257,1289,1736
E01016781,24,63,49,222,1175,1533
E01016814,20,19,17,30,1556,1642
E01033505,16,139,93,242,1286,1776
E01033522,13,151,93,128,1063,1448
E01033523,44,207,62,207,971,1491
E01033525,22,158,98,202,1276,1756
E01016774,14,61,56,286,1364,1781
E01016775,23,90,113,247,1260,1733
E01016777,17,62,30,180,1329,1618
E01016778,9,77,63,240,1379,1768
E01016725,5,254,93,349,932,1633
E01016727,15,185,76,386,1080,1742
E01016728,27,266,101,600,1002,1996
E01016847,20,238,91,224,1492,2065
E01016822,8,144,64,102,1243,1561
E01016824,9,82,57,86,1388,1622
E01016825,17,88,74,87,1250,1516
E01016827,9,100,44,131,1408,1692
E01016828,22,68,51,170,1484,1795
E01016842,13,267,48,105,1161,1594
E01016843,23,271,57,95,1080,1526
E01016844,20,167,51,97,1278,1613
E01033497,12,68,34,41,919,1074
E01033498,16,184,37,100,989,1326
E01016734,2,15,19,11,1172,1219
E01016735,3,17,45,38,1968,2071
E01016736,2,6,43,26,1305,1382
E01016826,11,33,31,146,1336,1557
E01016752,12,144,71,206,1309,1742
E01016753,19,237,114,257,1615,2242
E01016755,24,146,59,265,1411,1905
E01033514,5,137,70,183,1070,1465
E01033515,12,157,67,269,1445,1950
E01033517,11,70,57,153,1307,1598
E01016754,14,83,45,126,1384,1652
E01016756,11,203,69,293,1711,2287
E01016757,15,118,53,126,1267,1579
E01016758,10,84,56,306,1269,1725
E01016737,4,87,48,106,1396,1641
E01016738,9,122,62,96,1526,1815
E01016739,3,85,69,87,1325,1569
E01016740,2,68,53,69,1175,1367
E01016741,5,119,47,99,1400,1670
E01016748,6,110,81,280,1500,1977
E01016750,13,75,62,175,1304,1629
E01016751,13,53,59,192,1297,1614
E01033519,22,204,88,188,1368,1870
E01033520,14,72,75,190,1458,1809
E01016829,7,84,36,69,1368,1564
E01016831,1,87,44,54,1369,1555
E01016832,7,64,43,49,1116,1279
E01016833,10,20,47,104,1109,1290
E01016834,10,74,60,64,1335,1543
E01016710,3,31,46,179,1479,1738
E01016714,12,108,86,447,1230,1883
E01016716,6,51,63,212,1539,1871
E01016745,2,89,32,90,1354,1567
E01016711,16,80,160,109,2005,2370
E01016713,7,37,47,86,1493,1670
E01016715,9,64,47,65,1464,1649
E01016830,1,29,25,44,1132,1231
E01016742,11,161,77,198,1196,1643
E01016743,7,163,39,113,1702,2024
E01016744,2,138,44,122,1297,1603
E01016746,4,99,45,167,1411,1726
E01017112,5,7,34,54,1738,1838
E01017115,1,8,14,33,1303,1359
E01017117,0,21,35,27,1487,1570
E01017119,0,5,44,34,1647,1730
E01017120,3,11,33,26,1419,1492
E01017051,9,19,32,104,1743,1907
E01017052,13,8,16,66,1316,1419
E01017053,2,14,26,65,1242,1349
E01017118,0,6,26,76,1456,1564
E01017050,13,13,36,81,1406,1549
E01017061,3,2,18,32,1639,1694
E01017063,7,12,13,37,1542,1611
E01017064,3,4,19,80,1549,1655
E01017054,0,9,11,59,1333,1412
E01017113,4,7,20,25,1454,1510
E01017114,0,26,25,52,1248,1351
E01017116,9,34,22,42,1489,1596
E01017055,8,8,19,77,1463,1575
E01017056,4,5,20,22,1320,1371
E01017057,1,8,27,50,1431,1517
E01017058,6,38,19,44,1624,1731
E01017060,0,6,23,19,1501,1549
E01017086,6,15,11,25,1268,1325
E01017089,13,41,26,37,1487,1604
E01017090,9,23,77,83,1365,1557
E01017091,11,76,46,87,1326,1546
E01017092,3,17,30,67,1376,1493
E01017014,2,6,14,17,1551,1590
E01017046,5,6,20,100,1577,1708
E01017047,3,3,13,41,1587,1647
E01017048,9,7,27,12,1521,1576
E01017085,5,15,15,110,1283,1428
E01017084,7,13,17,78,1314,1429
E01017087,3,7,41,103,1305,1459
E01017088,16,23,20,89,1563,1711
E01017105,3,29,27,57,1286,1402
E01017107,3,19,38,122,1355,1537
E01017104,1,8,17,7,1130,1163
E01017106,4,30,28,40,1396,1498
E01017108,7,25,24,48,1447,1551
E01017109,5,17,27,30,1279,1358
E01017041,16,5,26,64,1287,1398
E01017043,5,15,46,128,1271,1465
E01017044,9,13,21,101,1393,1537
E01017049,7,8,22,28,1433,1498
E01017110,8,14,37,148,1258,1465
E01017111,15,25,45,73,1296,1454
E01017013,3,10,21,37,1534,1605
E01017042,13,28,24,53,1294,1412
E01017045,1,21,36,80,1229,1367
E01017075,8,32,49,110,1430,1629
E01017082,5,57,80,127,1475,1744
E01017083,4,20,43,79,1588,1734
E01017036,16,44,44,118,1346,1568
E01017037,14,41,71,117,1249,1492
E01017038,25,56,36,99,1415,1631
E01017102,20,42,43,135,1330,1570
E01017103,31,38,37,103,1043,1252
E01017015,3,14,37,27,1386,1467
E01017016,2,10,21,18,1536,1587
E01017017,5,11,22,37,1447,1522
E01017018,4,6,21,15,1555,1601
E01017019,18,28,63,96,1793,1998
E01017020,15,41,56,61,2120,2293
E01017076,1,20,37,65,1504,1627
E01017077,20,45,69,95,1500,1729
E01017078,21,49,48,77,1375,1570
E01017079,22,50,54,155,1298,1579
E01017080,36,82,92,249,1589,2048
E01017081,18,49,55,121,1411,1654
E01017031,25,56,76,205,1577,1939
E01017032,47,115,72,241,2132,2607
E01017034,33,80,40,73,1666,1892
E01017039,53,42,54,318,1287,1754
E01017040,32,51,43,140,1213,1479
E01033381,143,45,39,160,1014,1401
E01033383,30,34,34,95,1102,1295
E01017021,3,8,19,33,1395,1458
E01017093,5,61,27,116,1408,1617
E01017096,6,12,20,29,1337,1404
E01017099,13,23,46,118,1431,1631
E01017100,10,3,29,46,1371,1459
E01017101,6,16,34,66,1428,1550
E01017035,78,84,51,174,1197,1584
E01017128,25,45,79,243,1260,1652
E01017129,25,80,81,261,1471,1918
E01017130,46,71,84,363,1353,1917
E01017132,87,136,114,565,1787,2689
E01017133,33,59,70,318,1388,1868
E01017023,8,44,43,48,1551,1694
E01017025,20,53,105,190,1698,2066
E01017026,14,34,83,115,1710,1956
E01017029,13,48,39,83,1569,1752
E01017030,19,60,110,214,1585,1988
E01017022,26,39,42,120,1196,1423
E01017024,16,55,72,174,1493,1810
E01017027,18,27,75,180,1494,1794
E01017028,46,97,66,309,1659,2177
E01017124,18,25,61,127,1516,1747
E01017094,8,22,46,50,1431,1557
E01017095,2,46,52,73,1638,1811
E01017097,13,39,42,79,1464,1637
E01017098,8,15,63,68,1291,1445
E01017122,15,37,52,131,1508,1743
E01017125,32,45,43,183,1493,1796
E01017127,48,55,64,156,1601,1924
E01017135,32,44,54,159,1396,1685
E01017067,7,30,20,21,1392,1470
E01017068,3,25,62,55,1628,1773
E01017069,8,8,216,105,1563,1900
E01017070,8,28,61,75,1348,1520
E01017074,10,76,50,78,1648,1862
E01017073,38,33,47,99,1520,1737
E01017123,46,40,51,103,1762,2002
E01017131,43,41,81,196,1606,1967
E01033380,242,25,41,170,1032,1510
E01033384,20,7,20,52,1329,1428
E01017071,18,34,126,129,1395,1702
E01017072,22,24,44,112,1425,1627
E01017121,31,36,28,117,1494,1706
E01017126,14,25,81,145,1496,1761
E01017059,3,1,33,31,1475,1543
E01017062,3,1,22,20,1575,1621
E01017066,7,8,30,33,1747,1825
E01032604,6,4,24,36,1486,1556
E01016407,13,7,31,67,1394,1512
E01016408,10,41,35,131,1286,1503
E01016410,10,45,66,139,1386,1646
E01016411,11,9,30,54,1467,1571
E01016412,16,30,21,143,1339,1549
E01016386,12,8,24,43,1369,1456
E01016387,5,7,38,45,1454,1549
E01016425,12,8,35,99,1614,1768
E01016426,3,6,37,58,1306,1410
E01016430,3,21,36,74,1284,1418
E01016364,6,23,39,88,1258,1414
E01016409,10,21,49,91,1543,1714
E01016427,13,27,49,88,1441,1618
E01016428,7,23,37,130,1669,1866
E01016429,4,21,36,50,1510,1621
E01016362,18,27,53,126,1290,1514
E01016363,16,145,138,176,1385,1860
E01016365,4,28,33,93,1427,1585
E01016366,10,43,45,99,1385,1582
E01016367,10,97,65,130,1276,1578
E01016380,4,58,54,60,1467,1643
E01016383,2,66,46,40,1330,1484
E01016384,7,23,36,72,1499,1637
E01016431,8,34,29,54,1472,1597
E01016432,3,32,33,61,1340,1469
E01016381,12,115,69,164,1098,1458
E01016382,3,241,131,218,1153,1746
E01016385,7,45,50,97,1467,1666
E01016396,5,153,63,85,969,1275
E01016397,2,159,95,126,1009,1391
E01016355,33,71,59,447,1226,1836
E01016358,24,210,64,334,1092,1724
E01016359,27,306,95,407,1258,2093
E01016360,27,242,96,649,1043,2057
E01016361,8,196,84,285,1170,1743
E01016356,11,208,82,194,1062,1557
E01016357,6,164,82,188,1228,1668
E01016395,18,98,47,130,1095,1388
E01016398,4,167,90,167,1272,1700
E01016399,8,87,53,134,1134,1416
E01016400,12,137,72,148,1112,1481
E01016394,5,96,64,65,1125,1355
E01016433,8,41,36,36,1258,1379
E01016434,6,149,52,142,1421,1770
E01016435,3,54,36,84,1233,1410
E01016436,5,36,59,42,1388,1530
E01016402,14,131,77,321,1368,1911
E01016404,14,250,70,721,995,2050
E01016405,40,147,68,1110,714,2079
E01016406,26,105,49,462,960,1602
E01033417,7,41,32,185,830,1095
E01033421,45,236,92,517,890,1780
E01016353,29,186,101,424,1057,1797
E01016378,44,158,79,565,1237,2083
E01016391,16,180,109,385,1145,1835
E01033415,48,82,68,446,891,1535
E01033418,56,100,54,283,678,1171
E01033420,63,71,38,345,613,1130
E01033422,26,108,41,228,714,1117
E01033423,27,88,35,269,749,1168
E01016401,16,42,47,260,1144,1509
E01016403,8,79,70,356,1438,1951
E01016416,33,100,65,319,1120,1637
E01016417,19,72,60,301,1274,1726
E01016418,20,83,68,218,1251,1640
E01016388,1,97,44,233,1060,1435
E01016389,8,368,117,204,1039,1736
E01016390,15,96,42,239,1148,1540
E01016392,18,176,85,232,1530,2041
E01016393,12,108,51,256,1127,1554
E01016374,46,110,66,304,1100,1626
E01016375,25,136,63,236,798,1258
E01016376,15,80,50,371,1019,1535
E01016379,15,106,55,452,1122,1750
E01016413,45,104,49,307,1259,1764
E01016414,29,149,60,321,1051,1610
E01016419,19,104,67,133,1352,1675
E01016420,2,247,65,105,976,1395
E01016421,9,48,33,92,1134,1316
E01016422,6,95,39,123,1096,1359
E01016423,5,76,82,127,1190,1480
E01016424,5,45,56,147,1070,1323
E01016370,68,197,102,518,2208,3093
E01016371,9,106,68,292,1194,1669
E01016373,15,154,93,135,1118,1515
E01016415,13,294,86,257,961,1611
E01016368,19,101,68,157,1067,1412
E01016372,20,120,90,139,905,1274
E01016377,10,158,106,333,1034,1641
E01016438,2,120,66,112,994,1294
E01016442,19,235,181,442,1928,2805
E01016443,14,146,111,124,1110,1505
E01016369,7,81,64,147,1304,1603
E01016437,3,115,64,203,1030,1415
E01016439,13,173,70,133,1145,1534
E01016440,4,120,76,105,1153,1458
E01016441,7,121,114,114,1093,1449
E01016450,23,216,116,290,964,1609
E01016451,10,334,102,173,1001,1620
E01016452,24,180,70,306,1080,1660
E01016453,14,69,88,153,1235,1559
E01016454,12,149,49,168,1153,1531
E01016455,9,107,60,144,1077,1397
E01016483,62,148,74,945,569,1798
E01016484,52,161,23,727,615,1578
E01016485,42,127,65,893,598,1725
E01016486,20,263,84,420,863,1650
E01016487,89,147,56,1135,350,1777
E01016488,45,146,59,532,1024,1806
E01016493,12,57,52,250,866,1237
E01016494,21,174,68,467,1199,1929
E01016495,11,113,69,304,970,1467
E01016496,17,136,75,134,936,1298
E01016497,45,61,24,411,901,1442
E01016498,19,179,68,256,1120,1642
E01016499,19,315,68,349,591,1342
E01016444,24,94,45,1054,498,1715
E01016445,32,127,80,1029,556,1824
E01016446,52,125,27,1018,391,1613
E01016447,52,164,43,1151,408,1818
E01016448,81,166,38,1598,466,2349
E01016449,38,166,28,1273,626,2131
E01016516,53,86,57,1120,407,1723
E01016517,52,104,41,859,466,1522
E01016518,68,141,51,862,613,1735
E01016519,74,146,69,990,1277,2556
E01016520,38,168,62,692,721,1681
E01016521,52,81,36,784,847,1800
E01016467,58,85,76,412,826,1457
E01016468,26,113,56,412,1105,1712
E01016469,28,135,77,398,1005,1643
E01016470,27,84,65,387,1052,1615
E01016471,26,59,18,252,999,1354
E01016472,22,76,56,432,1080,1666
E01016456,74,199,38,1330,471,2112
E01016457,47,169,55,1284,337,1892
E01016458,37,181,65,859,604,1746
E01016459,49,185,68,1230,678,2210
E01016460,81,130,26,1155,477,1869
E01016461,54,243,81,1331,826,2535
E01016473,48,198,62,731,1097,2136
E01016474,39,209,82,628,999,1957
E01016475,109,155,72,1182,565,2083
E01016476,35,162,86,536,941,1760
E01016477,64,258,99,637,1285,2343
E01016478,44,121,64,760,848,1837
E01016462,40,272,62,1216,805,2395
E01016463,86,258,48,1075,483,1950
E01016464,31,254,44,1100,463,1892
E01016465,91,383,75,1187,996,2732
E01032729,36,292,66,644,598,1636
E01032730,46,245,58,574,589,1512
E01016506,34,138,55,458,1080,1765
E01016507,50,87,30,608,805,1580
E01016508,68,91,45,637,900,1741
E01016509,49,61,44,345,1022,1521
E01016510,61,67,32,807,505,1472
E01016511,31,176,90,682,856,1835
E01016512,51,177,73,580,962,1843
E01016513,72,28,44,1348,435,1927
E01016514,28,149,68,574,922,1741
E01016515,82,43,60,1333,522,2040
E01016500,81,92,51,948,624,1796
E01016501,36,143,48,495,875,1597
E01016502,41,100,57,497,763,1458
E01016503,32,144,46,428,896,1546
E01016504,81,65,16,726,531,1419
E01016505,50,117,64,546,911,1688
E01016490,43,369,85,454,1005,1956
E01016491,41,96,57,414,1099,1707
E01016492,61,116,79,647,770,1673
E01032731,72,161,70,718,526,1547
E01032732,25,159,53,476,905,1618
E01016479,54,178,92,582,686,1592
E01016480,25,63,40,366,883,1377
E01016481,19,101,57,232,1048,1457
E01016482,35,78,56,557,1005,1731
E01017144,28,38,41,232,879,1218
E01017145,66,17,13,246,1085,1427
E01017146,80,42,47,344,1710,2223
E01017148,68,56,48,446,1567,2185
E01017149,43,33,27,343,954,1400
E01017180,10,16,26,96,1343,1491
E01017181,5,16,22,57,1305,1405
E01017183,13,17,32,78,1488,1628
E01017185,7,28,41,141,1550,1767
E01017187,25,39,17,89,1417,1587
E01017264,35,69,85,539,1854,2582
E01017265,7,16,18,49,1542,1632
E01017270,2,30,18,97,1208,1355
E01017271,5,26,28,89,938,1086
E01017182,6,5,14,52,1324,1401
E01017184,5,19,35,36,1312,1407
E01017186,8,21,22,79,1522,1652
E01017188,13,28,56,154,1457,1708
E01017266,22,46,33,239,1102,1442
E01017267,18,43,37,215,925,1238
E01017272,20,11,38,96,1248,1413
E01032756,63,50,93,683,2027,2916
E01017147,18,44,23,114,1233,1432
E01017150,39,13,24,183,1252,1511
E01017151,16,31,19,108,1399,1573
E01017152,22,33,34,153,1321,1563
E01017238,5,20,31,19,1327,1402
E01017241,7,14,20,22,1362,1425
E01017242,2,22,25,39,1344,1432
E01017243,11,39,18,103,1556,1727
E01017244,2,34,19,38,1246,1339
E01017174,3,9,23,71,1212,1318
E01017175,4,5,40,48,1448,1545
E01017176,5,38,35,18,1521,1617
E01017179,14,27,37,45,1338,1461
E01017226,61,12,22,158,1231,1484
E01017231,33,42,46,316,1272,1709
E01017232,23,4,34,95,1104,1260
E01032753,53,35,74,330,1952,2444
E01017246,13,41,48,233,1588,1923
E01017250,5,37,30,63,1280,1415
E01017251,19,38,40,349,1117,1563
E01017253,15,52,33,127,1484,1711
E01017247,25,25,31,128,1428,1637
E01017248,14,9,32,162,1341,1558
E01017249,5,18,24,87,1264,1398
E01017252,16,4,24,159,1361,1564
E01017254,34,37,47,160,1378,1656
E01017236,5,16,28,13,1333,1395
E01017237,5,18,27,28,1426,1504
E01017239,1,13,24,32,1466,1536
E01017240,3,2,15,14,1196,1230
E01017245,2,12,20,49,1417,1500
E01017227,14,23,30,145,1107,1319
E01017228,23,48,53,129,1299,1552
E01017233,8,33,56,144,1372,1613
E01017234,26,47,57,226,1508,1864
E01017235,40,41,49,180,1276,1586
E01017171,10,46,47,131,1606,1840
E01017172,23,52,44,185,1472,1776
E01017173,3,21,36,56,1320,1436
E01017177,9,20,32,69,1380,1510
E01017178,4,18,37,43,1421,1523
E01017207,8,23,26,23,1548,1628
E01017209,10,40,31,74,1285,1440
E01017211,13,62,33,101,1551,1760
E01017212,12,15,44,78,1225,1374
E01017213,15,35,45,112,1308,1515
E01017200,2,22,27,53,1668,1772
E01017201,8,23,22,47,1268,1368
E01017202,9,15,53,33,1565,1675
E01017203,10,20,26,79,1499,1634
E01017204,3,19,22,41,1466,1551
E01017157,33,28,50,153,1312,1576
E01017158,34,51,59,206,1541,1891
E01017159,30,27,59,217,1341,1674
E01017160,33,42,53,159,1194,1481
E01017198,1,9,31,17,1376,1434
E01017199,5,28,38,48,1505,1624
E01017205,4,11,32,31,1287,1365
E01017206,2,19,39,66,1486,1612
E01017208,10,41,34,37,1302,1424
E01017210,9,17,31,40,1435,1532
E01017214,17,12,30,171,1238,1468
E01017215,9,33,24,123,1588,1777
E01017216,7,19,36,82,1320,1464
E01017189,23,63,42,185,1209,1522
E01017190,22,31,38,112,1517,1720
E01017191,14,69,52,216,1381,1732
E01017196,20,40,91,206,1658,2015
E01017197,16,19,28,127,1330,1520
E01017192,15,71,54,228,1655,2023
E01017193,14,46,60,116,1421,1657
E01017194,12,48,56,158,1524,1798
E01017195,27,56,75,120,1672,1950
E01017153,40,130,54,999,408,1631
E01017154,64,295,120,612,1198,2289
E01017155,48,125,59,856,610,1698
E01017156,19,175,43,1145,431,1813
E01032738,31,64,45,118,1038,1296
E01032750,58,92,55,281,1009,1495
E01017136,13,33,46,153,1378,1623
E01017137,10,75,62,64,1508,1719
E01017138,59,60,69,177,1960,2325
E01017140,21,65,49,206,1156,1497
E01017217,15,11,15,77,1426,1544
E01017223,10,16,40,58,1554,1678
E01017224,0,14,21,35,1283,1353
E01017225,14,13,21,34,1470,1552
E01017162,7,7,20,16,1385,1435
E01017163,4,29,42,26,1448,1549
E01017164,2,21,39,34,1407,1503
E01017165,0,12,31,19,1396,1458
E01017166,1,25,48,25,1408,1507
E01017256,14,16,29,38,1932,2029
E01017257,5,31,16,27,1481,1560
E01017259,1,4,28,15,1403,1451
E01017260,4,8,12,9,1349,1382
E01017262,1,8,27,12,1287,1335
E01017167,12,16,49,53,1397,1527
E01017168,2,19,29,37,1608,1695
E01017169,8,9,29,24,1484,1554
E01017170,2,10,30,18,1512,1572
E01017218,2,11,35,11,1294,1353
E01017219,7,36,34,63,1589,1729
E01017220,17,27,31,29,1739,1843
E01017221,7,15,27,50,1525,1624
E01017222,1,20,41,35,1430,1527
E01017139,73,113,93,456,1671,2406
E01017142,123,52,58,181,1953,2367
E01032745,89,122,109,326,1652,2298
E01032746,104,31,27,146,857,1165
E01032748,46,33,49,96,856,1080
E01032751,52,40,40,144,905,1181
E01032755,27,162,58,305,549,1101
E01017255,1,13,27,23,1530,1594
E01017258,2,9,42,11,1494,1558
E01017261,4,19,46,17,1629,1715
E01017263,17,11,22,21,1358,1429
E01017273,0,21,26,21,1367,1435
E01017275,4,9,29,15,1586,1643
E01017276,4,45,47,53,1569,1718
E01017278,6,18,24,14,1273,1335
E01017279,3,17,34,33,1604,1691
E01017274,4,14,29,2,1441,1490
E01017277,8,11,36,11,1436,1502
E01017280,3,10,26,17,1338,1394
E01017281,12,12,40,13,1567,1644
E01016277,8,13,25,31,1499,1576
E01016286,2,3,25,26,1515,1571
E01016287,2,1,13,13,1435,1464
E01016288,1,1,25,16,1608,1651
E01016303,0,1,6,7,1458,1472
E01016304,6,5,10,24,1499,1544
E01016305,1,6,20,27,1191,1245
E01016306,0,2,8,10,1294,1314
E01016256,0,6,22,23,1696,1747
E01016257,2,7,30,13,1304,1356
E01016313,4,4,26,19,1558,1611
E01016314,2,11,30,27,1297,1367
E01016315,2,31,29,25,1494,1581
E01016316,7,38,51,57,1845,1998
E01016317,5,21,40,71,1289,1426
E01016318,5,8,24,58,1448,1543
E01016258,3,14,36,29,1460,1542
E01016261,6,33,31,52,1525,1647
E01016349,0,13,31,26,1160,1230
E01016350,7,21,26,31,1441,1526
E01016259,4,31,37,54,1424,1550
E01016260,8,44,64,93,1501,1710
E01016262,6,21,29,21,1263,1340
E01016272,7,46,45,108,1337,1543
E01016273,3,48,58,64,1341,1514
E01016263,2,9,28,30,2189,2258
E01016278,1,11,17,42,1243,1314
E01016283,3,22,28,42,1922,2017
E01016284,2,4,18,6,1411,1441
E01016285,1,1,9,10,1572,1593
E01016271,4,68,40,92,1197,1401
E01016274,2,47,39,134,1164,1386
E01016275,6,34,36,70,1324,1470
E01016276,9,41,29,59,1333,1471
E01016327,0,1,14,19,1162,1196
E01016328,3,16,23,15,1700,1757
E01016344,2,19,38,45,1384,1488
E01016345,2,6,22,36,1281,1347
E01016296,1,2,12,15,1535,1565
E01016297,0,1,8,11,1526,1546
E01016298,8,9,21,18,1118,1174
E01016299,4,1,6,19,1452,1482
E01016254,7,8,25,19,1282,1341
E01016255,2,5,10,20,1473,1510
E01016264,2,9,27,44,1536,1618
E01016265,6,3,24,15,1431,1479
E01016266,0,0,7,3,1365,1375
E01016339,11,36,66,93,2707,2913
E01016310,0,14,18,30,1742,1804
E01016311,4,22,17,88,1479,1610
E01016323,3,2,17,29,1330,1381
E01016324,9,1,22,8,1352,1392
E01016325,9,7,18,35,1469,1538
E01016279,10,31,39,131,1888,2099
E01016280,9,30,19,82,1691,1831
E01016281,2,17,15,32,1356,1422
E01016282,0,10,28,39,1398,1475
E01016329,1,9,18,19,1414,1461
E01016340,0,13,8,13,1539,1573
E01016341,1,12,42,16,1331,1402
E01016342,4,31,21,25,1886,1967
E01016343,1,2,15,10,1420,1448
E01016267,3,8,12,22,1379,1424
E01016268,11,18,17,31,1517,1594
E01016269,1,7,17,32,1350,1407
E01016270,7,3,38,15,1467,1530
E01016330,1,12,21,15,1371,1420
E01016331,1,14,44,16,1526,1601
E01016332,5,10,22,41,1473,1551
E01016334,2,13,30,59,1631,1735
E01016336,1,11,7,7,1252,1278
E01016333,5,10,22,22,1238,1297
E01016335,1,9,13,30,1507,1560
E01016337,7,28,37,61,2046,2179
E01016338,2,5,20,44,1811,1882
E01016300,1,2,15,12,1431,1461
E01016301,1,8,26,15,1880,1930
E01016302,1,1,19,12,1610,1643
E01016326,1,3,6,3,1338,1351
E01016293,5,27,54,87,2511,2684
E01016346,5,4,20,108,1197,1334
E01016347,14,15,20,146,1299,1494
E01016348,10,34,33,164,1783,2024
E01016294,0,11,26,41,1415,1493
E01016295,0,4,22,28,1451,1505
E01016312,4,24,19,44,1849,1940
E01016319,5,19,21,39,1563,1647
E01016320,5,11,29,24,1311,1380
E01016289,3,2,18,33,1371,1427
E01016290,5,6,28,31,1479,1549
E01016291,11,3,32,38,1699,1783
E01016292,0,7,20,21,1554,1602
E01016321,15,7,20,58,1383,1483
E01016322,4,3,14,20,1248,1289
E01016307,0,10,25,15,1541,1591
E01016308,4,10,27,28,1819,1888
E01016309,1,34,41,107,2070,2253
E01016570,18,6,27,164,1380,1595
E01016572,14,0,30,129,1172,1345
E01016582,24,12,28,601,810,1475
E01016600,1,4,16,45,1109,1175
E01016530,1,4,15,41,1433,1494
E01016531,4,8,18,33,1378,1441
E01016532,6,7,24,58,1920,2015
E01016533,1,3,29,21,1874,1928
E01016578,5,6,39,33,1391,1474
E01016579,8,20,22,46,1601,1697
E01016581,6,7,24,23,1381,1441
E01016571,3,8,44,145,1354,1554
E01016573,6,4,45,258,1087,1400
E01016574,13,26,29,346,1085,1499
E01016599,11,9,28,141,1425,1614
E01016583,22,16,28,193,1330,1589
E01016585,17,11,35,170,1387,1620
E01016586,12,11,26,107,1198,1354
E01016591,20,11,35,282,1356,1704
E01016592,16,23,41,284,1485,1849
E01016525,6,16,32,139,1410,1603
E01016528,18,25,35,295,1248,1621
E01016529,20,27,45,414,1132,1638
E01016536,26,34,40,271,1484,1855
E01016584,40,25,59,349,1202,1675
E01032733,24,16,27,124,835,1026
E01032734,16,16,40,311,1052,1435
E01016526,16,23,36,154,1623,1852
E01016527,3,22,43,153,1380,1601
E01016534,10,7,22,176,1315,1530
E01016598,9,9,27,61,1304,1410
E01016601,19,16,42,120,1423,1620
E01016602,13,5,30,77,1448,1573
E01016535,5,11,37,316,904,1273
E01016537,25,53,48,503,900,1529
E01016538,17,31,45,245,1273,1611
E01016593,14,44,24,148,1445,1675
E01016594,15,14,28,151,1244,1452
E01016559,6,15,24,74,1358,1477
E01016560,18,37,39,98,1326,1518
E01016561,10,22,39,176,1537,1784
E01016562,5,8,22,136,1213,1384
E01016563,12,17,19,88,1206,1342
E01016580,11,7,42,65,1392,1517
E01016539,9,21,37,182,1340,1589
E01016540,4,35,37,180,1409,1665
E01016541,7,12,31,198,1136,1384
E01016542,4,4,30,71,1093,1202
E01016543,7,5,15,62,1554,1643
E01016544,15,44,44,109,1493,1705
E01016567,15,38,91,156,2448,2748
E01016568,7,13,19,42,1159,1240
E01016569,8,3,26,35,948,1020
E01016564,32,14,25,239,1318,1628
E01016565,23,17,40,212,1271,1563
E01016566,6,33,65,223,1395,1722
E01016577,17,32,35,311,1288,1683
E01016545,21,24,57,96,1740,1938
E01016547,6,15,42,90,1535,1688
E01016550,3,39,41,81,1362,1526
E01016552,25,10,45,98,1428,1606
E01016551,15,17,40,132,1373,1577
E01016553,0,11,19,93,1347,1470
E01016557,17,34,33,97,1690,1871
E01016558,21,126,46,107,1396,1696
E01016548,35,32,69,135,1641,1912
E01016549,18,31,58,154,1751,2012
E01016554,9,21,42,151,1397,1620
E01016555,7,24,49,108,1267,1455
E01016556,13,25,41,129,1566,1774
E01016546,6,14,40,131,1430,1621
E01016595,10,16,50,122,1522,1720
E01016596,25,32,46,146,1544,1793
E01016597,22,31,46,298,1380,1777
E01016575,25,5,40,255,1341,1666
E01016576,16,15,43,247,1393,1714
E01016587,18,7,26,105,1431,1587
E01016588,3,16,43,69,1639,1770
E01016589,23,10,31,110,1446,1620
E01016522,18,28,16,116,1779,1957
E01016523,10,17,36,104,1473,1640
E01016524,16,56,62,130,1841,2105
E01016609,22,27,76,120,1569,1814
E01016603,13,16,46,126,1600,1801
E01016604,6,15,66,166,1762,2015
E01016605,3,4,22,104,1398,1531
E01016606,6,2,28,95,1508,1639
E01016607,10,20,47,68,1620,1765
E01016608,5,18,46,81,1674,1824
E01016675,1,1,16,18,996,1032
E01016676,1,3,22,23,1488,1537
E01016677,2,8,17,18,1443,1488
E01016678,13,3,15,23,1310,1364
E01016619,4,11,30,70,1446,1561
E01016620,1,10,39,99,1332,1481
E01016692,4,3,37,30,1362,1436
E01016693,4,6,23,33,1286,1352
E01016694,2,5,27,41,1379,1454
E01016695,3,4,16,51,1475,1549
E01016621,8,20,28,103,1319,1478
E01016623,4,11,14,96,1364,1489
E01016624,10,6,28,92,1302,1438
E01016684,12,22,29,116,1419,1598
E01016685,13,19,42,191,1366,1631
E01016622,3,7,10,42,1187,1249
E01016657,3,11,25,29,1415,1483
E01016658,13,17,27,75,1206,1338
E01016659,18,15,27,79,1271,1410
E01016660,8,19,25,51,1524,1627
E01016615,16,41,39,231,1192,1519
E01016616,11,32,26,138,1282,1489
E01016617,20,0,10,72,1140,1242
E01016662,21,42,50,127,1484,1724
E01016613,34,99,54,617,730,1534
E01016614,29,46,42,478,790,1385
E01016618,24,34,40,274,911,1283
E01016664,11,11,42,164,1046,1274
E01016668,15,56,36,241,1239,1587
E01016669,59,40,37,370,1321,1827
E01016661,12,18,24,119,1197,1370
E01016663,11,23,22,141,1340,1537
E01016686,1,29,21,57,1031,1139
E01016687,5,26,28,147,1073,1279
E01016688,13,39,42,138,1356,1588
E01016689,0,11,20,42,1345,1418
E01016652,23,35,35,187,996,1276
E01016653,10,57,30,217,1180,1494
E01016665,12,45,38,237,1260,1592
E01016666,23,25,31,183,1121,1383
E01032761,20,51,46,297,2329,2743
E01016647,18,53,75,298,1477,1921
E01016701,7,25,33,122,1559,1746
E01016702,12,29,26,209,1552,1828
E01016703,15,33,58,133,1687,1926
E01016704,16,38,66,133,1764,2017
E01016627,10,7,23,66,1739,1845
E01016628,4,6,12,66,1446,1534
E01016656,12,5,17,39,1330,1403
E01016700,30,16,37,170,1637,1890
E01016644,33,23,40,269,1100,1465
E01016645,20,39,35,208,1237,1539
E01016646,37,28,32,187,1302,1586
E01016648,32,41,39,216,1106,1434
E01016649,13,24,34,215,1154,1440
E01016651,28,66,38,237,1037,1406
E01016654,43,27,43,204,1080,1397
E01016655,31,27,23,154,1067,1302
E01016679,36,101,102,289,1667,2195
E01016680,24,63,44,208,956,1295
E01032758,4,49,54,125,1361,1593
E01032759,8,36,31,97,1278,1450
E01016626,6,9,54,81,1479,1629
E01016671,3,7,33,56,1601,1700
E01016673,2,9,56,49,1608,1724
E01016674,7,19,38,48,1298,1410
E01016696,1,13,32,53,1377,1476
E01016670,16,24,38,80,1900,2058
E01016672,7,14,22,46,1672,1761
E01032763,9,9,28,57,2178,2281
E01016612,7,14,34,60,2099,2214
E01016629,1,12,13,34,1312,1372
E01016630,8,12,20,97,1395,1532
E01016635,11,3,31,57,1292,1394
E01016625,5,12,24,48,1582,1671
E01016631,5,9,22,92,1231,1359
E01016632,3,4,19,58,1427,1511
E01016634,2,9,26,47,1449,1533
E01016699,1,6,18,92,1421,1538
E01016682,5,18,53,63,1720,1859
E01016683,14,3,43,51,1767,1878
E01016690,13,13,41,47,1660,1774
E01016691,0,8,23,29,1144,1204
E01016610,6,28,66,128,2632,2860
E01016611,6,20,20,43,1300,1389
E01016641,1,5,22,55,1337,1420
E01016642,6,14,27,29,1079,1155
E01016633,5,1,12,34,1310,1362
E01016636,8,2,35,31,1388,1464
E01016637,1,14,22,20,1027,1084
E01016638,0,2,25,35,1258,1320
E01016639,9,11,31,45,1499,1595
E01016640,2,8,21,37,1484,1552
E01016643,6,5,35,50,1291,1387
E01016705,20,14,30,73,1430,1567
E01016706,2,6,30,62,1567,1667
E01016707,2,4,19,42,1545,1612
E01016708,9,27,27,45,1486,1594
E01016709,3,8,20,62,1491,1584
E01017648,12,7,22,44,1721,1806
E01017649,11,91,34,87,1877,2100
E01017650,4,17,38,62,1547,1668
E01032960,6,47,38,34,2924,3049
E01017644,13,21,19,23,1425,1501
E01017645,29,133,41,205,1105,1513
E01017646,5,27,30,36,1732,1830
E01017647,8,5,22,20,1570,1625
E01017671,6,14,29,16,1526,1591
E01017672,1,12,8,17,1445,1483
E01017695,1,9,19,17,1148,1194
E01017696,2,12,20,16,1213,1263
E01017693,3,1,7,12,1060,1083
E01017694,12,11,26,25,2255,2329
E01017713,1,4,13,2,1416,1436
E01017714,1,5,18,9,1300,1333
E01017717,4,9,24,13,1648,1698
E01017718,2,3,20,23,1529,1577
E01017735,5,6,19,10,1278,1318
E01017736,5,6,33,14,1468,1526
E01017737,1,3,7,7,1333,1351
E01017738,4,11,18,15,1482,1530
E01017669,2,1,16,18,1457,1494
E01017670,1,5,18,22,1502,1548
E01017715,1,2,9,3,1156,1171
E01017716,2,13,25,13,1787,1840
E01017641,11,9,31,29,1625,1705
E01017731,1,6,10,13,1293,1323
E01017732,2,3,17,16,1384,1422
E01017733,1,8,10,7,1171,1197
E01017734,3,6,21,19,1345,1394
E01017703,0,3,6,11,1272,1292
E01017704,3,5,13,3,1235,1259
E01017719,5,14,15,22,1143,1199
E01017720,2,4,19,19,1270,1314
E01032958,8,6,19,15,1474,1522
E01032959,13,61,97,208,1369,1748
E01017651,0,3,22,21,1511,1557
E01017652,0,5,19,11,1431,1466
E01017657,6,3,16,34,1362,1421
E01017658,6,3,15,15,1387,1426
E01017701,4,3,20,15,2165,2207
E01017702,4,3,12,7,1441,1467
E01017642,3,2,22,13,1229,1269
E01017643,0,4,17,22,1266,1309
E01017673,0,2,9,17,1274,1302
E01017674,4,66,54,53,1693,1870
E01017659,29,74,58,338,1109,1608
E01017660,6,36,56,90,1501,1689
E01017661,25,40,87,281,1132,1565
E01017664,5,23,22,91,1263,1404
E01017705,4,38,44,44,1045,1175
E01017706,6,73,60,121,1169,1429
E01017707,7,54,62,277,910,1310
E01017708,7,117,78,246,1116,1564
E01017665,6,44,82,238,1227,1597
E01017666,23,86,54,288,1236,1687
E01017667,11,55,83,212,1008,1369
E01017668,5,78,52,107,1292,1534
E01017697,1,49,42,90,1244,1426
E01017698,6,48,66,162,1202,1484
E01017699,16,109,87,143,1084,1439
E01017700,3,30,23,68,1423,1547
E01017634,7,66,45,351,1080,1549
E01017662,8,60,64,266,910,1308
E01017663,33,70,48,622,821,1594
E01032955,5,31,37,63,1097,1233
E01032961,6,66,57,100,810,1039
E01017653,12,35,31,120,1283,1481
E01017654,13,74,63,415,867,1432
E01017655,6,77,58,89,1716,1946
E01032956,4,26,37,60,1502,1629
E01032957,4,44,40,54,1214,1356
E01032962,7,39,36,35,1437,1554
E01017635,11,34,18,69,1307,1439
E01017636,14,12,25,64,1445,1560
E01017637,5,27,29,88,1186,1335
E01017638,2,10,12,88,1194,1306
E01017639,4,11,35,118,1426,1594
E01017640,4,15,25,89,1437,1570
E01017709,29,39,57,376,1186,1687
E01017710,3,50,81,229,1188,1551
E01017711,13,52,78,253,1177,1573
E01017712,18,111,93,473,1406,2101
E01017687,15,136,92,274,1513,2030
E01017688,14,41,42,89,1046,1232
E01017689,9,16,23,89,1252,1389
E01017690,7,14,37,74,1016,1148
E01017691,3,23,21,41,1282,1370
E01017692,17,76,39,143,1282,1557
E01017721,10,60,40,107,1358,1575
E01017722,8,56,37,89,1320,1510
E01017723,17,61,52,240,1002,1372
E01017724,23,112,75,280,935,1425
E01017627,3,11,17,19,1549,1599
E01017628,2,17,26,55,1656,1756
E01017629,2,8,23,28,1534,1595
E01017630,2,3,16,21,1502,1544
E01017631,6,6,32,60,1482,1586
E01017632,1,3,12,29,1516,1561
E01017675,3,4,13,7,1404,1431
E01017676,2,0,21,7,1398,1428
E01017677,2,3,10,16,1311,1342
E01017678,5,11,24,41,1216,1297
E01017679,8,12,45,44,1506,1615
E01017680,1,1,5,7,978,992
E01017681,4,3,20,6,1199,1232
E01017682,3,3,13,7,1193,1219
E01017683,1,4,19,12,1664,1700
E01017684,4,0,10,3,1091,1108
E01017726,0,4,19,8,1109,1140
E01017727,0,7,22,12,1659,1700
E01017728,7,15,51,95,2069,2237
E01017729,0,7,18,33,1638,1696
E01017730,1,9,28,18,1505,1561
E01017750,6,2,36,28,2131,2203
E01017752,2,4,30,47,2120,2203
E01017766,0,1,20,18,2265,2304
E01017778,6,4,28,14,1253,1305
E01017747,2,12,58,249,1088,1409
E01017748,6,43,35,339,1382,1805
E01017749,10,14,39,61,1512,1636
E01017789,9,8,21,64,1120,1222
E01017790,5,35,36,177,1129,1382
E01017795,6,17,64,269,1783,2139
E01017769,5,5,13,58,1503,1584
E01017771,0,1,17,61,1381,1460
E01017780,6,11,32,104,1109,1262
E01017781,5,20,33,342,812,1212
E01017770,3,10,69,250,1165,1497
E01017791,1,22,51,63,1354,1491
E01017792,10,17,63,104,1669,1863
E01017793,1,10,29,60,1421,1521
E01017768,1,8,47,32,2224,2312
E01017779,2,10,18,27,1106,1163
E01017785,0,11,17,17,1632,1677
E01017786,2,4,31,30,1486,1553
E01017787,1,3,16,22,1572,1614
E01017788,4,6,27,34,1682,1753
E01017741,1,14,45,61,1502,1623
E01017742,9,13,71,95,1507,1695
E01017743,2,5,52,103,1457,1619
E01017763,9,13,45,129,1522,1718
E01017764,5,7,39,77,1625,1753
E01017765,4,3,45,80,1632,1764
E01017739,11,6,24,69,1144,1254
E01017740,3,7,48,121,1148,1327
E01017744,1,9,16,63,1358,1447
E01017745,6,19,41,109,1593,1768
E01017746,8,6,23,101,1395,1533
E01017762,3,6,37,97,1329,1472
E01017775,6,8,52,128,1370,1564
E01017776,6,13,45,160,1395,1619
E01017777,7,12,33,142,1443,1637
E01017759,5,6,36,33,1735,1815
E01017760,6,11,40,73,1569,1699
E01017761,2,4,49,38,2039,2132
E01017794,9,4,34,37,2227,2311
E01017754,7,14,26,85,1439,1571
E01017755,2,5,40,94,1373,1514
E01017756,5,3,37,59,1388,1492
E01017757,5,1,18,52,1149,1225
E01017758,3,6,30,132,1095,1266
E01017751,11,8,40,103,2041,2203
E01017753,14,10,33,43,1159,1259
E01017767,11,4,57,95,2069,2236
E01017773,0,4,21,19,1489,1533
E01017774,4,5,18,20,1249,1296
E01017782,3,3,37,45,1354,1442
E01017783,4,3,24,19,1443,1493
E01017784,6,7,37,66,1459,1575
E01032609,5,7,17,28,1153,1210
E01017796,2,3,29,125,1640,1799
E01017797,8,2,40,56,1407,1513
E01017798,17,5,29,76,1665,1792
E01017799,21,8,50,137,1792,2008
E01017800,7,39,59,86,1590,1781
E01017801,7,14,41,167,1395,1624
E01017802,7,5,41,83,1428,1564
E01017818,14,18,60,326,1539,1957
E01017819,10,4,63,233,1284,1594
E01017820,16,9,26,73,1477,1601
E01017821,29,10,63,300,1196,1598
E01017822,72,22,48,507,1294,1943
E01017810,4,44,50,91,1540,1729
E01017811,1,7,13,111,1078,1210
E01017812,18,35,61,126,1427,1667
E01017813,17,13,39,214,1574,1857
E01017815,18,8,51,227,1525,1829
E01017816,10,9,32,164,1453,1668
E01017817,12,27,63,283,1617,2002
E01017823,6,8,20,55,1269,1358
E01017830,15,17,27,160,1603,1822
E01017831,17,13,39,343,1304,1716
E01017832,41,29,60,393,1164,1687
E01017834,29,22,35,381,1075,1542
E01017835,10,28,51,194,1426,1709
E01017803,11,9,19,137,1134,1310
E01017806,17,18,39,108,1503,1685
E01017814,18,16,28,220,1259,1541
E01017833,12,13,17,84,1543,1669
E01017804,7,13,34,100,1363,1517
E01017805,3,47,59,71,1673,1853
E01017807,16,32,35,144,1269,1496
E01017808,10,16,33,123,1298,1480
E01017809,2,31,27,82,1358,1500
E01017824,39,14,44,279,1314,1690
E01017825,17,21,24,186,1496,1744
E01017826,8,14,24,124,1341,1511
E01017827,25,33,61,176,1376,1671
E01017828,9,9,38,91,1486,1633
E01017829,51,24,35,697,1190,1997
E01017929,5,17,21,46,1579,1668
E01017930,5,7,31,34,1663,1740
E01017931,3,11,25,16,1341,1396
E01017932,1,9,28,43,1492,1573
E01017933,4,14,41,24,1641,1724
E01017885,3,7,20,31,1646,1707
E01017886,1,12,19,23,1431,1486
E01017887,5,2,32,16,1092,1147
E01017888,0,34,26,25,1627,1712
E01017869,2,4,23,24,1281,1334
E01017870,2,4,25,30,1181,1242
E01017871,10,2,21,40,1500,1573
E01017872,1,13,16,28,1585,1643
E01017873,1,5,15,30,1370,1421
E01017874,4,13,20,73,1039,1149
E01017915,11,22,45,16,1267,1361
E01017916,1,3,8,31,1151,1194
E01017917,1,14,13,43,1398,1469
E01017918,5,31,23,36,1435,1530
E01017857,11,136,67,432,762,1408
E01017858,2,108,68,309,1130,1617
E01017859,8,64,44,305,995,1416
E01017860,1,102,41,357,949,1450
E01017861,6,33,34,143,1447,1663
E01017862,7,36,53,140,1644,1880
E01017863,0,35,52,182,1466,1735
E01017842,5,25,42,53,2880,3005
E01017853,4,23,15,105,1198,1345
E01017854,1,10,27,10,1240,1288
E01017878,11,27,31,32,2547,2648
E01017920,6,36,33,126,1055,1256
E01017921,10,120,66,223,1374,1793
E01017922,3,83,75,332,1151,1644
E01017923,25,132,57,312,972,1498
E01017924,33,63,61,226,1261,1644
E01017937,9,7,45,61,1426,1548
E01017938,2,11,25,53,1269,1360
E01017940,9,22,26,62,1382,1501
E01017942,3,8,33,42,1424,1510
E01017850,11,114,86,474,687,1372
E01017851,17,134,75,436,1047,1709
E01017852,14,195,44,1406,834,2493
E01017919,12,65,42,167,1060,1346
E01017925,14,137,100,415,1441,2107
E01017926,14,183,118,177,1008,1500
E01017927,3,56,51,344,1104,1558
E01017928,6,94,49,197,1051,1397
E01017911,7,101,107,469,1039,1723
E01017912,6,63,59,285,988,1401
E01017913,4,111,90,486,1035,1726
E01017914,2,40,40,215,1067,1364
E01017903,20,116,70,920,528,1654
E01017904,5,165,63,758,755,1746
E01017905,32,211,77,905,956,2181
E01017906,26,134,65,1331,424,1980
E01017907,22,170,71,850,732,1845
E01017899,14,177,59,209,1197,1656
E01017900,7,108,63,193,972,1343
E01017901,10,89,87,108,912,1206
E01017902,7,197,109,250,1039,1602
E01017836,4,120,71,655,807,1657
E01017837,11,196,99,541,1349,2196
E01017838,12,99,49,615,784,1559
E01017839,8,94,77,316,1226,1721
E01017840,12,105,66,419,1201,1803
E01017841,17,28,37,288,1059,1429
E01017908,16,182,146,216,1945,2505
E01017909,23,118,115,221,1705,2182
E01017910,10,90,83,269,1949,2401
E01017941,5,49,34,61,1249,1398
E01017843,3,37,34,126,1350,1550
E01017844,9,124,66,328,1220,1747
E01017845,14,179,55,279,1150,1677
E01017855,6,14,33,22,1360,1435
E01017856,9,62,22,73,1250,1416
E01017864,3,10,12,20,1294,1339
E01017865,0,2,31,23,1487,1543
E01017867,3,24,66,70,1382,1545
E01017868,9,11,20,21,1477,1538
E01017934,5,57,71,80,1524,1737
E01017935,7,15,43,48,1857,1970
E01017936,10,11,21,29,1483,1554
E01017939,1,20,27,106,1212,1366
E01017866,2,7,11,20,1398,1438
E01017875,3,14,15,23,1468,1523
E01017876,3,12,43,53,1965,2076
E01017877,11,19,57,78,1508,1673
E01017846,0,5,37,83,1262,1387
E01017847,1,7,23,29,1474,1534
E01017848,1,5,7,21,1177,1211
E01017849,4,11,28,40,1316,1399
E01017889,17,17,36,33,1198,1301
E01017890,2,6,6,13,1280,1307
E01017891,3,4,13,32,1380,1432
E01017892,0,3,29,25,1527,1584
E01017893,5,17,36,56,1466,1580
E01017894,0,15,41,21,1518,1595
E01017895,6,20,38,31,1222,1317
E01017896,5,4,30,27,1343,1409
E01017897,13,14,26,52,1471,1576
E01017898,3,31,37,38,1115,1224
E01017880,0,5,16,24,1378,1423
E01017881,7,26,58,83,1703,1877
E01017882,7,4,30,53,1525,1619
E01017883,13,32,27,123,1444,1639
E01017884,11,6,19,28,1378,1442
E01032610,11,38,36,64,1474,1623
E01020924,10,7,18,24,1359,1418
E01020925,9,10,41,31,1432,1523
E01020927,11,22,30,35,1405,1503
E01020928,7,5,14,16,1526,1568
E01020930,10,3,27,25,1415,1480
E01020917,6,14,46,50,1385,1501
E01020918,9,19,34,65,1492,1619
E01020919,1,4,20,37,1484,1546
E01020923,5,37,32,61,1317,1452
E01020949,4,4,28,43,1498,1577
E01020926,1,12,14,23,1563,1613
E01020929,14,12,35,41,1499,1601
E01020955,2,1,15,26,1454,1498
E01020956,0,8,13,23,1531,1575
E01020957,4,7,13,36,1432,1492
E01020920,3,20,19,19,1410,1471
E01020921,0,13,23,21,1449,1506
E01020922,7,10,31,36,1412,1496
E01020945,19,10,34,68,1711,1842
E01020950,4,14,26,31,1548,1623
E01020940,5,3,19,19,1463,1509
E01020941,18,8,23,41,1603,1693
E01020942,7,5,19,22,1511,1564
E01020946,8,4,11,28,1670,1721
E01020947,10,5,27,33,1422,1497
E01020914,5,12,53,63,1801,1934
E01020915,7,17,23,31,1621,1699
E01020952,6,5,30,32,1722,1795
E01020953,1,4,20,32,1473,1530
E01020954,1,3,43,17,1701,1765
E01020948,12,22,24,207,1169,1434
E01020963,19,22,23,33,1602,1699
E01020965,9,22,27,56,1750,1864
E01020966,2,19,37,52,1621,1731
E01020938,7,4,16,31,1516,1574
E01020939,5,3,34,28,1507,1577
E01020943,2,4,35,16,1536,1593
E01020964,11,12,27,22,1578,1650
E01020967,9,13,20,32,1746,1820
E01020910,11,19,34,65,1580,1709
E01020911,37,46,88,164,1655,1990
E01020912,38,32,79,127,1759,2035
E01020916,16,13,40,97,1520,1686
E01020935,19,20,39,77,1688,1843
E01020936,10,20,32,68,1591,1721
E01020937,8,19,27,70,1510,1634
E01020968,13,33,40,42,1572,1700
E01020931,4,13,29,45,1758,1849
E01020932,4,2,11,20,1344,1381
E01020933,8,9,19,119,892,1047
E01020934,7,7,29,13,1194,1250
E01020944,2,4,17,35,1485,1543
E01020913,12,15,48,55,1984,2114
E01020951,14,8,19,17,1455,1513
E01020959,2,7,13,23,1412,1457
E01020961,11,19,12,28,1342,1412
E01020962,5,19,21,44,1915,2004
E01020960,5,25,48,68,2309,2455
E01032831,7,4,38,35,1494,1578
E01032832,10,20,58,35,1477,1600
E01032833,22,10,26,42,1238,1338
E01020969,3,5,18,20,1473,1519
E01020970,13,7,33,56,2580,2689
E01020971,12,28,24,36,1937,2037
E01020987,23,15,36,131,1592,1797
E01020974,0,15,11,18,1493,1537
E01020986,8,12,30,46,1377,1473
E01020988,10,5,21,31,1632,1699
E01021007,4,3,13,9,1413,1442
E01021008,20,7,36,23,1501,1587
E01021009,11,4,22,27,1880,1944
E01020993,1,15,28,10,1289,1343
E01020994,5,18,36,13,1461,1533
E01020995,4,13,34,18,1362,1431
E01020996,2,20,47,30,1693,1792
E01021019,12,20,28,30,1517,1607
E01021004,8,13,14,11,1739,1785
E01021005,4,20,40,33,1520,1617
E01021006,6,30,27,17,1713,1793
E01021013,6,6,30,16,1769,1827
E01020972,7,25,37,22,1458,1549
E01020973,11,9,53,18,1661,1752
E01020977,10,12,43,26,1497,1588
E01021015,5,20,30,14,1537,1606
E01021010,4,5,42,36,1495,1582
E01021011,5,10,44,41,1460,1560
E01021012,10,14,48,35,1557,1664
E01021020,1,7,25,27,1790,1850
E01021021,6,32,32,44,1778,1892
E01021000,2,15,20,12,1437,1486
E01021001,5,6,14,4,1208,1237
E01021002,8,19,32,16,1393,1468
E01021003,11,14,23,17,1606,1671
E01021014,6,11,57,26,1784,1884
E01020975,15,16,48,20,1711,1810
E01020976,7,39,70,40,1757,1913
E01020990,14,26,46,57,1510,1653
E01020991,6,18,50,32,1228,1334
E01020992,20,48,57,81,1636,1842
E01020978,10,49,56,90,1742,1947
E01020979,8,25,45,82,1674,1834
E01020980,9,12,45,25,1492,1583
E01020981,4,16,38,32,1533,1623
E01020997,13,14,39,32,1540,1638
E01020998,4,14,43,56,1733,1850
E01020999,8,19,25,50,1826,1928
E01021016,1,16,22,36,1570,1645
E01021017,7,13,36,29,1519,1604
E01021018,6,22,25,19,1843,1915
E01020982,28,63,53,159,1439,1742
E01020983,19,55,58,91,1434,1657
E01020984,27,65,59,106,1694,1951
E01020985,20,38,56,82,1586,1782
E01020989,15,42,49,94,1562,1762
E01021022,2,1,28,13,2061,2105
E01021024,0,7,7,13,1183,1210
E01021025,3,5,29,15,1826,1878
E01021052,3,0,9,3,1252,1267
E01021053,1,1,14,2,1172,1190
E01021023,1,1,19,16,1943,1980
E01021026,4,2,32,12,2374,2424
E01021032,8,14,20,28,2036,2106
E01021067,0,2,8,19,1094,1123
E01021068,3,0,6,2,1142,1153
E01021033,1,2,25,24,1699,1751
E01021034,1,10,18,26,1262,1317
E01021035,5,3,35,37,1630,1710
E01021036,1,5,26,16,1421,1469
E01021037,6,7,17,36,1529,1595
E01021038,3,14,56,39,1641,1753
E01021054,0,0,16,15,1416,1447
E01021055,2,11,34,6,1694,1747
E01021056,1,3,17,19,1663,1703
E01021057,3,8,11,4,1499,1525
E01021039,2,4,34,42,1370,1452
E01021040,14,14,58,33,1608,1727
E01021041,3,11,39,22,1495,1570
E01021042,2,2,21,22,1299,1346
E01021043,3,0,25,18,1561,1607
E01021027,5,4,31,21,1496,1557
E01021028,9,3,33,51,1518,1614
E01021029,11,15,17,27,1478,1548
E01021030,5,7,20,28,1196,1256
E01021031,3,8,14,48,1429,1502
E01021061,5,12,28,23,1478,1546
E01021063,9,25,15,28,1626,1703
E01021064,3,14,20,29,1542,1608
E01021065,2,19,26,25,1117,1189
E01021066,4,1,9,27,1503,1544
E01021045,1,2,15,11,1765,1794
E01021046,4,0,13,10,1492,1519
E01021047,3,3,15,11,1390,1422
E01021048,12,22,21,38,1458,1551
E01021044,9,5,35,33,1837,1919
E01021049,5,11,29,8,1383,1436
E01021050,2,0,13,23,1324,1362
E01021051,4,9,10,5,1201,1229
E01021058,6,10,24,40,1810,1890
E01021059,8,17,24,18,1456,1523
E01021060,12,12,22,19,1533,1598
E01021062,16,9,23,38,1380,1466
E01021069,3,8,15,19,1549,1594
E01021075,1,9,7,22,1754,1793
E01021077,1,6,7,10,1458,1482
E01021081,1,8,13,26,1555,1603
E01021082,0,10,9,13,1600,1632
E01021083,6,4,9,18,1339,1376
E01021072,1,1,12,6,1522,1542
E01021073,0,2,10,12,1458,1482
E01021074,0,1,17,14,1624,1656
E01021076,3,10,27,16,1838,1894
E01021078,0,6,16,18,1239,1279
E01021070,1,0,12,47,1505,1565
E01021071,9,7,30,70,1594,1710
E01021079,11,4,19,48,1465,1547
E01021080,5,5,11,18,1377,1416
E01021132,2,3,14,19,1453,1491
E01021133,0,2,21,27,1580,1630
E01021134,1,4,11,14,1451,1481
E01021139,2,2,7,9,1300,1320
E01021140,2,1,23,6,1785,1817
E01021141,1,5,11,9,1516,1542
E01021103,2,2,9,9,1461,1483
E01021114,2,1,4,10,1511,1528
E01021115,1,0,10,15,1566,1592
E01021116,3,0,4,5,1514,1526
E01021098,4,2,12,11,1689,1718
E01021099,2,1,16,10,1629,1658
E01021100,2,6,27,17,1792,1844
E01021104,1,2,16,13,1323,1355
E01021105,1,18,16,28,1188,1251
E01021101,1,3,17,14,1687,1722
E01021102,2,1,6,7,1591,1607
E01021117,2,0,28,27,1542,1599
E01021118,1,6,10,12,1535,1564
E01021119,0,0,6,11,1075,1092
E01021087,5,8,22,12,1609,1656
E01021088,3,1,11,6,1505,1526
E01021089,2,2,9,2,1518,1533
E01021109,19,17,31,26,1596,1689
E01021110,3,2,19,11,2224,2259
E01021084,1,13,18,23,1832,1887
E01021085,2,5,32,18,1639,1696
E01021086,0,7,17,10,1695,1729
E01021096,0,1,16,6,1265,1288
E01021097,1,3,21,17,1356,1398
E01021111,4,4,9,9,1008,1034
E01021113,3,17,13,11,1350,1394
E01021131,3,0,21,23,1640,1687
E01021135,10,7,35,30,1754,1836
E01021136,1,5,16,4,1291,1317
E01021137,3,11,33,16,1405,1468
E01021112,6,8,19,42,1430,1505
E01021120,6,3,10,32,1271,1322
E01021126,11,18,16,36,1461,1542
E01021127,3,6,23,28,1503,1563
E01021128,1,8,15,30,1771,1825
E01021093,4,3,16,13,1503,1539
E01021095,0,8,17,9,1257,1291
E01021123,2,2,13,17,1514,1548
E01021124,1,5,31,26,1611,1674
E01021125,4,1,16,10,1263,1294
E01021129,6,2,14,20,1747,1789
E01021138,2,1,15,4,1075,1097
E01021094,4,1,15,18,1492,1530
E01021106,2,6,10,12,1628,1658
E01021107,4,2,15,8,1540,1569
E01021108,8,0,11,16,1445,1480
E01021130,3,0,20,15,1397,1435
E01021090,9,14,44,87,1512,1666
E01021091,10,16,33,31,1833,1923
E01021092,8,17,34,69,1869,1997
E01021121,2,7,34,42,1507,1592
E01021122,10,15,19,41,1447,1532
E01021167,4,4,45,52,2082,2187
E01021168,1,4,25,11,1636,1677
E01021169,3,6,24,25,1356,1414
E01021186,3,1,2,8,1191,1205
E01021171,13,0,37,22,1978,2050
E01021172,4,2,7,6,1785,1804
E01021173,3,3,17,4,1393,1420
E01021218,2,2,9,5,1129,1147
E01021156,2,16,24,36,1708,1786
E01021157,7,1,23,51,1747,1829
E01021158,15,5,26,15,2125,2186
E01021159,5,1,20,29,2269,2324
E01021160,1,6,19,34,1589,1649
E01021161,0,1,18,13,1545,1577
E01021162,1,3,11,17,1586,1618
E01021202,5,12,10,32,1064,1123
E01021203,1,0,10,9,1471,1491
E01021229,9,2,26,27,1636,1700
E01021230,2,2,20,6,1696,1726
E01021231,6,3,27,24,1695,1755
E01021151,0,11,21,21,1716,1769
E01021152,10,7,24,43,1521,1605
E01021153,0,12,21,26,1904,1963
E01021154,1,0,10,26,1445,1482
E01021155,3,4,14,7,1135,1163
E01021163,1,13,28,24,2175,2241
E01021164,7,0,17,21,1868,1913
E01021187,4,4,18,9,1399,1434
E01021144,2,2,12,11,1772,1799
E01021145,2,4,10,14,1968,1998
E01021170,8,3,21,7,2702,2741
E01021217,7,5,9,7,1258,1286
E01021219,0,4,8,3,1335,1350
E01021220,1,3,15,49,1572,1640
E01021223,1,0,6,12,1102,1121
E01021224,0,1,13,16,1442,1472
E01021225,2,5,9,29,1512,1557
E01021226,1,0,16,21,1333,1371
E01021150,1,3,19,17,1154,1194
E01021191,1,6,21,44,1545,1617
E01021192,0,4,3,10,1570,1587
E01021193,1,2,20,18,1681,1722
E01021194,1,2,10,13,1626,1652
E01021149,0,3,14,18,1243,1278
E01021189,0,5,6,6,1370,1387
E01021190,0,1,13,3,1507,1524
E01021200,0,0,10,13,1083,1106
E01021201,0,3,16,11,1506,1536
E01021221,0,3,12,19,1236,1270
E01021222,2,2,14,40,1448,1506
E01021227,3,1,28,16,1645,1693
E01021228,6,2,11,16,1478,1513
E01021146,9,7,23,7,1691,1737
E01021147,4,0,7,11,1632,1654
E01021148,6,6,23,18,1513,1566
E01021165,3,6,13,8,1162,1192
E01021188,3,2,11,4,1116,1136
E01021198,2,1,15,2,1504,1524
E01021199,2,1,4,5,1316,1328
E01021204,2,1,9,4,1187,1203
E01021205,0,0,7,4,1239,1250
E01021174,4,4,13,7,1599,1627
E01021175,0,0,7,15,1467,1489
E01021176,0,10,4,25,1366,1405
E01021177,2,5,7,27,1068,1109
E01021180,1,4,5,15,1292,1317
E01021181,7,3,4,13,1271,1298
E01021182,4,2,6,17,1540,1569
E01021183,2,7,22,13,1297,1341
E01021178,0,4,16,29,1344,1393
E01021179,1,5,17,12,1462,1497
E01021184,0,2,7,23,1513,1545
E01021185,6,4,25,30,1431,1496
E01021142,0,1,4,4,1103,1112
E01021143,1,2,19,6,1181,1209
E01021166,1,7,22,16,2212,2258
E01021195,0,2,16,10,1927,1955
E01021196,0,5,13,13,1911,1942
E01021197,4,19,37,72,1911,2043
E01021212,1,3,13,11,1794,1822
E01021213,1,6,17,49,1700,1773
E01021214,5,2,13,7,1598,1625
E01021215,0,4,6,14,1233,1257
E01021216,0,0,12,10,1156,1178
E01021206,0,1,14,13,1420,1448
E01021207,2,0,9,19,1309,1339
E01021208,4,4,20,14,1900,1942
E01021209,6,3,7,11,1588,1615
E01021210,8,11,23,37,1519,1598
E01021211,5,3,10,18,1489,1525
E01021232,2,3,11,39,1597,1652
E01021233,0,2,19,26,1436,1483
E01021234,0,0,7,3,1465,1475
E01021235,2,1,13,11,1314,1341
E01021236,0,1,9,11,1468,1489
E01022553,4,4,9,8,1432,1457
E01022554,1,6,26,11,1632,1676
E01022555,0,9,19,27,1453,1508
E01022556,5,5,19,20,1550,1599
E01022560,0,7,5,10,1155,1177
E01022493,0,7,11,8,1312,1338
E01022536,1,4,15,22,1278,1320
E01022537,3,0,10,11,1269,1293
E01022557,2,9,25,19,1474,1529
E01022558,0,7,10,16,1214,1247
E01022559,4,2,23,16,1235,1280
E01022488,2,7,13,3,1160,1185
E01022489,4,4,23,10,1493,1534
E01022499,0,6,12,18,1501,1537
E01022500,3,3,13,24,1334,1377
E01022513,6,3,20,12,1565,1606
E01022472,5,0,12,9,1217,1243
E01022473,1,0,5,18,1222,1246
E01022520,5,3,8,11,1615,1642
E01022521,2,5,13,34,1654,1708
E01022522,2,9,25,6,1542,1584
E01022490,2,11,38,31,1691,1773
E01022491,4,11,35,34,1863,1947
E01022492,3,7,7,14,1556,1587
E01022546,1,4,10,17,1375,1407
E01022547,2,4,16,15,1673,1710
E01022495,6,27,23,79,1320,1455
E01022496,8,17,49,80,2316,2470
E01022497,4,8,26,60,1264,1362
E01022498,6,16,21,87,1389,1519
E01022539,0,15,24,117,1071,1227
E01022540,6,75,58,145,1671,1955
E01022542,2,22,38,98,1103,1263
E01022543,2,78,37,113,1355,1585
E01032843,7,62,49,121,1373,1612
E01032844,4,71,37,136,1280,1528
E01032851,6,74,42,116,1841,2079
E01022470,2,13,30,61,1775,1881
E01022471,0,15,30,67,1431,1543
E01022494,15,39,47,94,2238,2433
E01022523,11,63,48,167,1752,2041
E01022524,7,72,54,186,1655,1974
E01022525,9,21,36,93,1492,1651
E01022526,5,23,31,102,1513,1674
E01022527,10,34,40,130,1385,1599
E01022566,0,34,19,30,1214,1297
E01022567,2,23,31,47,1174,1277
E01022568,9,32,30,57,1293,1421
E01022570,12,30,40,60,1424,1566
E01032840,8,78,62,120,1657,1925
E01032841,4,25,48,63,1515,1655
E01022502,11,22,35,120,1353,1541
E01022506,1,8,26,54,1176,1265
E01022507,7,13,24,73,1440,1557
E01032842,9,32,30,468,700,1239
E01032847,6,19,55,145,1123,1348
E01022481,11,20,20,178,1570,1799
E01022482,27,26,40,220,1260,1573
E01022503,15,4,29,44,1314,1406
E01032845,4,23,27,141,1500,1695
E01032846,9,23,53,496,931,1512
E01022484,1,25,25,58,1209,1318
E01022485,6,15,16,47,1095,1179
E01022486,7,23,56,61,1900,2047
E01022487,2,18,24,29,1226,1299
E01022569,3,9,20,17,1183,1232
E01022548,3,10,37,47,1269,1366
E01022549,3,24,21,52,1513,1613
E01022550,0,41,38,29,1554,1662
E01022551,11,19,26,77,1403,1536
E01022552,2,11,38,49,1402,1502
E01022528,2,6,13,3,1248,1272
E01022529,4,7,11,13,1442,1477
E01022530,0,1,13,8,1229,1251
E01022531,1,8,11,12,1444,1476
E01022475,12,24,23,62,1532,1653
E01022476,8,18,36,79,1706,1847
E01022480,10,8,17,47,1238,1320
E01022504,6,13,11,83,1391,1504
E01022505,6,27,22,80,1414,1549
E01022467,3,12,27,31,1587,1660
E01022468,2,9,21,25,1735,1792
E01022469,0,7,27,44,1492,1570
E01022561,0,7,8,9,1443,1467
E01022562,2,2,11,14,1300,1329
E01022515,2,10,9,24,1246,1291
E01022516,3,5,15,46,1415,1484
E01022517,1,2,7,22,1209,1241
E01022518,0,10,26,51,1921,2008
E01022519,1,6,12,42,1200,1261
E01022474,1,38,38,77,1398,1552
E01022477,6,17,22,67,1264,1376
E01022478,3,31,47,50,1306,1437
E01022479,3,20,23,30,1293,1369
E01022509,2,24,23,63,1318,1430
E01022514,4,0,14,15,1481,1514
E01022563,3,6,13,14,1759,1795
E01022564,0,3,21,15,1772,1811
E01022565,1,1,10,12,1604,1628
E01022510,5,14,33,64,1549,1665
E01022511,5,13,30,31,1207,1286
E01022512,2,5,28,47,1323,1405
E01032848,4,15,44,79,1443,1585
E01032849,13,21,50,71,1394,1549
E01032850,5,13,27,52,1384,1481
E01022532,6,2,12,11,1305,1336
E01022533,2,7,28,18,1729,1784
E01022534,1,7,13,13,1605,1639
E01022535,0,1,5,33,1475,1514
E01022581,3,15,11,38,1505,1572
E01022582,0,3,13,6,1389,1411
E01022604,1,4,11,12,1227,1255
E01022605,1,11,24,16,1566,1618
E01022574,13,5,16,39,1327,1400
E01022575,2,3,18,62,1437,1522
E01022576,15,1,28,51,1429,1524
E01022579,2,5,6,38,1068,1119
E01022571,5,3,17,9,1169,1203
E01022572,3,10,15,19,1197,1244
E01022573,11,8,22,33,2374,2448
E01022577,10,11,9,31,1422,1483
E01022578,4,15,40,32,2910,3001
E01022580,1,3,15,64,1171,1254
E01022603,7,14,12,53,1344,1430
E01022634,0,17,19,85,958,1079
E01022639,6,58,36,78,1708,1886
E01022640,3,11,28,26,1395,1463
E01022615,5,17,35,40,2694,2791
E01022633,4,5,12,64,1254,1339
E01022635,6,25,25,36,1394,1486
E01022636,2,16,14,42,1264,1338
E01022641,6,11,15,19,1194,1245
E01022591,1,6,31,14,2396,2448
E01022593,1,0,7,10,1254,1272
E01022594,0,1,5,10,1421,1437
E01022595,2,0,16,20,1895,1933
E01022596,4,1,14,17,1341,1377
E01022627,3,3,25,8,2163,2202
E01022630,1,4,23,13,2208,2249
E01022642,1,8,27,20,1031,1087
E01032663,11,22,25,41,2237,2336
E01022583,1,18,13,22,1630,1684
E01022584,2,15,19,36,1710,1782
E01022585,1,3,21,17,1573,1615
E01022586,2,9,28,22,1630,1691
E01022587,1,10,28,23,1657,1719
E01022616,0,28,19,35,1620,1702
E01022617,0,6,20,38,1521,1585
E01022618,2,6,20,11,1795,1834
E01022631,6,2,23,13,1248,1292
E01022632,1,1,3,2,1163,1170
E01022592,32,3,24,14,2266,2339
E01022597,5,4,49,30,2759,2847
E01022619,2,7,21,38,1269,1337
E01022624,2,6,22,29,2213,2272
E01022625,6,2,32,32,2672,2744
E01022620,1,1,15,15,1105,1137
E01022621,6,3,6,15,1396,1426
E01022622,0,6,17,8,1292,1323
E01022623,1,6,21,27,2239,2294
E01032664,1,8,27,48,998,1082
E01032665,1,32,27,72,1227,1359
E01022588,5,0,5,23,1578,1611
E01022589,2,0,12,20,1713,1747
E01022590,1,1,15,8,1471,1496
E01022607,0,1,8,18,1165,1192
E01022608,1,0,8,10,1323,1342
E01022606,7,2,14,14,2357,2394
E01022611,7,0,11,28,1485,1531
E01022613,16,3,17,23,1314,1373
E01022614,4,6,7,9,1063,1089
E01022610,4,2,9,20,1306,1341
E01022628,22,0,13,3,1119,1157
E01022629,0,0,10,11,1352,1373
E01032615,1,0,5,3,1102,1111
E01032616,1,0,11,11,1546,1569
E01022599,3,2,29,13,1244,1291
E01022600,2,1,18,12,1440,1473
E01022601,4,0,16,5,1414,1439
E01022602,4,3,14,23,1227,1271
E01032625,1,4,14,12,1091,1122
E01022705,17,1,22,43,1523,1606
E01022706,7,0,25,88,1547,1667
E01022707,14,16,26,115,1844,2015
E01022708,32,15,36,122,1554,1759
E01022709,49,13,28,44,1620,1754
E01022659,36,14,20,55,1474,1599
E01022660,13,8,22,65,1393,1501
E01022675,6,7,8,52,1330,1403
E01022676,3,14,21,30,1444,1512
E01022704,12,13,32,69,1704,1830
E01022661,3,10,17,57,1602,1689
E01022662,6,3,24,51,1260,1344
E01022663,22,1,20,94,1488,1625
E01022664,4,5,22,66,1453,1550
E01022665,9,1,16,68,1403,1497
E01022648,2,4,21,15,1247,1289
E01022667,2,6,22,68,1402,1500
E01022672,8,1,27,85,1460,1581
E01022673,18,26,48,69,1929,2090
E01022674,16,9,23,99,1448,1595
E01022643,4,4,6,23,1580,1617
E01022644,3,8,2,28,1279,1320
E01022646,3,1,18,13,1534,1569
E01022647,4,1,18,19,1492,1534
E01022649,3,6,23,18,1577,1627
E01022650,6,0,9,18,1116,1149
E01022668,11,34,48,239,2274,2606
E01022677,9,17,36,43,1902,2007
E01022678,2,9,41,73,1766,1891
E01022680,1,7,22,57,1517,1604
E01022681,4,3,44,64,1459,1574
E01022666,64,25,41,163,1840,2133
E01022669,12,41,54,167,1518,1792
E01022670,22,31,42,37,1472,1604
E01022671,8,6,39,53,1421,1527
E01022679,11,19,36,64,1697,1827
E01022645,1,3,6,19,1143,1172
E01022682,2,2,4,10,1371,1389
E01022683,2,4,10,6,1367,1389
E01022684,2,1,15,11,1485,1514
E01022685,2,2,10,17,1165,1196
E01022686,4,2,14,29,1612,1661
E01022687,1,7,13,30,1709,1760
E01022713,5,6,23,24,1686,1744
E01022714,11,1,10,37,1609,1668
E01022715,3,6,23,68,1489,1589
E01022716,3,9,41,79,1418,1550
E01022717,13,3,19,73,1096,1204
E01022718,15,11,30,68,1338,1462
E01022719,3,4,10,21,1506,1544
E01022653,6,5,7,10,1457,1485
E01022691,4,1,30,76,1472,1583
E01022692,3,18,52,108,2664,2845
E01022693,2,7,24,60,1438,1531
E01022694,2,5,19,25,1738,1789
E01022652,2,2,33,41,1686,1764
E01022695,2,1,17,22,1290,1332
E01022700,3,3,19,62,1485,1572
E01022701,6,4,14,19,1043,1086
E01022703,0,8,10,48,1401,1467
E01022651,0,4,32,36,1762,1834
E01022696,7,0,11,23,1515,1556
E01022697,0,0,10,9,1573,1592
E01022698,1,11,11,28,1570,1621
E01022699,4,7,8,23,1488,1530
E01022702,2,7,20,32,1225,1286
E01022654,3,2,19,19,1308,1351
E01022655,0,3,11,19,1509,1542
E01022656,6,8,18,7,1437,1476
E01022657,1,13,21,20,1571,1626
E01022658,1,4,18,10,1636,1669
E01022710,0,12,33,44,1921,2010
E01022711,2,7,28,21,1655,1713
E01022712,1,9,23,12,1564,1609
E01022688,2,11,19,11,2178,2221
E01022689,2,1,11,6,1497,1517
E01022690,2,12,35,23,1891,1963
E01022758,0,9,27,29,1563,1628
E01022771,14,6,18,21,1586,1645
E01022772,6,3,33,44,2125,2211
E01022773,2,6,26,12,1531,1577
E01022774,6,8,40,50,1848,1952
E01022749,0,4,23,28,1304,1359
E01022753,1,5,13,39,1190,1248
E01022754,5,8,15,44,1723,1795
E01022780,4,15,32,31,1479,1561
E01022787,5,1,11,40,1283,1340
E01022788,0,5,22,18,1211,1256
E01022730,0,5,16,14,1441,1476
E01022731,1,1,11,15,1313,1341
E01022732,6,12,30,18,1468,1534
E01022733,9,2,24,39,1611,1685
E01022734,8,9,18,17,1313,1365
E01022720,6,8,10,48,1346,1418
E01022725,2,2,8,16,1286,1314
E01022726,3,6,24,34,1381,1448
E01022727,0,1,15,18,1537,1571
E01022729,3,0,11,21,1142,1177
E01022743,2,3,19,37,1751,1812
E01022750,8,1,61,20,1418,1508
E01022751,3,1,14,8,1541,1567
E01022752,0,3,16,13,1390,1422
E01022757,1,2,18,33,1549,1603
E01022790,3,12,27,19,1739,1800
E01022755,0,4,12,12,1435,1463
E01022756,5,0,3,8,1306,1322
E01022791,1,45,39,24,1977,2086
E01022792,1,3,17,18,1503,1542
E01022793,5,7,15,20,1708,1755
E01022781,9,2,10,5,1362,1388
E01022782,1,6,8,17,1407,1439
E01022785,1,2,19,11,1462,1495
E01022786,0,8,14,20,1555,1597
E01022789,1,5,15,20,1404,1445
E01022721,4,4,19,23,1352,1402
E01022722,5,7,34,23,1642,1711
E01022723,8,7,29,50,1387,1481
E01022724,4,5,23,24,1394,1450
E01022737,11,13,29,45,1480,1578
E01022766,3,2,10,18,1289,1322
E01022769,2,2,8,34,1212,1258
E01022740,3,1,9,14,1593,1620
E01022741,1,7,16,23,1201,1248
E01022742,4,8,36,34,1676,1758
E01022783,6,5,32,27,1437,1507
E01022784,8,2,18,25,1332,1385
E01022759,2,1,10,6,1511,1530
E01022763,5,5,9,39,1477,1535
E01022765,3,1,20,14,1654,1692
E01022768,3,4,7,13,1330,1357
E01022770,1,0,14,15,1703,1733
E01022728,1,18,18,52,1688,1777
E01022735,0,5,18,28,1398,1449
E01022736,5,2,12,13,1505,1537
E01022738,1,1,14,8,1019,1043
E01022739,13,3,29,65,1514,1624
E01022760,0,2,21,15,1490,1528
E01022761,1,5,10,5,1481,1502
E01022762,1,2,20,28,1480,1531
E01022764,0,2,7,13,1542,1564
E01022767,3,0,17,17,1200,1237
E01022776,1,1,18,15,1528,1563
E01022777,1,2,8,12,1619,1642
E01022778,2,2,11,21,1493,1529
E01032877,6,1,26,10,2130,2173
E01022744,3,4,11,14,1321,1353
E01022745,2,5,17,15,1465,1504
E01022746,1,1,19,16,1608,1645
E01022747,1,6,10,9,1219,1245
E01022748,2,1,16,3,1401,1423
E01022800,0,1,9,9,1630,1649
E01022801,3,11,8,3,1500,1525
E01022802,1,6,6,11,1468,1492
E01022803,0,10,14,40,1587,1651
E01022836,0,4,5,7,1422,1438
E01022804,0,3,20,4,1555,1582
E01022805,0,18,14,34,1435,1501
E01022834,11,7,4,11,1302,1335
E01022835,1,3,28,42,1394,1468
E01022840,2,14,21,29,1542,1608
E01022813,0,3,7,5,1394,1409
E01022814,1,6,14,27,1634,1682
E01022815,2,0,38,26,1487,1553
E01022823,1,4,3,8,1531,1547
E01022825,8,0,6,8,1418,1440
E01022819,14,23,24,4,1521,1586
E01022820,5,36,12,25,1747,1825
E01022841,3,76,29,18,1383,1509
E01022842,5,122,29,40,1485,1681
E01032882,6,13,37,32,1978,2066
E01022807,1,2,39,18,1499,1559
E01022816,0,1,10,19,1462,1492
E01022817,1,1,25,27,1740,1794
E01022818,3,1,20,18,1415,1457
E01022824,3,15,73,66,2565,2722
E01022826,3,5,11,9,1506,1534
E01022828,2,3,18,17,1260,1300
E01022829,20,14,16,9,2034,2093
E01022830,1,3,27,14,1363,1408
E01032880,12,4,22,34,1343,1415
E01032881,16,8,23,14,1683,1744
E01032883,7,5,14,9,1331,1366
E01022806,0,2,11,25,1452,1490
E01022832,1,11,27,25,1587,1651
E01022839,5,3,10,19,1318,1355
E01032884,6,10,48,35,1996,2095
E01022810,10,10,45,56,1462,1583
E01022811,9,17,28,23,2193,2270
E01022833,7,15,35,13,1784,1854
E01022843,4,18,13,17,1518,1570
E01032878,8,2,13,27,1059,1109
E01032879,2,12,12,15,1167,1208
E01022794,1,1,17,11,1442,1472
E01022795,3,5,39,24,1432,1503
E01022796,2,2,12,22,1221,1259
E01022837,2,4,25,14,1558,1603
E01022838,0,1,10,15,1286,1312
E01022797,1,5,5,3,1107,1121
E01022798,4,46,16,38,1101,1205
E01022799,0,3,23,13,1337,1376
E01022812,0,0,13,13,1223,1249
E01022831,3,0,11,18,1414,1446
E01022845,6,3,27,10,1414,1460
E01022890,2,3,26,48,1391,1470
E01022891,2,0,19,47,1675,1743
E01022892,0,11,18,21,1812,1862
E01022893,2,0,19,26,1564,1611
E01022894,3,6,31,18,1420,1478
E01022859,1,5,29,20,1598,1653
E01022895,6,3,15,35,1775,1834
E01022896,6,8,17,20,1567,1618
E01022897,2,12,26,36,1621,1697
E01022898,2,6,13,16,1479,1516
E01022846,17,32,23,70,1040,1182
E01022847,4,14,13,71,1636,1738
E01022848,6,30,24,67,1426,1553
E01022874,3,8,18,83,1248,1360
E01022875,7,25,37,56,1341,1466
E01022876,7,16,31,27,1279,1360
E01022877,3,12,15,28,1398,1456
E01022858,4,0,13,12,1026,1055
E01022878,3,1,17,22,1688,1731
E01022879,6,6,29,18,1716,1775
E01022880,2,1,15,12,1463,1493
E01022860,4,2,32,75,1844,1957
E01022862,14,14,38,145,1715,1926
E01022867,10,8,39,102,1357,1516
E01032852,8,9,26,113,1586,1742
E01032853,11,6,33,137,1582,1769
E01032854,5,27,54,134,1452,1672
E01032857,5,2,20,91,908,1026
E01022881,10,8,37,73,2237,2365
E01022882,1,8,17,22,1440,1488
E01022883,2,1,22,16,1342,1383
E01022884,5,9,36,43,1526,1619
E01022885,4,11,30,27,1407,1479
E01022861,1,10,37,41,1622,1711
E01022863,7,2,18,25,1521,1573
E01022865,3,4,36,18,1560,1621
E01022868,3,4,14,29,1649,1699
E01022870,2,3,16,27,1405,1453
E01022864,11,8,30,31,1363,1443
E01022871,5,10,41,46,1316,1418
E01022872,12,10,41,63,1666,1792
E01022873,3,8,41,37,1697,1786
E01022887,3,7,21,21,1393,1445
E01022849,2,8,22,23,1646,1701
E01022850,3,3,10,33,1483,1532
E01022851,3,6,24,37,1621,1691
E01022853,3,3,25,27,1685,1743
E01022869,3,5,19,24,1389,1440
E01022852,5,12,30,31,1735,1813
E01022854,3,9,22,11,1691,1736
E01022855,1,5,17,8,1208,1239
E01022856,3,4,27,18,1454,1506
E01022857,21,26,40,67,1303,1457
E01022888,1,7,29,26,1623,1686
E01022889,1,8,18,11,1441,1479
E01032855,0,7,22,20,1244,1293
E01032856,1,33,25,43,2081,2183
E01022930,1,0,9,14,1625,1649
E01022931,1,6,10,29,1617,1663
E01022935,0,10,21,13,1470,1514
E01022975,0,3,10,22,1478,1513
E01022976,3,0,14,17,1477,1511
E01022922,3,2,22,34,1438,1499
E01022971,5,2,21,30,1451,1509
E01022972,1,2,11,18,1551,1583
E01022974,3,1,17,25,1379,1425
E01022959,2,1,18,31,1406,1458
E01022962,0,9,38,27,1406,1480
E01022965,1,5,20,34,1418,1478
E01022973,5,10,94,65,1834,2008
E01022901,3,1,28,20,1659,1711
E01022902,2,5,18,8,1539,1572
E01022966,2,5,10,3,1353,1373
E01022967,0,2,19,11,1208,1240
E01022960,3,20,37,48,1313,1421
E01022961,0,2,12,25,1343,1382
E01022963,1,8,28,37,1338,1412
E01022964,4,2,30,25,1315,1376
E01022903,2,17,30,9,1756,1814
E01022906,1,8,13,0,1457,1479
E01022968,1,6,26,6,1408,1447
E01022969,4,12,20,22,1609,1667
E01022913,1,10,11,7,1278,1307
E01022914,1,7,7,8,1279,1302
E01022915,5,10,18,3,1432,1468
E01022916,0,5,10,13,1562,1590
E01022917,1,3,20,2,1217,1243
E01022900,6,12,31,20,1785,1854
E01022904,4,10,24,26,1926,1990
E01022905,2,9,40,29,1699,1779
E01022908,1,2,12,11,1427,1453
E01022970,5,1,18,14,1854,1892
E01022947,8,12,16,12,1602,1650
E01022948,2,3,17,13,1604,1639
E01022949,4,3,10,21,1487,1525
E01022950,3,12,18,19,1449,1501
E01022951,0,4,20,6,1363,1393
E01022952,2,9,13,8,1431,1463
E01022924,0,2,33,28,1537,1600
E01022925,0,0,7,16,1377,1400
E01022926,8,0,15,20,1486,1529
E01022927,2,1,12,16,1616,1647
E01022928,1,5,20,12,1717,1755
E01022929,1,4,24,21,1511,1561
E01022953,4,4,26,51,1944,2029
E01022954,3,3,10,32,1477,1525
E01022955,9,4,12,3,1347,1375
E01022956,6,0,19,17,1172,1214
E01022957,1,0,20,11,1271,1303
E01022958,4,3,20,12,1397,1436
E01022937,4,2,7,13,1412,1438
E01022943,1,2,17,11,1434,1465
E01022944,0,1,13,15,1242,1271
E01022946,2,1,29,21,1750,1803
E01022940,0,1,20,11,1514,1546
E01022942,3,6,39,29,1495,1572
E01022945,3,4,21,15,2223,2266
E01022936,4,5,23,22,1437,1491
E01022938,0,0,14,4,1431,1449
E01022939,1,3,21,10,1530,1565
E01022941,0,16,18,8,1471,1513
E01022899,2,2,14,12,1351,1381
E01022907,4,6,12,18,1472,1512
E01022909,1,11,24,36,1505,1577
E01022910,9,12,24,43,1341,1429
E01022911,4,0,10,20,1468,1502
E01032605,8,7,15,11,1321,1362
E01022919,1,6,11,8,1604,1630
E01022933,3,8,32,12,1617,1672
E01022934,6,4,12,14,1887,1923
E01032618,1,0,6,18,1461,1486
E01022918,1,3,4,4,1486,1498
E01022920,2,6,16,15,1531,1570
E01022921,1,4,20,17,1521,1563
E01032617,0,1,13,16,1563,1593
E01023011,3,0,5,15,1439,1462
E01023012,1,0,4,6,1361,1372
E01023021,1,1,8,4,1578,1592
E01023022,5,4,18,14,1749,1790
E01023023,2,0,3,7,1745,1757
E01023024,1,0,17,0,1521,1539
E01023025,0,1,5,1,1357,1364
E01023076,7,4,17,8,1383,1419
E01023082,2,6,20,23,1415,1466
E01023083,7,7,11,18,1472,1515
E01023088,7,0,15,8,1593,1623
E01023073,0,3,16,17,1361,1397
E01023080,2,7,21,35,1335,1400
E01023081,2,9,30,41,1948,2030
E01023089,0,4,10,19,1512,1545
E01023090,0,13,22,27,1824,1886
E01023074,1,10,10,24,1406,1451
E01023077,0,9,21,46,1442,1518
E01023078,0,1,15,6,1383,1405
E01023079,0,3,20,25,1685,1733
E01023085,0,1,22,14,1506,1543
E01023072,0,9,10,7,1276,1302
E01023075,2,3,22,2,1162,1191
E01023084,1,6,7,17,1509,1540
E01023086,1,1,17,13,1494,1526
E01023087,0,4,13,13,1450,1480
E01022977,7,1,8,11,1459,1486
E01022978,1,0,11,4,1512,1528
E01022979,1,2,8,2,1190,1203
E01022980,2,2,7,14,1522,1547
E01022992,0,0,6,6,1141,1153
E01022993,1,1,6,10,1344,1362
E01023045,5,5,16,5,1549,1580
E01023046,1,10,23,33,1382,1449
E01023007,2,5,13,6,1113,1139
E01023010,2,13,20,10,1492,1537
E01023047,10,35,8,14,1261,1328
E01023048,8,10,16,8,1316,1358
E01023049,5,46,23,25,1563,1662
E01023050,24,76,30,39,1624,1793
E01023008,25,4,17,20,1467,1533
E01023009,1,9,9,14,1470,1503
E01023038,3,1,9,17,1428,1458
E01023039,3,2,6,6,1416,1433
E01023040,2,4,6,10,1428,1450
E01023026,1,2,7,10,1151,1171
E01023062,3,0,5,9,1478,1495
E01023064,1,2,12,7,1358,1380
E01023066,1,1,16,12,1629,1659
E01023067,6,4,15,6,1459,1490
E01023003,2,3,15,8,1701,1729
E01023004,8,8,13,10,1826,1865
E01023005,0,0,11,6,1488,1505
E01023006,0,2,6,6,1379,1393
E01023028,12,11,34,23,2016,2096
E01023037,10,13,19,7,1836,1885
E01023065,4,2,13,11,1613,1643
E01023068,2,3,13,12,1308,1338
E01023069,0,1,11,6,1539,1557
E01023070,11,4,19,23,1716,1773
E01023071,4,3,4,22,1344,1377
E01023029,12,8,14,1,1654,1689
E01023030,1,3,19,11,1274,1308
E01023032,5,1,12,8,1277,1303
E01023033,0,5,13,1,1283,1302
E01023013,5,0,11,3,1447,1466
E01023014,4,5,16,7,1643,1675
E01023015,16,24,11,31,1402,1484
E01023016,3,0,5,3,1380,1391
E01023027,8,9,15,6,1392,1430
E01023031,1,1,14,6,1217,1239
E01022989,7,5,13,15,1771,1811
E01022991,5,9,27,23,2006,2070
E01022998,5,7,5,19,1715,1751
E01023000,5,4,22,27,1743,1801
E01022994,1,6,17,11,1544,1579
E01022995,1,1,14,8,1390,1414
E01022996,1,5,12,8,1219,1245
E01022997,0,1,16,5,1362,1384
E01023063,1,1,15,12,1268,1297
E01022990,1,5,11,7,1546,1570
E01022999,1,2,6,11,2091,2111
E01023041,2,5,4,10,1493,1514
E01023042,5,6,18,20,1458,1507
E01023043,3,3,18,11,1689,1724
E01022984,3,1,11,9,1483,1507
E01022985,1,7,11,6,1199,1224
E01023020,2,1,6,5,1420,1434
E01023034,0,1,12,12,1713,1738
E01023035,2,7,8,4,1733,1754
E01023036,1,5,11,2,1965,1984
E01023001,4,1,34,42,1701,1782
E01023002,2,2,27,18,1670,1719
E01023058,0,0,13,8,1469,1490
E01023060,0,0,6,4,1387,1397
E01023061,1,0,19,19,1426,1465
E01023017,1,6,26,15,1914,1962
E01023018,3,12,22,16,1379,1432
E01023019,3,3,18,33,1394,1451
E01023055,12,4,21,27,1226,1290
E01022986,2,7,11,22,1382,1424
E01022988,1,2,14,22,1462,1501
E01023054,12,13,29,50,1671,1775
E01023056,5,5,14,27,1486,1537
E01023057,21,14,22,93,1573,1723
E01022981,6,2,29,14,1916,1967
E01022982,4,5,10,17,1798,1834
E01022983,1,1,15,13,1623,1653
E01022987,0,2,14,24,1963,2003
E01023044,0,1,9,5,1084,1099
E01023051,1,2,17,13,1508,1541
E01023052,4,0,6,10,1621,1641
E01023053,1,0,12,13,1630,1656
E01023059,6,1,11,16,1676,1710
E01023099,7,20,22,119,1521,1689
E01023104,12,21,42,307,1288,1670
E01023106,4,20,20,319,1116,1479
E01023121,17,16,57,142,1784,2016
E01023105,10,29,44,266,1210,1559
E01023119,22,28,34,230,994,1308
E01023120,22,35,68,464,1208,1797
E01023122,11,37,35,331,1100,1514
E01023146,3,24,48,208,1091,1374
E01023100,0,37,35,108,1077,1257
E01023101,2,17,21,41,1197,1278
E01023102,3,10,9,56,1296,1374
E01023134,2,4,31,116,1658,1811
E01023147,7,28,13,121,1324,1493
E01023096,17,27,34,204,1851,2133
E01023097,4,10,31,79,1294,1418
E01023103,10,11,17,138,1445,1621
E01023111,5,21,50,99,1643,1818
E01023112,2,10,16,41,1201,1270
E01023092,2,8,25,65,1365,1465
E01023093,2,20,17,43,1294,1376
E01023132,5,11,21,94,1429,1560
E01023133,5,15,39,66,1228,1353
E01023135,11,35,55,120,2198,2419
E01023091,12,59,56,191,1404,1722
E01023094,0,14,31,74,1211,1330
E01023095,18,18,30,188,1508,1762
E01023098,7,7,26,125,1393,1558
E01023148,0,25,23,137,1194,1379
E01023149,0,12,24,71,1194,1301
E01023113,9,19,45,74,1448,1595
E01023114,10,13,37,50,1350,1460
E01023136,8,36,48,159,1498,1749
E01023137,4,10,34,88,1150,1286
E01023138,4,22,36,61,1244,1367
E01023139,8,22,36,51,1192,1309
E01023140,23,114,53,280,1146,1616
E01023141,49,196,73,523,2279,3120
E01023142,40,178,33,631,1049,1931
E01023143,23,124,47,230,1587,2011
E01023144,48,91,42,606,967,1754
E01023118,19,32,47,378,1273,1749
E01023124,3,13,34,125,1092,1267
E01023125,16,44,50,88,2190,2388
E01032858,16,55,71,104,1889,2135
E01023128,6,20,41,155,1164,1386
E01023129,3,35,38,165,1034,1275
E01023130,3,9,16,49,1299,1376
E01023131,10,11,21,86,1286,1414
E01023145,23,51,51,473,1400,1998
E01023109,7,21,34,75,1367,1504
E01023115,9,5,20,94,1240,1368
E01023116,16,22,48,381,1335,1802
E01023117,2,13,34,46,1705,1800
E01023107,8,25,27,43,1337,1440
E01023108,7,10,24,43,1282,1366
E01023110,7,25,22,61,1668,1783
E01023123,4,23,21,73,1333,1454
E01023165,2,1,19,12,2085,2119
E01023169,3,2,10,13,1919,1947
E01023181,5,6,19,37,1341,1408
E01023182,2,7,23,31,1506,1569
E01023153,5,11,23,24,1605,1668
E01023154,3,16,43,25,1608,1695
E01023156,9,17,56,16,1388,1486
E01023157,1,14,33,33,1345,1426
E01023205,3,4,14,16,1311,1348
E01023155,15,14,39,19,2681,2768
E01023201,1,16,22,26,1584,1649
E01023202,22,21,43,26,1631,1743
E01023215,11,11,26,29,1491,1568
E01023219,3,4,17,31,1356,1411
E01023179,0,10,25,46,1738,1819
E01023183,3,5,33,48,1385,1474
E01023190,5,11,26,26,1163,1231
E01023203,2,9,21,47,1449,1528
E01023204,6,16,28,53,1607,1710
E01023180,0,6,31,36,1590,1663
E01023186,0,11,16,27,1658,1712
E01023189,3,8,40,65,1522,1638
E01023196,2,4,25,22,1656,1709
E01032870,4,12,28,41,1826,1911
E01032871,0,5,16,2,1508,1531
E01023187,1,16,20,39,1558,1634
E01023188,2,3,18,14,1295,1332
E01023216,16,15,26,77,1694,1828
E01023217,2,5,17,10,1548,1582
E01023218,3,3,22,17,1477,1522
E01023159,0,1,21,6,2233,2261
E01023195,10,12,38,31,2091,2182
E01023197,0,7,12,6,1479,1504
E01023198,0,6,7,9,1402,1424
E01023160,5,1,7,3,1520,1536
E01023168,1,2,10,5,1424,1442
E01023178,2,7,18,21,2212,2260
E01023166,0,3,15,10,1449,1477
E01023167,1,4,14,4,1581,1604
E01023177,3,10,20,35,2166,2234
E01023184,1,5,12,8,1330,1356
E01023185,0,1,15,4,1207,1227
E01023174,2,4,10,32,1689,1737
E01023175,7,2,16,8,1592,1625
E01023176,0,13,10,30,1509,1562
E01023207,2,4,7,18,1501,1532
E01023208,0,6,16,15,1114,1151
E01023209,2,4,10,34,1312,1362
E01023150,2,7,15,32,1451,1507
E01023151,8,9,37,62,1357,1473
E01023152,1,7,17,15,1605,1645
E01023206,4,4,4,18,1144,1174
E01023158,14,1,14,43,2195,2267
E01023191,10,9,23,28,1804,1874
E01023192,22,1,40,52,1702,1817
E01023193,3,0,9,19,1559,1590
E01023194,0,1,13,14,1514,1542
E01023200,5,1,15,26,1494,1541
E01023162,8,4,31,29,1735,1807
E01023163,3,0,17,17,1617,1654
E01023164,4,8,20,23,1558,1613
E01023199,4,6,24,32,1669,1735
E01023210,18,21,10,118,1412,1579
E01023211,33,6,46,141,1699,1925
E01023212,7,0,18,50,1436,1511
E01023213,15,4,16,85,1246,1366
E01023214,5,9,10,52,1256,1332
E01023170,14,1,21,20,1684,1740
E01023171,45,5,27,246,1305,1628
E01023172,3,3,17,21,1454,1498
E01023173,6,5,13,38,1413,1475
E01023286,1,7,10,5,1423,1446
E01023287,9,26,27,88,2661,2811
E01023288,3,4,14,12,1354,1387
E01023236,4,3,29,21,1839,1896
E01023237,3,1,17,19,1209,1249
E01023238,1,21,18,14,1489,1543
E01023239,1,8,32,22,1580,1643
E01023240,12,5,36,117,2047,2217
E01023241,3,6,5,11,1335,1360
E01023248,5,6,21,36,1642,1710
E01023253,1,2,14,23,1591,1631
E01023274,7,8,14,20,1817,1866
E01023225,1,3,21,21,2235,2281
E01023278,0,4,23,6,1588,1621
E01023279,0,0,15,5,1444,1464
E01023280,2,0,10,25,1495,1532
E01023281,5,3,17,15,1692,1732
E01023247,4,5,33,34,1460,1536
E01023249,1,4,27,45,1143,1220
E01023250,2,20,24,81,1612,1739
E01023268,3,6,30,47,1248,1334
E01023269,7,11,55,137,2149,2359
E01023270,6,17,32,40,1442,1537
E01023251,5,2,20,38,1096,1161
E01023255,7,12,33,160,1591,1803
E01023256,3,4,23,54,1322,1406
E01023257,6,6,30,46,1420,1508
E01023258,4,16,35,96,1417,1568
E01023252,13,16,36,133,1589,1787
E01023254,6,14,24,40,1744,1828
E01023263,8,8,39,41,1291,1387
E01023264,13,12,62,123,1768,1978
E01023265,8,9,35,24,1738,1814
E01023267,7,7,28,51,1199,1292
E01023260,4,10,26,82,1518,1640
E01023261,2,14,29,34,1505,1584
E01023262,13,6,13,32,1487,1551
E01023266,4,13,26,59,1459,1561
E01023229,5,5,32,24,1965,2031
E01023242,0,2,32,25,1150,1209
E01023243,7,18,26,62,1179,1292
E01023244,0,1,8,24,1514,1547
E01023259,12,3,33,40,1427,1515
E01023226,3,1,24,22,1539,1589
E01023227,5,3,20,30,1781,1839
E01023228,2,4,32,24,1956,2018
E01023230,12,10,23,49,2032,2126
E01023246,4,1,15,16,1445,1481
E01023235,2,6,20,16,1975,2019
E01023275,0,0,9,9,1437,1455
E01023276,2,12,22,20,1506,1562
E01023277,5,1,9,15,1204,1234
E01023282,0,2,24,17,1838,1881
E01023220,1,3,21,14,1977,2016
E01023221,1,4,15,12,1674,1706
E01023222,0,0,14,28,1499,1541
E01023223,1,1,21,6,1431,1460
E01023272,2,1,11,7,1234,1255
E01023273,1,1,10,14,1455,1481
E01023245,4,2,17,16,2351,2390
E01023271,0,7,9,20,1170,1206
E01023284,7,6,52,60,2617,2742
E01023285,3,8,9,7,1530,1557
E01032859,3,12,33,69,1677,1794
E01032860,3,5,33,64,1337,1442
E01023224,3,5,13,18,1450,1489
E01023231,8,3,14,16,1712,1753
E01023232,5,4,21,12,1865,1907
E01023233,1,1,3,5,1483,1493
E01023234,10,6,18,21,1528,1583
E01023987,4,7,8,17,1005,1041
E01023988,2,5,11,6,1377,1401
E01024040,5,8,14,18,1122,1167
E01024041,4,3,21,24,1063,1115
E01032810,4,28,31,34,1391,1488
E01032812,5,18,24,44,1653,1744
E01023985,1,2,8,6,1094,1111
E01023986,4,8,20,7,1206,1245
E01023989,1,0,14,16,1151,1182
E01023990,2,5,27,12,1175,1221
E01024033,4,5,12,4,1688,1713
E01024035,5,2,13,2,1051,1073
E01023983,0,16,17,15,1333,1381
E01023999,11,38,32,56,2066,2203
E01032811,4,36,27,108,1471,1646
E01032822,1,30,21,11,1387,1450
E01023980,6,17,11,8,1108,1150
E01023981,10,27,17,42,1129,1225
E01023984,6,23,37,57,1087,1210
E01023992,10,37,15,131,1308,1501
E01023993,7,19,18,152,1268,1464
E01024021,1,28,42,88,1139,1298
E01024022,5,11,23,117,1259,1415
E01032820,3,33,31,146,1346,1559
E01032821,13,24,25,66,1586,1714
E01023973,5,26,39,104,1417,1591
E01024002,8,30,34,89,1278,1439
E01024023,6,31,49,229,2212,2527
E01024027,3,27,33,240,1342,1645
E01024029,5,30,37,109,2197,2378
E01023972,2,6,5,46,1222,1281
E01023995,1,18,11,58,1157,1245
E01023996,2,17,26,70,1213,1328
E01024003,4,10,11,64,1663,1752
E01024004,6,32,40,114,1528,1720
E01024005,2,30,14,84,1434,1564
E01023974,5,21,22,29,1229,1306
E01023975,16,15,27,130,1462,1650
E01023977,1,10,14,16,1119,1160
E01024016,1,23,22,25,1292,1363
E01024017,2,34,24,24,1677,1761
E01024028,9,30,40,132,1507,1718
E01023976,11,15,20,126,1474,1646
E01024019,2,22,31,129,1288,1472
E01024020,16,53,34,116,1760,1979
E01032816,7,43,31,32,1652,1765
E01032823,27,23,42,50,1549,1691
E01024001,4,14,23,64,1424,1529
E01024006,6,21,26,50,1301,1404
E01024008,17,46,41,67,1873,2044
E01032815,6,36,30,58,914,1044
E01032817,2,59,27,83,1034,1205
E01032818,2,44,34,60,1441,1581
E01032819,12,23,22,106,1645,1808
E01032824,10,22,12,47,1392,1483
E01024013,1,5,26,13,1661,1706
E01024014,0,2,10,8,1688,1708
E01024015,0,3,13,9,1577,1602
E01024034,12,2,27,31,2344,2416
E01023978,1,0,7,5,1258,1271
E01023979,3,11,11,10,1268,1303
E01024032,4,6,7,10,1557,1584
E01024036,0,0,18,4,1279,1301
E01024031,1,1,6,7,1466,1481
E01024038,0,4,14,9,1876,1903
E01024039,1,4,23,10,1453,1491
E01032813,3,49,38,23,1699,1812
E01032814,5,15,22,24,1799,1865
E01024009,0,3,10,4,1077,1094
E01024010,3,3,16,10,1244,1276
E01024011,7,6,7,20,1267,1307
E01024012,2,6,14,13,1039,1074
E01024024,4,6,18,21,2180,2229
E01024025,0,1,12,8,1109,1130
E01023997,15,0,5,4,1432,1456
E01023998,3,2,7,5,1095,1112
E01024026,1,2,14,1,1244,1262
E01024037,4,3,17,4,1749,1777
E01024078,1,3,23,56,1593,1676
E01024080,3,7,10,19,1286,1325
E01024081,7,5,21,18,1520,1571
E01024082,11,5,19,31,1340,1406
E01024095,2,10,14,11,1455,1492
E01024094,2,3,12,18,2406,2441
E01024096,0,8,17,17,1738,1780
E01024097,0,7,17,9,1509,1542
E01024098,0,2,18,3,1567,1590
E01024064,10,4,27,53,2338,2432
E01024066,0,4,19,22,1550,1595
E01024079,1,7,10,17,1458,1493
E01024083,4,5,14,7,1340,1370
E01024118,2,3,19,31,1737,1792
E01024059,2,5,20,42,1460,1529
E01024065,3,6,14,16,1973,2012
E01024117,1,0,12,9,1394,1416
E01024119,4,3,9,25,1584,1625
E01024120,1,0,8,21,1535,1565
E01024056,8,3,18,23,1894,1946
E01024057,3,1,14,11,1763,1792
E01024058,7,0,12,27,1566,1612
E01024114,7,1,15,13,1684,1720
E01024115,3,0,6,11,1373,1393
E01024073,1,6,10,7,1939,1963
E01024074,8,8,11,6,1471,1504
E01024075,3,6,13,10,1595,1627
E01024076,1,9,17,15,1833,1875
E01024077,3,7,28,23,1410,1471
E01024055,0,1,7,14,1497,1519
E01024061,1,5,21,19,1450,1496
E01024063,0,5,16,20,1510,1551
E01024071,1,6,44,14,1617,1682
E01024116,6,12,18,24,1440,1500
E01024060,3,14,28,25,1451,1521
E01024069,2,7,18,18,1335,1380
E01024070,2,9,17,18,1359,1405
E01024072,3,6,29,14,1272,1324
E01024106,1,8,26,12,1531,1578
E01024062,1,10,26,13,1506,1556
E01024105,0,2,22,17,1489,1530
E01024107,0,4,17,37,1408,1466
E01024108,0,4,11,11,1120,1146
E01024109,1,14,25,31,2176,2247
E01024084,1,0,13,17,1110,1141
E01024085,5,1,20,8,1543,1577
E01024086,12,36,52,39,1915,2054
E01024087,2,2,19,25,1200,1248
E01024091,0,10,29,96,1296,1431
E01024110,1,5,12,18,1235,1271
E01024111,1,8,12,18,1494,1533
E01024112,1,16,19,21,1513,1570
E01024113,13,23,27,49,1212,1324
E01024067,4,13,13,34,1068,1132
E01024068,16,24,42,114,1328,1524
E01024123,15,26,32,116,1457,1646
E01032809,135,364,222,753,4702,6176
E01024099,21,32,41,94,1312,1500
E01024100,24,49,49,123,1336,1581
E01024101,28,72,43,131,1570,1844
E01024102,20,43,61,123,1515,1762
E01024103,11,37,22,66,1494,1630
E01024047,22,36,34,251,1240,1583
E01024049,20,38,33,73,1653,1817
E01024090,46,128,67,193,2012,2446
E01024092,16,58,27,76,1377,1554
E01024093,17,42,50,78,1384,1571
E01024044,22,11,40,119,1784,1976
E01024045,16,17,23,73,1455,1584
E01024046,31,42,32,220,1569,1894
E01024048,19,112,66,142,1624,1963
E01024131,15,38,46,82,1417,1598
E01024052,13,11,50,58,2101,2233
E01024053,7,7,34,45,1754,1847
E01024054,2,2,20,13,1761,1798
E01024127,3,20,20,33,1476,1552
E01024042,3,1,12,5,1343,1364
E01024043,2,5,18,15,1353,1393
E01024088,1,1,7,35,1521,1565
E01024089,15,10,21,13,1134,1193
E01024128,9,24,35,41,1551,1660
E01024129,8,45,51,91,1552,1747
E01024130,9,52,47,128,2298,2534
E01024104,31,38,54,148,1734,2005
E01024121,26,30,54,52,1344,1506
E01024122,13,30,37,83,1244,1407
E01024124,23,51,55,75,1368,1572
E01024126,10,47,20,93,1333,1503
E01032807,39,28,48,99,1249,1463
E01032808,35,17,50,98,1217,1417
E01024148,18,99,32,55,1470,1674
E01024149,15,284,118,143,2412,2972
E01024154,5,85,23,65,1088,1266
E01024155,9,77,65,67,1274,1492
E01024140,39,127,75,219,2232,2692
E01024141,7,51,36,53,1450,1597
E01024143,37,95,76,132,1906,2246
E01024179,19,211,97,113,2377,2817
E01024180,14,88,38,102,1194,1436
E01024181,2,82,36,165,1070,1355
E01024182,40,110,53,227,1141,1571
E01024183,10,29,25,99,1221,1384
E01024184,20,97,79,220,1570,1986
E01024185,29,104,61,204,1681,2079
E01024142,19,119,70,120,2396,2724
E01024176,5,33,40,37,1555,1670
E01024177,11,33,30,32,1330,1436
E01024178,6,49,26,23,1534,1638
E01024156,7,126,50,162,1313,1658
E01024161,42,54,45,166,1669,1976
E01024162,42,58,37,103,1386,1626
E01024163,15,96,49,139,1503,1802
E01024164,49,88,49,186,1528,1900
E01024169,11,62,33,98,1306,1510
E01024170,14,76,43,71,1351,1555
E01024171,2,55,22,53,1426,1558
E01024172,12,93,56,74,1695,1930
E01024144,5,30,18,115,1342,1510
E01024145,14,36,30,199,1351,1630
E01024146,12,26,33,88,1328,1487
E01024147,1,91,27,143,1460,1722
E01024186,10,19,33,93,1162,1317
E01024133,15,49,19,140,1142,1365
E01024136,14,53,29,151,1303,1550
E01024137,20,59,28,122,1282,1511
E01024138,14,64,32,147,1553,1810
E01024139,16,43,8,152,1544,1763
E01024165,18,51,32,104,1318,1523
E01024166,10,84,31,116,1464,1705
E01024167,12,82,51,112,1575,1832
E01024168,13,39,22,54,1119,1247
E01024150,8,27,21,80,1380,1516
E01024151,4,17,10,49,1351,1431
E01024152,28,150,75,199,2203,2655
E01024153,2,14,18,70,1306,1410
E01024173,6,5,25,43,1714,1793
E01024187,1,13,16,28,1055,1113
E01024188,10,14,27,46,1214,1311
E01024189,9,14,32,37,1484,1576
E01024132,5,18,31,25,1207,1286
E01024134,3,24,29,41,1546,1643
E01024135,1,21,20,58,1326,1426
E01024174,0,10,20,25,1093,1148
E01024175,0,10,26,16,1237,1289
E01024157,1,6,10,42,1615,1674
E01024158,4,8,12,74,1462,1560
E01024159,0,6,17,43,1511,1577
E01024160,2,14,15,59,1345,1435
E01024206,5,0,9,8,1777,1799
E01024207,5,3,15,14,1780,1817
E01024208,5,2,18,17,1578,1620
E01024209,1,0,22,18,1734,1775
E01024202,1,5,12,18,1878,1914
E01024242,5,16,20,52,1717,1810
E01024243,3,4,17,14,1644,1682
E01024244,9,13,35,36,1667,1760
E01024245,2,0,16,12,1761,1791
E01024219,0,2,13,3,1321,1339
E01024220,0,0,10,8,1582,1600
E01024221,5,5,10,8,1546,1574
E01024227,2,3,18,10,1439,1472
E01024229,1,1,10,8,1440,1460
E01024228,5,8,15,27,1485,1540
E01024230,4,7,11,11,1343,1376
E01024231,2,2,17,27,1490,1538
E01024252,6,7,24,34,2322,2393
E01024201,0,3,5,13,1513,1534
E01024217,3,3,15,11,1656,1688
E01024223,0,7,15,11,1566,1599
E01024225,2,6,6,7,1671,1692
E01024226,1,1,13,9,1451,1475
E01024190,9,2,14,17,1413,1455
E01024191,3,9,9,17,1714,1752
E01024192,11,4,11,9,1663,1698
E01024204,3,14,15,22,1539,1593
E01024218,3,0,10,6,1194,1213
E01024222,1,0,13,13,1544,1571
E01024224,0,3,11,7,1493,1514
E01024250,1,3,18,6,1642,1670
E01024251,3,5,5,4,1625,1642
E01024200,2,1,26,12,1710,1751
E01024203,3,9,13,2,1575,1602
E01024205,3,1,16,11,1589,1620
E01024255,0,4,6,11,1537,1558
E01024232,1,1,17,8,2003,2030
E01024236,0,1,5,9,1577,1592
E01024237,1,1,10,9,1557,1578
E01024253,1,6,7,40,1675,1729
E01024233,1,1,7,14,1582,1605
E01024235,0,6,18,7,1564,1595
E01024254,3,0,9,102,2048,2162
E01024256,1,7,4,14,1396,1422
E01033210,4,2,13,32,2291,2342
E01024193,0,9,8,13,1585,1615
E01024194,5,5,12,14,1470,1506
E01024195,7,3,16,8,1370,1404
E01024196,4,5,14,13,1450,1486
E01024197,2,3,16,13,1535,1569
E01024240,1,8,19,22,1638,1688
E01024241,5,18,28,48,2049,2148
E01024248,3,10,27,34,1826,1900
E01024238,36,18,23,560,1362,1999
E01024239,5,8,22,103,1620,1758
E01024247,13,11,34,90,1803,1951
E01033209,3,3,15,54,972,1047
E01033211,12,7,10,41,1059,1129
E01024214,8,18,34,17,1611,1688
E01024215,10,23,32,107,1442,1614
E01024216,2,1,20,12,1456,1491
E01024246,9,8,34,33,1952,2036
E01024249,7,40,27,37,1961,2072
E01024198,3,0,10,25,2309,2347
E01024212,3,4,6,22,1496,1531
E01024213,2,4,11,7,1365,1389
E01024234,1,2,8,10,1343,1364
E01024276,147,154,61,599,1581,2542
E01024277,36,95,42,186,1529,1888
E01024278,26,105,69,104,1559,1863
E01024279,32,46,45,288,1099,1510
E01024257,151,112,63,477,1239,2042
E01024290,82,47,46,570,958,1703
E01024291,113,30,58,393,1177,1771
E01024295,112,56,61,192,1367,1788
E01032799,109,60,49,423,916,1557
E01032800,26,52,37,70,976,1161
E01024258,101,54,35,378,1039,1607
E01024261,7,30,32,90,2004,2163
E01024293,34,134,40,464,1057,1729
E01024294,55,210,55,296,1652,2268
E01024296,100,123,77,538,2004,2842
E01024262,22,41,43,217,1362,1685
E01024263,9,21,33,88,1373,1524
E01024282,46,74,52,425,1033,1630
E01024283,13,36,20,138,1113,1320
E01024284,42,28,43,261,1184,1558
E01024259,18,14,21,91,1387,1531
E01024260,48,16,32,160,1602,1858
E01024292,78,22,44,466,1028,1638
E01024313,24,27,29,136,1381,1597
E01024317,35,14,40,232,1384,1705
E01024318,16,27,33,129,1374,1579
E01024280,22,89,34,143,1385,1673
E01024281,21,35,15,201,1185,1457
E01024285,15,21,27,159,1169,1391
E01024287,4,30,20,72,1338,1464
E01024288,33,22,10,205,1109,1379
E01024308,5,69,31,52,1263,1420
E01024310,2,43,15,41,1443,1544
E01024311,29,87,37,154,1028,1335
E01024314,9,56,23,88,1107,1283
E01024315,24,109,50,68,1293,1544
E01024297,13,31,29,107,1371,1551
E01024298,4,36,5,89,1282,1416
E01024299,10,15,24,98,1283,1430
E01024309,10,73,31,56,1118,1288
E01024312,13,33,28,69,1154,1297
E01024264,6,34,25,82,1380,1527
E01024286,31,42,24,174,1355,1626
E01024316,25,57,30,241,1496,1849
E01024319,22,41,32,215,1294,1604
E01024265,22,9,14,113,1129,1287
E01024266,1,7,19,27,1099,1153
E01024267,18,2,21,21,1460,1522
E01024300,15,16,16,88,1328,1463
E01024301,4,13,13,85,1132,1247
E01024303,12,49,25,45,1415,1546
E01024304,6,39,32,81,1391,1549
E01024305,9,76,45,53,1337,1520
E01024306,2,50,52,20,1020,1144
E01024307,19,34,36,51,1322,1462
E01024268,8,2,11,32,1549,1602
E01024269,1,2,29,42,1761,1835
E01024270,1,6,13,45,1385,1450
E01024271,7,2,12,16,1377,1414
E01024272,0,6,24,58,1405,1493
E01024273,20,6,13,41,1449,1529
E01024274,9,8,17,12,1449,1495
E01024275,2,4,18,13,1369,1406
E01024302,3,3,6,36,1418,1466
E01024333,1,14,17,14,1330,1376
E01024334,6,14,13,10,980,1023
E01024335,1,15,18,28,1492,1554
E01024338,3,19,13,21,1331,1387
E01024347,1,10,31,29,1631,1702
E01024353,1,17,19,65,1710,1812
E01024354,5,17,24,63,1353,1462
E01024355,2,10,44,87,1820,1963
E01024385,9,11,25,22,1535,1602
E01024386,9,13,24,39,1645,1730
E01024320,2,13,12,22,1142,1191
E01024321,13,3,25,51,1626,1718
E01024322,2,3,7,22,1138,1172
E01024323,13,3,9,53,1267,1345
E01024324,7,3,13,21,1408,1452
E01024341,9,11,23,124,1548,1715
E01024352,5,21,44,108,1617,1795
E01024382,24,124,40,121,1743,2052
E01024383,12,42,42,608,1610,2314
E01024384,17,7,27,39,1693,1783
E01033090,16,23,45,66,1085,1235
E01033092,15,27,50,141,991,1224
E01024330,3,5,23,22,1533,1586
E01024336,4,9,27,34,1593,1667
E01024337,4,4,30,52,1413,1503
E01024348,3,4,20,40,1293,1360
E01024351,4,20,20,128,1335,1507
E01024339,10,29,54,71,1736,1900
E01024340,25,52,38,83,2042,2240
E01024356,7,26,47,77,1465,1622
E01024373,10,49,41,113,1610,1823
E01033087,10,45,34,68,1179,1336
E01033091,2,14,45,65,1556,1682
E01024326,1,2,28,38,1813,1882
E01024327,4,11,32,39,1547,1633
E01024328,0,2,20,13,1553,1588
E01024329,5,13,9,25,1468,1520
E01024349,3,15,24,25,1289,1356
E01024357,17,19,35,130,1485,1686
E01024358,9,14,32,99,1568,1722
E01024367,5,25,18,118,1308,1474
E01024369,10,10,22,69,1423,1534
E01033088,8,16,58,139,1225,1446
E01033089,7,31,34,173,1354,1599
E01024360,2,19,18,47,1436,1522
E01024372,13,32,57,94,1770,1966
E01024374,1,13,46,95,1655,1810
E01024401,6,34,26,29,1419,1514
E01024403,6,11,33,61,1656,1767
E01024371,5,16,26,65,1520,1632
E01024392,16,26,29,105,1422,1598
E01024393,1,20,32,45,1454,1552
E01024395,1,7,17,44,1406,1475
E01024396,3,9,24,53,1485,1574
E01024361,0,3,8,4,1671,1686
E01024362,0,4,13,25,1642,1684
E01024363,3,5,19,29,2057,2113
E01024387,3,6,27,20,2389,2445
E01024331,1,0,5,26,1379,1411
E01024394,0,8,19,23,1359,1409
E01024402,0,7,21,12,1424,1464
E01024404,2,5,17,26,1532,1582
E01024405,1,26,20,65,1892,2004
E01024389,12,34,65,67,2095,2273
E01024390,3,15,18,18,1347,1401
E01024391,0,26,19,31,1359,1435
E01024397,5,18,28,36,1363,1450
E01024398,9,29,20,15,1663,1736
E01024399,1,8,12,28,1259,1308
E01024400,1,5,26,19,1350,1401
E01024325,5,8,35,22,2257,2327
E01024346,0,7,7,10,1269,1293
E01024377,1,3,11,15,1584,1614
E01024378,0,4,11,1,1349,1365
E01024332,1,0,8,7,1182,1198
E01024350,0,11,12,5,1430,1458
E01024375,5,12,32,24,2321,2394
E01024388,5,12,50,70,2792,2929
E01024410,0,9,9,5,1541,1564
E01024342,2,12,22,28,1607,1671
E01024343,2,1,13,1,1402,1419
E01024344,2,2,6,10,1354,1374
E01024376,3,5,20,21,2228,2277
E01024364,4,4,10,19,1590,1627
E01024365,2,3,25,8,1722,1760
E01024366,1,20,28,10,1709,1768
E01024411,6,10,17,39,1216,1288
E01024345,0,1,8,17,1530,1556
E01024379,7,2,17,27,1662,1715
E01024380,2,8,20,16,1642,1688
E01024381,4,5,19,5,1393,1426
E01024406,0,6,22,56,1429,1513
E01024407,1,5,18,28,1443,1495
E01024408,4,6,14,19,1390,1433
E01024409,3,3,10,23,1467,1506
E01024445,0,7,10,12,1261,1290
E01024446,1,11,16,35,1415,1478
E01024447,1,6,5,15,1297,1324
E01024472,12,50,12,18,1304,1396
E01024479,0,16,22,27,1419,1484
E01024476,0,76,49,33,1382,1540
E01024477,3,62,26,26,1299,1416
E01024478,2,47,21,75,1277,1422
E01024480,12,42,39,17,1525,1635
E01024481,8,39,23,40,1425,1535
E01024482,8,27,23,22,1370,1450
E01024421,1,13,26,11,1858,1909
E01024473,5,47,28,40,1477,1597
E01024474,3,43,5,24,1192,1267
E01024475,8,39,19,57,1361,1484
E01024441,1,3,14,28,1478,1524
E01024442,5,3,9,28,1467,1512
E01024443,2,0,14,52,1465,1533
E01024444,7,4,9,39,1207,1266
E01024431,0,7,16,22,1769,1814
E01024432,1,11,38,10,1462,1522
E01024433,3,16,24,15,1261,1319
E01024434,2,17,27,24,1900,1970
E01024435,0,1,11,11,1522,1545
E01024436,0,9,18,15,1462,1504
E01024437,3,4,14,21,1467,1509
E01024438,2,9,9,47,1437,1504
E01024422,12,10,32,46,1758,1858
E01024423,14,2,39,76,1590,1721
E01024439,3,4,26,15,1515,1563
E01024440,6,2,32,29,1853,1922
E01024452,1,8,13,6,1365,1393
E01024448,1,4,9,32,1205,1251
E01024449,2,1,15,15,1407,1440
E01024450,0,1,7,3,1516,1527
E01024453,0,2,9,19,1595,1625
E01024454,1,2,21,24,1529,1577
E01024457,1,4,9,25,1122,1161
E01024460,1,3,25,44,1589,1662
E01024461,3,13,47,50,2333,2446
E01024465,0,4,22,30,1328,1384
E01024466,5,2,25,55,1276,1363
E01024468,3,0,32,41,1416,1492
E01024416,2,2,39,17,1645,1705
E01024418,6,3,17,41,1320,1387
E01024424,6,5,23,14,1367,1415
E01024463,0,5,32,37,1428,1502
E01024464,5,12,30,42,1592,1681
E01024467,6,3,27,49,1620,1705
E01024458,4,10,28,15,1395,1452
E01024459,5,5,10,12,1549,1581
E01024462,6,7,25,28,1609,1675
E01024469,5,15,44,90,1478,1632
E01024470,3,3,31,38,1527,1602
E01024471,8,12,50,116,1663,1849
E01024417,0,4,15,23,1516,1558
E01024419,3,4,27,6,1708,1748
E01024483,4,9,23,34,1504,1574
E01024484,3,5,21,8,1182,1219
E01024485,6,10,27,20,1619,1682
E01024425,4,1,23,15,1543,1586
E01024426,8,13,26,20,1688,1755
E01024427,3,3,12,11,1242,1271
E01024428,2,0,18,14,1265,1299
E01024429,1,8,38,27,1494,1568
E01024430,1,5,29,15,1378,1428
E01024420,2,4,20,10,2013,2049
E01024451,1,3,33,17,2150,2204
E01024455,2,0,21,8,1175,1206
E01024456,1,0,20,7,1233,1261
E01024413,3,6,17,18,1579,1623
E01024414,4,4,20,17,1521,1566
E01024415,3,11,11,19,1314,1358
E01032619,1,10,28,23,1556,1618
E01024490,0,2,10,13,2062,2087
E01024544,0,4,9,4,1382,1399
E01024545,0,0,13,3,1431,1447
E01024547,2,0,23,18,1299,1342
E01024492,31,7,7,205,1272,1522
E01024541,8,4,41,86,2300,2439
E01024542,5,5,23,18,1988,2039
E01033213,8,14,28,133,1606,1789
E01033214,10,10,26,43,1646,1735
E01024496,2,7,12,37,1525,1583
E01024497,1,3,17,21,1619,1661
E01024498,0,10,24,28,1600,1662
E01024503,0,5,15,23,1678,1721
E01024518,2,2,10,20,1687,1721
E01024499,1,7,17,21,1630,1676
E01024500,2,6,21,33,1145,1207
E01024501,5,0,20,46,1505,1576
E01024502,8,19,18,35,1324,1404
E01024505,5,15,26,28,1808,1882
E01024491,7,13,25,187,1296,1528
E01024493,15,1,5,124,1326,1471
E01024494,2,5,16,205,1423,1651
E01024495,27,10,28,580,1142,1787
E01024520,4,5,22,70,1303,1404
E01024528,4,3,15,97,1133,1252
E01024511,10,7,40,28,1315,1400
E01024512,7,11,17,148,1560,1743
E01024513,13,18,26,80,1539,1676
E01024514,3,5,32,90,1248,1378
E01024515,3,2,14,31,1384,1434
E01024516,4,14,16,30,1333,1397
E01024519,5,2,30,286,1231,1554
E01024521,4,12,22,35,1608,1681
E01024523,0,2,19,12,1515,1548
E01024526,1,2,13,9,1501,1526
E01024527,3,2,9,14,1438,1466
E01024550,1,1,16,24,1980,2022
E01024489,2,3,9,8,1681,1703
E01024530,2,1,9,38,1414,1464
E01024536,0,3,13,7,1981,2004
E01024546,5,5,21,14,1556,1601
E01024522,3,1,11,36,1293,1344
E01024524,2,9,15,28,1425,1479
E01024525,1,5,22,29,1506,1563
E01024529,1,5,8,6,1415,1435
E01024531,0,3,9,9,1418,1439
E01024486,1,4,8,7,2002,2022
E01024487,3,0,14,4,1245,1266
E01024488,0,2,14,10,1274,1300
E01024548,0,0,19,12,1214,1245
E01024549,0,1,9,4,1099,1113
E01024537,2,2,15,21,1635,1675
E01024538,2,6,11,17,1733,1769
E01024539,0,4,23,35,1944,2006
E01024540,1,5,8,12,1520,1546
E01024532,1,0,14,9,1435,1459
E01024533,1,2,16,3,1197,1219
E01024534,0,1,10,4,1517,1532
E01024535,4,5,14,17,2317,2357
E01024504,18,27,44,66,1880,2035
E01024507,13,30,29,99,1824,1995
E01033212,8,12,18,88,1335,1461
E01033215,5,3,9,35,1155,1207
E01024508,19,20,46,78,1792,1955
E01024509,6,15,34,29,1555,1639
E01024510,19,20,33,39,1522,1633
E01024517,8,29,37,70,1549,1693
E01024609,8,6,10,26,1122,1172
E01024610,2,6,23,15,1523,1569
E01024611,3,4,26,11,1528,1572
E01024612,5,12,19,16,1477,1529
E01024613,6,12,17,19,1374,1428
E01024614,0,5,14,15,1486,1520
E01024615,1,8,14,5,1467,1495
E01024616,0,7,15,14,1617,1653
E01024585,0,5,16,12,1395,1428
E01024587,0,4,13,23,1401,1441
E01024588,2,4,12,19,1432,1469
E01024589,0,7,16,14,1514,1551
E01024595,0,16,17,27,1432,1492
E01024598,0,22,17,24,1508,1571
E01024619,3,3,15,8,1420,1449
E01024621,2,8,17,0,1228,1255
E01032653,3,9,8,6,1475,1501
E01032654,2,31,19,58,1719,1829
E01024594,2,1,11,10,1371,1395
E01024596,0,1,18,7,1585,1611
E01024597,3,15,8,8,1420,1454
E01024620,0,2,5,5,1230,1242
E01024580,2,1,6,8,1661,1678
E01024581,2,8,8,10,1313,1341
E01024586,0,2,15,9,1598,1624
E01024618,11,167,86,98,2660,3022
E01024576,3,43,19,17,1566,1648
E01024577,2,29,16,14,1308,1369
E01024578,0,34,16,20,1564,1634
E01024579,6,235,65,72,2592,2970
E01024583,1,35,18,12,1610,1676
E01032655,0,39,17,10,1518,1584
E01032656,4,52,8,12,1427,1503
E01024570,1,12,17,9,1710,1749
E01024571,3,7,20,9,1506,1545
E01024572,2,5,14,22,1101,1144
E01024573,0,2,18,4,1316,1340
E01024575,2,3,13,12,1150,1180
E01024554,1,12,30,22,2367,2432
E01024561,2,15,26,20,1297,1360
E01024567,7,110,53,53,2551,2774
E01024568,6,34,59,45,2650,2794
E01024582,6,20,10,11,1520,1567
E01024559,1,18,14,15,1291,1339
E01024584,1,9,15,23,1656,1704
E01024590,3,9,22,24,1474,1532
E01024599,5,18,30,41,1832,1926
E01024608,9,24,29,48,1628,1738
E01024591,2,31,28,21,1728,1810
E01024592,2,9,15,5,1233,1264
E01024593,1,9,17,9,1335,1371
E01024600,1,6,18,15,1444,1484
E01024601,1,4,26,9,1572,1612
E01024560,3,6,21,19,1224,1273
E01024562,6,6,33,23,1411,1479
E01024569,1,19,16,66,1664,1766
E01024630,2,10,3,19,1611,1645
E01024632,6,5,11,19,1519,1560
E01024606,1,15,12,14,1352,1394
E01024628,2,1,11,10,1473,1497
E01024629,0,2,7,5,1127,1141
E01024631,0,9,20,10,1637,1676
E01032735,3,8,18,23,1516,1568
E01032737,7,38,19,17,1362,1443
E01024564,1,2,7,4,998,1012
E01024603,1,2,10,4,1229,1246
E01024604,1,1,23,13,1156,1194
E01024605,1,2,3,2,1331,1339
E01024626,4,5,18,6,1542,1575
E01024627,4,2,18,13,1897,1934
E01024551,3,7,30,13,2188,2241
E01024552,2,9,21,16,1807,1855
E01024553,6,6,25,19,1932,1988
E01024563,4,3,27,14,1533,1581
E01024602,7,4,15,16,1447,1489
E01024625,2,4,16,23,1817,1862
E01024565,1,0,6,3,1295,1305
E01024566,0,1,12,7,1463,1483
E01024622,3,6,21,15,1636,1681
E01024623,1,6,16,10,1805,1838
E01024624,3,8,19,19,1755,1804
E01024555,5,12,11,13,1299,1340
E01024556,1,1,6,5,1169,1182
E01024557,5,2,9,4,1473,1493
E01024558,6,3,13,4,1585,1611
E01024657,15,58,61,89,2053,2276
E01024658,23,59,48,42,1900,2072
E01024659,9,24,37,28,1429,1527
E01024660,21,37,46,64,1592,1760
E01024678,17,27,48,49,1777,1918
E01024653,2,2,27,31,1539,1601
E01024654,0,2,24,24,1469,1519
E01024655,7,6,19,10,1433,1475
E01024656,11,11,25,49,1577,1673
E01024675,11,14,30,43,2049,2147
E01024676,8,25,48,46,1540,1667
E01024677,4,26,37,53,1678,1798
E01024695,3,12,42,33,1212,1302
E01024697,1,13,31,29,1202,1276
E01024710,5,29,27,36,1034,1131
E01024661,7,19,34,26,1424,1510
E01024664,6,11,32,31,1402,1482
E01024665,2,2,16,25,1471,1516
E01024694,24,40,23,125,1567,1779
E01024696,1,13,19,12,1366,1411
E01024672,1,2,29,11,1408,1451
E01024673,6,3,11,12,1760,1792
E01024674,1,7,14,15,1569,1606
E01024711,2,7,19,32,1381,1441
E01024712,2,4,23,24,1501,1554
E01024633,4,6,11,31,1493,1545
E01024634,2,8,23,33,1337,1403
E01024662,6,5,37,33,1498,1579
E01024663,5,11,18,24,1529,1587
E01024666,6,2,25,27,1595,1655
E01024641,2,3,15,13,1424,1457
E01024713,4,1,29,8,1621,1663
E01024714,6,9,43,21,1433,1512
E01024715,3,19,34,41,1706,1803
E01024716,2,10,29,19,1958,2018
E01024636,11,8,21,26,1962,2028
E01024637,4,2,19,23,1624,1672
E01024638,3,4,7,20,1553,1587
E01024639,1,6,20,41,1556,1624
E01024640,3,3,15,15,1557,1593
E01024635,0,11,29,30,1606,1676
E01024642,4,7,18,15,1459,1503
E01024644,1,1,16,8,1305,1331
E01024692,5,7,21,13,1596,1642
E01024693,1,10,11,22,1328,1372
E01024643,12,5,28,18,1170,1233
E01024705,1,7,19,44,1200,1271
E01024706,4,10,46,50,1413,1523
E01024707,2,4,18,8,1329,1361
E01024708,4,18,21,36,1453,1532
E01024686,6,5,16,15,1591,1633
E01024688,10,3,16,28,1509,1566
E01024689,0,2,5,47,1199,1253
E01024690,2,6,20,25,1450,1503
E01024691,4,5,11,32,1220,1272
E01024669,4,8,29,28,1615,1684
E01024698,4,3,17,25,1417,1466
E01024699,3,6,22,16,1806,1853
E01024700,6,9,31,19,1739,1804
E01024709,0,7,13,23,1293,1336
E01024682,2,3,36,31,1651,1723
E01024683,3,12,23,16,1666,1720
E01024684,0,3,24,18,1556,1601
E01024685,1,11,20,21,1813,1866
E01024687,2,6,20,8,1409,1445
E01024701,0,1,25,10,1959,1995
E01024702,2,0,14,14,1309,1339
E01024703,0,3,14,13,1706,1736
E01024704,2,0,5,12,1649,1668
E01024645,0,12,21,22,1461,1516
E01024647,8,20,40,25,1486,1579
E01024668,2,33,35,111,1211,1392
E01024670,8,6,35,23,1503,1575
E01024681,2,10,35,29,1651,1727
E01024646,3,14,74,57,1752,1900
E01024648,2,16,45,35,1421,1519
E01024649,4,26,39,58,1599,1726
E01024667,2,7,38,48,1630,1725
E01024671,4,14,24,49,1555,1646
E01024650,8,5,17,17,1395,1442
E01024651,3,11,23,36,1366,1439
E01024652,6,9,27,13,1767,1822
E01024679,2,2,12,4,1241,1261
E01024680,2,2,17,18,1561,1600
E01024719,6,7,23,31,1916,1983
E01024720,2,7,21,49,1319,1398
E01024721,0,11,11,23,1240,1285
E01024722,7,14,13,35,1308,1377
E01024727,3,12,35,41,2633,2724
E01024728,1,5,27,11,1594,1638
E01024771,0,6,23,19,1817,1865
E01024772,5,1,5,24,1609,1644
E01024773,1,3,11,6,1723,1744
E01024774,2,6,47,30,2376,2461
E01032830,4,6,18,23,2446,2497
E01024741,7,5,28,26,1472,1538
E01024761,7,22,30,37,2118,2214
E01024762,8,14,49,32,1951,2054
E01024763,0,10,5,14,1365,1394
E01024764,8,5,19,22,1209,1263
E01024765,4,2,11,6,1342,1365
E01024782,2,0,10,15,1259,1286
E01024785,3,6,18,10,1443,1480
E01024717,13,0,9,28,1561,1611
E01024718,10,0,8,25,1293,1336
E01024735,3,1,17,45,1504,1570
E01024736,10,15,21,16,1641,1703
E01024737,6,31,42,74,2178,2331
E01024723,3,4,26,11,1543,1587
E01024724,3,11,39,22,1917,1992
E01024725,5,2,22,38,1573,1640
E01024726,7,3,35,46,1628,1719
E01024755,8,3,28,30,2015,2084
E01024786,4,2,28,39,1848,1921
E01024746,1,7,10,5,1060,1083
E01024760,7,10,32,41,1491,1581
E01024781,1,6,32,30,2035,2104
E01032825,4,10,45,53,1464,1576
E01032826,12,6,31,69,1495,1613
E01032827,2,14,42,70,1634,1762
E01032828,9,4,19,29,1177,1238
E01024743,3,2,4,14,1806,1829
E01024744,2,0,14,17,2009,2042
E01024745,5,2,16,22,1827,1872
E01024747,3,11,13,21,1498,1546
E01024730,6,3,25,13,1237,1284
E01024731,4,2,16,14,1173,1209
E01024775,5,3,31,38,1452,1529
E01024776,2,1,16,28,1271,1318
E01024777,2,2,9,39,1186,1238
E01024734,3,3,15,22,1570,1613
E01024752,1,2,25,27,1607,1662
E01024753,4,5,17,22,1547,1595
E01024754,11,6,32,23,1625,1697
E01024729,21,7,28,40,1674,1770
E01024748,8,3,14,13,1414,1452
E01024749,16,1,16,17,1457,1507
E01024750,7,2,7,4,1469,1489
E01024751,2,0,19,21,1514,1556
E01024732,6,13,45,163,1669,1896
E01024733,8,6,27,66,1666,1773
E01024756,9,16,26,42,1560,1653
E01024766,6,10,30,84,1844,1974
E01024767,4,3,20,24,1492,1543
E01024768,10,7,34,71,1564,1686
E01024757,18,1,20,100,1457,1596
E01024758,4,1,22,51,1507,1585
E01024778,4,5,32,57,1481,1579
E01024779,11,11,41,91,1652,1806
E01024780,2,2,24,59,1551,1638
E01024740,5,2,34,26,1758,1825
E01024742,10,5,30,18,1651,1714
E01024783,1,9,28,26,1606,1670
E01024784,9,0,16,14,1333,1372
E01032620,4,1,31,16,2213,2265
E01032829,10,3,10,3,1335,1361
E01024798,1,5,30,13,2418,2467
E01024811,1,8,26,9,1176,1220
E01024812,0,7,12,10,1283,1312
E01024813,11,9,20,32,1594,1666
E01024814,2,2,9,14,1311,1338
E01024815,1,1,15,10,1319,1346
E01024816,1,11,13,8,1338,1371
E01024837,5,16,44,66,1832,1963
E01024844,5,10,46,41,1545,1647
E01024846,0,7,27,50,1516,1600
E01024849,4,11,28,15,1597,1655
E01024850,0,1,17,8,1309,1335
E01024836,9,9,60,70,1612,1760
E01024839,1,5,36,60,1648,1750
E01024845,5,6,17,35,1291,1354
E01024847,10,12,33,54,1514,1623
E01024848,2,5,20,38,1293,1358
E01024793,4,4,22,9,1643,1682
E01024825,8,10,20,38,1468,1544
E01024826,7,0,7,31,1422,1467
E01024827,1,8,15,41,1511,1576
E01024828,5,2,25,39,1470,1541
E01024840,5,14,29,87,1884,2019
E01024841,14,26,36,72,1781,1929
E01024842,15,8,29,66,1484,1602
E01024843,5,7,25,29,1423,1489
E01024829,12,2,32,12,1600,1658
E01024851,1,1,24,32,1665,1723
E01024852,4,13,23,20,1295,1355
E01024853,0,2,16,19,1330,1367
E01024854,2,5,33,18,1638,1696
E01024799,5,10,49,70,1857,1991
E01024800,12,1,29,25,1611,1678
E01024835,9,30,50,64,1970,2123
E01024838,4,12,49,67,1609,1741
E01024801,17,32,57,285,2203,2594
E01024802,24,40,54,106,1816,2040
E01024823,19,14,46,83,1657,1819
E01024833,16,26,20,193,2154,2409
E01024821,3,7,40,31,1973,2054
E01024822,4,26,31,72,1748,1881
E01024824,7,6,28,21,1547,1609
E01024832,1,13,33,63,1554,1664
E01024834,8,26,60,74,2077,2245
E01024795,9,30,35,68,1313,1455
E01024796,3,17,21,43,1324,1408
E01024830,2,5,21,144,1697,1869
E01024831,5,2,21,29,1392,1449
E01024792,6,1,18,5,1865,1895
E01024794,0,0,17,8,1696,1721
E01024804,10,4,17,17,1453,1501
E01024805,0,5,23,13,1665,1706
E01024806,1,27,20,37,1741,1826
E01024797,9,4,26,48,1536,1623
E01024817,6,5,41,16,1761,1829
E01024818,4,4,37,12,1670,1727
E01024819,9,7,33,42,1614,1705
E01024820,8,3,55,46,1594,1706
E01024787,2,0,17,13,1262,1294
E01024788,0,6,15,6,1462,1489
E01024790,5,11,28,24,1237,1305
E01024791,1,1,15,16,1304,1337
E01024803,6,0,11,3,2160,2180
E01024789,4,23,38,77,2232,2374
E01024807,2,3,20,16,1553,1594
E01024808,5,1,15,7,1588,1616
E01024809,2,3,7,5,1461,1478
E01024810,7,6,7,8,1673,1701
E01028479,2,2,7,4,1234,1249
E01028480,0,1,17,5,1446,1469
E01028508,3,0,7,4,1075,1089
E01028509,3,6,7,8,1503,1527
E01028441,3,27,57,132,2255,2474
E01028443,3,13,14,32,1402,1464
E01028444,9,11,28,53,1432,1533
E01032943,3,15,36,31,1547,1632
E01032944,1,25,12,46,1263,1347
E01028445,2,32,23,227,1174,1458
E01028446,1,23,18,123,1379,1544
E01028447,4,21,25,170,1040,1260
E01028448,11,26,36,186,1347,1606
E01028435,14,73,48,115,1446,1696
E01028437,3,21,37,294,1237,1592
E01028438,14,41,24,214,1394,1687
E01028439,3,17,19,107,1277,1423
E01028440,6,39,44,157,1388,1634
E01032941,5,32,33,185,1178,1433
E01032942,17,47,54,162,1135,1415
E01028449,1,24,16,139,1174,1354
E01028450,3,37,42,76,1303,1461
E01028451,0,12,37,50,1209,1308
E01028452,3,24,30,86,1250,1393
E01028453,0,30,33,95,1201,1359
E01028454,1,23,62,161,1348,1595
E01028430,1,19,47,54,1356,1477
E01028431,3,11,18,73,1410,1515
E01028432,2,12,21,61,1455,1551
E01028433,3,9,11,14,1641,1678
E01028434,0,16,19,61,1459,1555
E01028426,9,4,23,35,1307,1378
E01028427,13,74,44,179,1214,1524
E01028428,4,20,18,74,1327,1443
E01028429,11,14,18,79,942,1064
E01028422,3,1,31,18,1495,1548
E01028423,1,1,8,11,1442,1463
E01028475,4,6,28,10,2078,2126
E01028476,8,10,25,31,2331,2405
E01028474,3,6,19,14,1540,1582
E01028485,0,2,11,1,1299,1313
E01028486,1,2,4,6,1270,1283
E01028503,0,3,7,5,1136,1151
E01028504,6,1,15,32,1469,1523
E01028481,3,1,15,19,1433,1471
E01028482,2,5,16,3,1198,1224
E01028505,4,16,35,12,1691,1758
E01028506,1,3,30,11,1708,1753
E01028507,5,3,17,11,1392,1428
E01028425,26,129,51,34,2008,2248
E01028477,4,13,15,24,1480,1536
E01028478,23,61,42,27,1328,1481
E01028483,2,0,12,9,1247,1270
E01028484,1,5,6,7,1074,1093
E01028499,2,7,8,15,1489,1521
E01028459,4,12,30,49,1381,1476
E01028460,7,15,33,61,2043,2159
E01028461,7,30,34,59,1618,1748
E01028462,3,17,23,54,1534,1631
E01028455,5,11,19,22,1385,1442
E01028456,2,19,38,77,1327,1463
E01028457,3,19,14,30,1330,1396
E01028458,0,30,44,18,1453,1545
E01028467,8,17,27,54,1475,1581
E01028466,16,31,58,88,1537,1730
E01028469,3,19,32,37,1436,1527
E01028470,2,15,15,37,1629,1698
E01028471,2,35,45,60,1224,1366
E01028472,3,14,22,38,1218,1295
E01028473,0,14,27,56,1442,1539
E01028463,11,47,64,77,2324,2523
E01028464,2,19,28,41,1338,1428
E01028465,3,28,17,27,1385,1460
E01028468,3,23,28,99,1694,1847
E01028424,4,1,26,20,1551,1602
E01028497,3,5,12,21,1381,1422
E01028498,4,13,34,18,1564,1633
E01028500,13,102,87,101,1805,2108
E01028501,4,6,4,18,1249,1281
E01028502,2,1,9,18,1200,1230
E01028487,13,35,22,129,1075,1274
E01028489,16,12,16,24,1329,1397
E01028490,14,29,18,50,1097,1208
E01028491,4,16,34,34,1411,1499
E01028494,1,24,50,111,980,1166
E01028492,17,30,32,99,1296,1474
E01028493,8,18,31,69,1284,1410
E01028495,14,19,32,78,1170,1313
E01028496,27,31,41,133,1169,1401
E01028488,40,64,42,204,1231,1581
E01028510,5,10,27,56,1501,1599
E01028511,11,33,36,49,1480,1609
E01028512,3,21,29,31,1359,1443
E01028594,38,29,38,114,1324,1543
E01028595,5,13,41,36,1340,1435
E01028596,15,22,57,86,1288,1468
E01028597,15,29,39,163,1174,1420
E01028591,17,19,43,82,1252,1413
E01028592,18,22,54,100,1355,1549
E01032554,24,16,51,137,1841,2069
E01032555,96,78,124,262,1618,2178
E01028565,7,7,31,60,1148,1253
E01028583,28,21,52,157,1158,1416
E01028584,33,50,102,169,2244,2598
E01028585,9,21,48,167,1238,1483
E01028560,18,39,41,147,1245,1490
E01028561,20,33,45,232,1263,1593
E01028562,40,57,81,266,1203,1647
E01028563,24,19,42,207,1237,1529
E01028513,28,177,103,311,1627,2246
E01028514,12,154,69,179,1088,1502
E01028516,16,97,94,190,1375,1772
E01028538,20,63,47,245,1118,1493
E01028534,9,31,17,128,954,1139
E01028535,24,46,48,176,1307,1601
E01028536,17,32,38,132,1162,1381
E01028537,29,89,47,330,1148,1643
E01028539,46,87,60,414,1278,1885
E01028540,38,99,100,423,2186,2846
E01028515,12,81,51,189,1349,1682
E01028571,21,52,55,108,1348,1584
E01028572,7,38,57,119,1412,1633
E01028573,19,53,79,223,1372,1746
E01028574,16,63,46,140,1080,1345
E01028521,110,116,333,1046,6695,8300
E01028522,58,83,162,446,2737,3486
E01033282,57,61,162,503,3773,4556
E01028548,26,13,45,173,1451,1708
E01028549,16,31,47,131,1419,1644
E01028550,22,30,55,95,1200,1402
E01028551,55,52,75,308,1576,2066
E01028523,43,97,61,324,995,1520
E01028524,19,117,60,274,1057,1527
E01028525,35,184,94,325,1281,1919
E01028526,33,75,50,416,1763,2337
E01028579,12,66,65,256,1250,1649
E01028580,44,46,72,169,1152,1483
E01028581,9,43,42,134,1254,1482
E01028582,22,32,47,181,1056,1338
E01028586,12,82,69,143,1413,1719
E01028587,15,66,87,322,1521,2011
E01028588,16,30,78,215,1261,1600
E01028541,29,27,54,86,1276,1472
E01028542,25,57,87,265,1397,1831
E01028543,8,49,51,188,1024,1320
E01028544,11,39,36,120,1115,1321
E01028531,52,108,75,244,1690,2169
E01028532,47,164,78,645,1663,2597
E01028533,61,205,142,498,1305,2211
E01028556,38,102,72,351,1221,1784
E01028557,21,165,118,323,1545,2172
E01028558,29,85,88,333,1183,1718
E01028559,6,68,63,258,1303,1698
E01028545,13,50,51,121,1418,1653
E01028546,25,106,87,420,1269,1907
E01028547,20,53,91,326,1663,2153
E01028527,17,65,69,231,1358,1740
E01028528,45,107,84,347,962,1545
E01028529,23,158,108,259,1022,1570
E01028530,14,143,75,302,1173,1707
E01028575,14,69,66,199,1180,1528
E01028578,13,46,30,177,1284,1550
E01028552,10,120,73,129,1392,1724
E01028553,15,109,66,111,1510,1811
E01028554,16,81,37,159,1033,1326
E01028555,4,94,37,117,1328,1580
E01028576,15,78,53,344,972,1462
E01028577,16,229,79,337,1299,1960
E01028517,9,161,71,89,977,1307
E01028518,13,238,94,107,1165,1617
E01028519,10,182,91,127,1041,1451
E01028567,14,245,98,89,1310,1756
E01028520,17,172,120,111,1282,1702
E01028568,43,222,89,30,1217,1601
E01028569,20,169,98,90,1358,1735
E01028570,21,201,100,141,1436,1899
E01028666,1,5,20,34,1476,1536
E01028667,1,6,18,24,1335,1384
E01028668,1,1,11,6,1383,1402
E01028669,1,8,20,48,1276,1353
E01028638,1,4,19,26,1332,1382
E01028639,15,20,34,73,1200,1342
E01028640,1,2,34,29,1388,1454
E01028683,7,9,25,9,1328,1378
E01028670,2,2,7,10,1475,1496
E01028671,3,9,27,31,1350,1420
E01028672,2,1,33,18,1656,1710
E01028673,1,1,25,14,1219,1260
E01028646,1,3,28,19,1099,1150
E01028647,8,9,17,13,1530,1577
E01028681,1,3,27,21,1240,1292
E01028682,1,5,20,12,1160,1198
E01028684,3,36,20,27,1337,1423
E01028598,2,5,12,9,2342,2370
E01028613,2,6,10,12,1407,1437
E01028614,1,5,11,16,1465,1498
E01028615,0,3,10,18,1552,1583
E01028616,2,0,8,8,1388,1406
E01028604,3,21,18,147,1359,1548
E01028605,2,16,30,11,1496,1555
E01028607,2,5,9,7,1308,1331
E01028641,0,3,9,19,1173,1204
E01028657,5,14,39,37,1118,1213
E01028658,3,11,12,28,1261,1315
E01028600,2,5,15,14,1463,1499
E01028603,0,6,17,9,1169,1201
E01028606,1,3,10,14,1703,1731
E01028609,1,3,20,11,1302,1337
E01028610,0,2,10,19,1462,1493
E01028678,1,5,20,10,1513,1549
E01028679,0,2,21,21,2130,2174
E01028680,4,4,11,39,1670,1728
E01028625,15,31,32,97,1787,1962
E01028626,2,23,22,28,1573,1648
E01028627,0,17,29,39,1409,1494
E01028628,2,3,25,40,1423,1493
E01028629,6,12,20,45,1363,1446
E01028621,19,14,24,39,1336,1432
E01028622,2,12,16,14,1170,1214
E01028623,19,17,20,78,1500,1634
E01028624,0,5,5,21,1420,1451
E01028599,4,6,2,11,1355,1378
E01028601,1,14,15,9,1877,1916
E01028602,2,21,20,9,1491,1543
E01028620,6,70,58,74,2625,2833
E01028608,1,2,10,16,1194,1223
E01028617,1,6,19,28,1831,1885
E01028674,2,7,8,20,1289,1326
E01028675,0,12,29,12,1198,1251
E01028676,8,19,34,41,1923,2025
E01028677,9,4,26,35,1357,1431
E01028630,2,27,25,67,1428,1549
E01028631,1,5,24,39,1035,1104
E01028632,5,15,20,51,1386,1477
E01028633,2,46,34,43,1380,1505
E01028634,3,5,12,27,1290,1337
E01028635,2,9,4,18,1495,1528
E01028636,2,3,9,49,1244,1307
E01028637,3,1,9,20,1526,1559
E01028618,1,7,17,29,1793,1847
E01028619,0,6,18,22,1789,1835
E01028644,0,3,25,10,1545,1583
E01028648,1,1,16,8,1136,1162
E01028649,0,8,14,3,1530,1555
E01028650,9,5,47,39,1904,2004
E01028651,4,2,17,36,1497,1556
E01028652,6,10,30,52,1892,1990
E01028653,5,4,37,39,1364,1449
E01028654,4,2,24,27,1552,1609
E01028655,5,10,31,44,1624,1714
E01028656,3,2,14,21,1257,1297
E01028611,3,0,19,16,1106,1144
E01028642,3,1,16,12,1263,1295
E01028643,2,0,24,32,1344,1402
E01028645,2,6,9,5,1443,1465
E01028685,8,1,12,8,1166,1195
E01028686,3,23,30,32,1321,1409
E01028612,2,1,24,11,1187,1225
E01028660,5,2,31,18,1704,1760
E01028661,10,7,21,44,1747,1829
E01028662,5,2,14,17,1278,1316
E01028659,3,4,15,13,1584,1619
E01028663,3,1,17,9,1461,1491
E01028664,2,7,26,16,1259,1310
E01028665,1,4,25,9,1277,1316
E01028708,11,12,26,74,1658,1781
E01028709,16,15,28,113,1400,1572
E01028710,12,22,31,84,1486,1635
E01028711,3,2,23,13,1641,1682
E01028733,9,7,20,61,1186,1283
E01028734,11,24,31,48,1438,1552
E01028735,11,7,35,68,1513,1634
E01028740,12,6,50,124,1361,1553
E01028741,11,14,46,61,1411,1543
E01028742,16,11,34,93,1421,1575
E01028738,23,230,47,123,1720,2143
E01028739,3,21,25,28,1828,1905
E01028743,2,10,19,12,1562,1605
E01028744,2,4,5,21,1198,1230
E01028750,2,83,14,47,1320,1466
E01028751,15,10,36,19,1392,1472
E01028752,4,25,32,34,1602,1697
E01028693,7,12,19,89,1486,1613
E01028694,8,26,17,79,1340,1470
E01028701,1,8,27,41,1484,1561
E01028705,2,2,12,45,1228,1289
E01028706,3,3,13,61,1417,1497
E01028707,4,7,15,54,1475,1555
E01028688,8,6,19,43,1141,1217
E01028689,7,24,30,54,1356,1471
E01028695,1,29,25,33,1475,1563
E01028699,12,19,9,16,1542,1598
E01028696,4,14,14,65,1309,1406
E01028697,2,36,21,48,1418,1525
E01028698,2,25,32,47,1387,1493
E01028700,4,23,52,51,1546,1676
E01028703,9,25,35,66,1629,1764
E01033305,8,26,30,107,1117,1288
E01033306,6,21,21,66,1474,1588
E01028726,1,3,13,25,2149,2191
E01028736,7,21,21,31,2269,2349
E01028737,2,8,8,13,2310,2341
E01028690,7,10,24,34,1547,1622
E01028691,2,17,24,21,1360,1424
E01028692,4,20,18,43,1326,1411
E01028702,1,8,12,26,1194,1241
E01028704,6,16,23,57,1756,1858
E01028716,3,30,27,50,1773,1883
E01028717,6,18,19,56,1485,1584
E01028718,1,13,16,25,1444,1499
E01028719,0,11,17,13,1554,1595
E01028749,0,17,17,43,2353,2430
E01028714,10,18,20,18,2287,2353
E01028731,1,1,14,11,1265,1292
E01028732,1,2,14,11,1196,1224
E01028753,4,13,18,14,1373,1422
E01028754,1,10,19,13,1306,1349
E01028721,0,13,19,17,1299,1348
E01028722,1,33,17,34,1516,1601
E01028723,1,5,8,8,1396,1418
E01028724,2,10,7,21,1259,1299
E01028725,0,10,8,6,1488,1512
E01028755,2,5,18,15,1626,1666
E01028756,3,9,31,48,2326,2417
E01028758,4,5,13,8,1523,1553
E01028759,0,1,27,15,1483,1526
E01028760,3,15,14,16,1239,1287
E01028761,4,5,12,19,1314,1354
E01028712,3,7,19,21,1952,2002
E01028727,3,5,18,24,1576,1626
E01028728,11,5,12,17,1121,1166
E01028729,1,7,11,10,1044,1073
E01028730,3,2,14,7,1597,1623
E01028757,0,13,13,13,1485,1524
E01028713,12,1,17,21,2321,2372
E01028715,2,2,13,15,1366,1398
E01028720,0,5,14,26,2216,2261
E01028745,6,5,10,31,1331,1383
E01028746,0,2,18,21,1249,1290
E01028747,12,19,7,26,1186,1250
E01028748,17,1,17,31,1003,1069
E01028780,7,5,16,45,1942,2015
E01028781,6,6,13,10,1220,1255
E01028782,4,8,12,13,1514,1551
E01028783,2,16,20,44,1434,1516
E01028795,1,0,9,8,1523,1541
E01028796,3,10,19,15,1375,1422
E01028797,0,0,26,13,1100,1139
E01028806,1,1,11,18,1945,1976
E01028763,4,1,9,3,1940,1957
E01028776,8,1,14,18,1897,1938
E01028798,2,0,9,11,1990,2012
E01028804,3,2,11,14,1283,1313
E01028823,3,3,33,31,1223,1293
E01028824,3,8,23,26,1480,1540
E01028825,1,1,20,20,1123,1165
E01032954,4,7,43,24,2638,2716
E01028777,1,2,14,9,1075,1101
E01028778,1,1,13,8,1445,1468
E01028779,0,1,2,9,1046,1058
E01028799,0,11,24,12,1881,1928
E01028788,17,3,32,33,1541,1626
E01028789,1,4,12,10,1421,1448
E01028790,5,5,16,4,1152,1182
E01028791,0,4,18,23,1515,1560
E01028784,4,2,12,6,2086,2110
E01028792,7,4,3,5,1057,1076
E01028793,0,1,3,9,1561,1574
E01028794,2,3,2,19,1383,1409
E01028810,1,2,14,18,1323,1358
E01028811,3,5,23,26,1322,1379
E01028813,0,11,35,20,1228,1294
E01028814,3,3,18,23,1367,1414
E01028815,4,2,18,5,1231,1260
E01032947,8,12,45,80,1673,1818
E01032948,7,16,21,49,1850,1943
E01032952,1,10,19,19,1314,1363
E01028809,2,15,17,6,1323,1363
E01028820,5,2,18,6,1307,1338
E01028821,0,11,20,41,1423,1495
E01028822,0,11,11,29,1366,1417
E01028807,14,22,35,58,2037,2166
E01028808,2,13,25,42,1646,1728
E01028816,1,3,20,61,1298,1383
E01028817,6,10,21,38,1406,1481
E01028818,5,14,20,45,1650,1734
E01028819,2,8,30,36,1512,1588
E01028785,2,4,25,25,1500,1556
E01028786,1,7,17,19,1212,1256
E01028787,1,0,15,17,1263,1296
E01028800,1,9,8,14,1276,1308
E01028762,0,0,13,3,1756,1772
E01028766,1,2,19,12,1921,1955
E01028767,2,7,21,15,1802,1847
E01028772,1,4,15,13,1646,1679
E01032949,4,12,32,19,1376,1443
E01032950,6,14,36,21,1723,1800
E01032951,0,18,27,34,1887,1966
E01032953,2,26,39,40,2105,2212
E01028771,1,9,18,26,1397,1451
E01028773,0,3,12,19,1289,1323
E01028774,6,18,45,21,2524,2614
E01028775,0,5,11,19,1246,1281
E01028764,1,5,22,5,1736,1769
E01028765,0,0,11,5,1924,1940
E01028801,1,6,16,12,1339,1374
E01028802,2,8,12,23,1481,1526
E01030330,15,16,57,113,1349,1550
E01030331,14,13,27,59,1434,1547
E01030332,6,7,38,74,1348,1473
E01030333,10,12,37,104,1275,1438
E01030326,13,13,45,54,1488,1613
E01030327,13,10,40,44,1469,1576
E01030328,8,5,43,53,1576,1685
E01030329,11,8,30,45,1369,1463
E01030334,5,14,34,209,1175,1437
E01030335,16,23,37,63,1697,1836
E01030336,15,12,39,96,1716,1878
E01030337,12,7,33,77,1463,1592
E01030361,9,10,44,52,1868,1983
E01030362,2,13,27,67,1067,1176
E01030363,20,31,44,35,1710,1840
E01030364,18,29,33,65,1367,1512
E01030350,11,10,55,40,1520,1636
E01030351,10,4,38,55,1416,1523
E01030352,6,9,43,46,1457,1561
E01030353,9,13,61,69,1435,1587
E01030322,14,15,55,201,1529,1814
E01030323,20,6,37,123,1197,1383
E01030324,8,11,43,62,1454,1578
E01030325,20,12,38,116,1382,1568
E01030357,3,3,37,55,1468,1566
E01030358,21,7,49,64,1302,1443
E01030359,28,23,74,134,1951,2210
E01030360,8,29,41,87,1406,1571
E01030354,12,39,50,97,1285,1483
E01030355,12,10,32,69,1338,1461
E01030356,18,10,34,49,1236,1347
E01030365,11,8,33,140,1353,1545
E01030368,10,11,39,78,1456,1594
E01030319,12,10,45,175,1487,1729
E01030320,6,18,59,175,1483,1741
E01030321,17,4,57,151,1369,1598
E01030369,19,9,52,122,2041,2243
E01030370,6,3,40,76,1508,1633
E01030313,5,21,26,110,1402,1564
E01030314,4,23,45,99,1389,1560
E01030366,32,20,58,151,1525,1786
E01030367,15,13,44,121,1427,1620
E01030338,10,2,32,41,1585,1670
E01030339,16,8,32,74,1271,1401
E01030340,29,9,37,77,1318,1470
E01030341,31,12,48,134,1586,1811
E01030371,10,15,41,94,1321,1481
E01030372,6,5,30,46,1233,1320
E01030373,16,7,36,61,1426,1546
E01030374,17,12,51,87,1433,1600
E01030375,16,20,90,95,1496,1717
E01030376,15,5,32,80,1151,1283
E01030307,27,4,35,94,1530,1690
E01030308,7,9,44,99,1455,1614
E01030309,18,6,32,56,1446,1558
E01030310,29,39,57,136,1620,1881
E01030311,16,15,34,59,1420,1544
E01030312,16,10,37,73,1188,1324
E01030315,21,2,32,44,1519,1618
E01030316,12,7,34,45,1499,1597
E01030317,10,11,32,53,1562,1668
E01030318,5,13,41,64,1416,1539
E01030296,5,6,36,63,1645,1755
E01030297,15,13,49,95,2024,2196
E01030298,8,4,35,48,1486,1581
E01030299,5,8,44,55,1524,1636
E01030346,31,14,73,133,1250,1501
E01030347,27,21,61,121,1434,1664
E01030348,27,16,46,142,1400,1631
E01030349,44,5,45,107,1505,1706
E01030300,17,22,28,84,1458,1609
E01030301,13,5,28,92,1415,1553
E01030302,9,16,35,32,1484,1576
E01030304,11,21,24,49,1523,1628
E01030305,40,17,54,97,1412,1620
E01030306,21,13,63,98,1308,1503
E01030303,20,4,42,76,1684,1826
E01030342,33,9,44,127,1515,1728
E01030343,24,17,40,64,1548,1693
E01030344,38,11,27,108,1346,1530
E01030345,17,13,37,97,1500,1664
E01030386,41,9,25,224,1147,1446
E01030387,27,24,37,152,1433,1673
E01030388,72,10,35,208,983,1308
E01030389,46,10,44,226,1181,1507
E01030393,36,37,48,237,1542,1900
E01030394,26,11,17,122,1587,1763
E01030399,38,69,55,148,1743,2053
E01030400,51,63,58,174,1310,1656
E01030414,24,18,33,51,1199,1325
E01030377,25,18,51,179,2108,2381
E01030378,17,12,36,102,1384,1551
E01030406,48,17,35,135,1365,1600
E01030407,6,20,38,65,1261,1390
E01030408,8,13,30,125,1643,1819
E01030395,23,14,31,106,1580,1754
E01030413,22,17,68,146,1817,2070
E01030415,17,21,28,93,1494,1653
E01030416,20,6,26,91,1186,1329
E01030383,62,115,87,317,1891,2472
E01030384,62,74,117,284,2164,2701
E01030401,21,50,66,195,2133,2465
E01030402,24,11,43,92,1161,1331
E01030385,28,70,61,223,1275,1657
E01030391,29,23,43,96,1628,1819
E01030403,12,19,43,96,1379,1549
E01030404,16,2,36,63,1459,1576
E01030409,24,39,60,244,1121,1488
E01030410,13,46,44,108,1205,1416
E01030381,19,7,30,84,1327,1467
E01030411,36,50,76,307,1711,2180
E01030412,28,46,52,125,1644,1895
E01030419,15,48,31,175,1405,1674
E01030379,12,19,59,146,1367,1603
E01030380,4,9,27,97,1269,1406
E01030405,9,6,33,86,1498,1632
E01030417,2,4,23,67,1244,1340
E01030418,9,8,35,47,1371,1470
E01030420,11,13,36,83,1092,1235
E01030382,6,4,34,129,1224,1397
E01030390,7,11,33,51,1729,1831
E01030392,21,13,23,87,1738,1882
E01030396,14,13,43,179,1578,1827
E01030398,6,13,49,247,1445,1760
E01032624,29,26,43,272,1481,1851
E01030440,12,0,21,29,1569,1631
E01030458,3,3,23,6,1216,1251
E01030459,3,47,32,40,1251,1373
E01030475,5,7,13,17,1275,1317
E01030476,2,2,14,19,1220,1257
E01030477,1,1,20,21,1628,1671
E01030465,6,18,11,33,1367,1435
E01030466,0,7,7,13,1519,1546
E01030473,9,8,38,18,1659,1732
E01030474,45,114,48,76,1676,1959
E01030441,6,4,8,13,1245,1276
E01030442,10,3,20,18,1439,1490
E01030443,4,2,21,13,1306,1346
E01030444,1,9,15,17,1510,1552
E01030445,3,12,28,34,1377,1454
E01030446,3,5,26,58,1277,1369
E01030447,1,3,18,11,1309,1342
E01030426,6,15,22,67,1386,1496
E01030427,12,8,15,38,1429,1502
E01030428,8,18,20,39,1112,1197
E01030429,4,19,9,34,1425,1491
E01030430,5,11,19,23,1436,1494
E01030499,15,3,18,40,1473,1549
E01030500,24,29,19,108,1350,1530
E01030501,25,13,29,67,1504,1638
E01030502,12,14,12,25,1181,1244
E01030503,27,33,19,101,1265,1445
E01030504,15,6,14,32,1056,1123
E01030485,29,31,49,89,1531,1729
E01030487,16,23,35,91,1465,1630
E01030488,90,57,52,313,1757,2269
E01030489,32,23,39,165,2274,2533
E01030481,24,21,48,61,1590,1744
E01030482,18,10,32,77,1268,1405
E01030483,11,1,11,42,1312,1377
E01030484,15,18,30,97,1501,1661
E01030434,50,13,29,95,1463,1650
E01030435,50,14,54,83,1599,1800
E01030462,23,19,24,138,1450,1654
E01030463,26,11,38,76,1336,1487
E01030464,16,13,49,104,1494,1676
E01030486,27,21,44,85,1467,1644
E01030493,4,31,34,69,1157,1295
E01030495,29,36,46,143,1495,1749
E01030498,20,13,40,66,1260,1399
E01030424,1,13,27,42,1435,1518
E01030431,3,10,16,33,1407,1469
E01030432,2,31,42,46,1393,1514
E01030433,1,13,26,49,1554,1643
E01030436,50,24,23,121,2028,2246
E01030437,36,13,46,69,1628,1792
E01030439,35,10,52,136,1486,1719
E01030460,18,11,20,73,1448,1570
E01030461,3,2,18,39,1587,1649
E01030470,114,169,91,611,1958,2943
E01030494,39,27,30,107,1427,1630
E01030496,24,20,18,179,1378,1619
E01030497,19,46,27,129,1394,1615
E01030438,41,17,36,76,1420,1590
E01030450,23,22,65,174,2064,2348
E01030451,37,28,63,147,1609,1884
E01030453,59,14,42,71,1293,1479
E01030455,39,29,41,96,1360,1565
E01030457,55,15,62,152,1317,1601
E01030421,1,9,10,9,1438,1467
E01030422,2,10,11,21,1405,1449
E01030423,3,28,18,18,1585,1652
E01030425,6,21,18,50,1493,1588
E01030452,46,29,60,115,1726,1976
E01030467,11,10,27,58,1526,1632
E01030468,141,166,104,797,2291,3499
E01030469,19,11,28,69,1291,1418
E01030448,6,11,13,31,1428,1489
E01030449,37,11,27,63,1155,1293
E01030454,8,13,40,44,1598,1703
E01030456,15,13,26,15,1376,1445
E01030471,3,2,15,7,1215,1242
E01030472,9,2,12,12,1336,1371
E01030478,6,14,30,44,1947,2041
E01030479,7,3,20,27,1736,1793
E01030480,15,5,24,28,1749,1821
E01030490,11,4,15,14,1556,1600
E01030491,7,8,28,23,1808,1874
E01030492,4,3,17,17,1983,2024
E01030506,0,5,28,25,1295,1353
E01030508,0,8,15,69,1250,1342
E01030509,1,7,25,35,1004,1072
E01030513,7,15,24,42,1321,1409
E01030514,5,5,28,46,1394,1478
E01030505,2,10,17,60,1447,1536
E01030507,0,1,16,18,1205,1240
E01030511,9,11,33,42,1438,1533
E01030512,9,24,32,32,1481,1578
E01030548,17,19,40,135,1665,1876
E01030549,13,15,47,121,1634,1830
E01030550,18,15,28,106,1564,1731
E01030551,10,23,51,94,1420,1598
E01030510,24,9,30,75,1490,1628
E01030552,10,8,21,76,1328,1443
E01030553,10,5,43,54,1593,1705
E01030554,8,9,21,21,1074,1133
E01030539,5,7,28,50,1690,1780
E01030540,3,3,28,36,1986,2056
E01030541,3,1,17,39,1283,1343
E01030542,2,3,20,15,1231,1271
E01030543,11,2,34,61,1438,1546
E01030516,5,13,23,29,1225,1295
E01030517,4,3,15,33,1494,1549
E01030518,1,1,17,19,1308,1346
E01030519,5,6,14,31,1533,1589
E01030520,5,0,13,24,1419,1461
E01030521,13,4,23,35,1572,1647
E01030522,5,0,6,7,1277,1295
E01030523,4,3,18,13,1155,1193
E01030524,5,11,24,49,1918,2007
E01030525,0,6,10,10,1498,1524
E01030526,1,2,7,5,1329,1344
E01030527,1,3,20,19,1571,1614
E01030532,7,3,26,44,1419,1499
E01030533,13,4,17,42,1312,1388
E01030534,4,5,12,35,1214,1270
E01030556,6,13,37,54,1885,1995
E01030535,7,2,24,66,1765,1864
E01030536,22,11,43,34,1696,1806
E01030537,4,4,22,33,1667,1730
E01030538,20,12,29,87,1453,1601
E01030544,1,3,15,14,1571,1604
E01030545,7,11,13,10,1515,1556
E01030546,3,22,21,16,1594,1656
E01030547,26,11,31,38,1495,1601
E01030529,1,3,19,14,1643,1680
E01030555,6,5,17,15,1702,1745
E01030557,5,2,22,17,1839,1885
E01030558,3,5,34,40,2169,2251
E01030515,6,3,10,13,1849,1881
E01030528,4,3,8,12,1386,1413
E01030530,4,1,6,17,1251,1279
E01030531,9,19,35,50,2213,2326
E01030603,15,20,44,106,1319,1504
E01030604,2,16,25,55,1432,1530
E01030605,5,8,24,40,1387,1464
E01030607,15,15,35,74,1605,1744
E01030559,4,6,19,49,1214,1292
E01030560,8,6,38,71,1491,1614
E01030561,9,16,16,49,1350,1440
E01030562,6,21,22,19,1218,1286
E01030563,10,169,73,126,1689,2067
E01030564,1,11,26,35,1338,1411
E01030606,9,8,35,73,1189,1314
E01030641,3,6,13,74,1517,1613
E01030642,6,12,39,71,1471,1599
E01030644,6,18,41,57,1156,1278
E01030565,3,11,21,51,1382,1468
E01030566,2,31,21,34,1433,1521
E01030567,1,26,14,15,1519,1575
E01030568,2,17,36,51,1455,1561
E01030569,23,123,125,183,2244,2698
E01030608,4,23,19,72,1303,1421
E01030609,10,42,34,109,1334,1529
E01030640,9,28,25,45,1425,1532
E01030643,2,24,39,38,1245,1348
E01030635,4,3,14,26,1550,1597
E01030636,13,10,24,96,1107,1250
E01030637,6,3,24,20,1196,1249
E01030638,6,8,22,60,1446,1542
E01030639,3,8,13,32,1429,1485
E01030589,13,25,30,92,1565,1725
E01030590,7,9,55,79,1720,1870
E01030591,3,16,27,97,1269,1412
E01030592,18,11,25,96,1734,1884
E01030599,8,40,40,131,1333,1552
E01030600,14,27,40,43,1432,1556
E01030601,6,76,44,83,1414,1623
E01030602,5,24,35,68,1665,1797
E01030598,6,13,30,66,1480,1595
E01030623,3,9,39,59,2033,2143
E01030624,3,5,20,29,1298,1355
E01030625,5,38,55,102,1471,1671
E01030626,1,6,14,31,986,1038
E01030627,12,11,34,75,1499,1631
E01030615,32,77,70,358,1026,1563
E01030616,9,4,47,72,1465,1597
E01030617,18,53,53,144,1372,1640
E01030618,21,38,44,158,1621,1882
E01030619,16,40,43,141,1263,1503
E01030622,10,22,43,76,1717,1868
E01030610,9,16,32,98,1141,1296
E01030611,35,51,96,215,2287,2684
E01030612,42,108,71,345,1930,2496
E01030613,19,76,66,246,1479,1886
E01030614,4,17,35,58,1502,1616
E01030593,8,25,34,65,1256,1388
E01030596,3,6,22,15,1483,1529
E01030597,5,5,30,26,1526,1592
E01030620,10,3,54,75,1624,1766
E01030621,11,17,28,57,1471,1584
E01030594,14,11,36,43,1684,1788
E01030595,0,5,20,47,1426,1498
E01030630,0,6,24,46,1565,1641
E01030631,2,10,39,41,1408,1500
E01030570,17,30,54,149,1337,1587
E01030571,23,19,30,88,1428,1588
E01030572,12,84,63,282,1682,2123
E01030573,3,29,41,140,1571,1784
E01030574,14,37,54,149,1521,1775
E01030628,6,12,18,36,1338,1410
E01030629,1,20,21,50,1109,1201
E01030632,1,9,20,27,1300,1357
E01030633,0,24,23,41,1294,1382
E01030634,1,27,34,38,1351,1451
E01030584,1,14,24,29,1563,1631
E01030585,0,17,14,49,1513,1593
E01030586,5,23,33,47,1587,1695
E01030587,1,14,17,43,1389,1464
E01030588,8,28,20,74,1341,1471
E01030580,11,27,55,68,1763,1924
E01030581,5,9,15,33,1195,1257
E01030582,7,21,36,61,1139,1264
E01030583,10,10,20,42,1398,1480
E01030575,11,32,55,135,1859,2092
E01030576,9,30,39,106,1497,1681
E01030577,27,30,43,52,1484,1636
E01030578,12,16,23,66,1338,1455
E01030579,17,15,29,79,1293,1433
E01030667,30,13,38,149,1197,1427
E01030668,18,18,33,247,1504,1820
E01030669,21,26,51,136,1400,1634
E01030670,10,21,57,144,1271,1503
E01030671,52,64,108,666,2048,2938
E01030672,86,30,52,282,2039,2489
E01030673,21,6,21,55,958,1061
E01030674,35,25,39,53,1256,1408
E01030675,12,23,22,108,1182,1347
E01030676,49,31,41,101,1142,1364
E01030663,8,11,22,102,1439,1582
E01030664,8,9,32,114,1490,1653
E01030665,14,6,30,135,1334,1519
E01030666,31,11,47,112,1519,1720
E01030687,2,6,23,69,1072,1172
E01030688,8,6,37,73,1350,1474
E01030656,6,34,25,62,1474,1601
E01030658,1,4,22,54,1266,1347
E01030685,10,12,29,70,1304,1425
E01030686,21,8,19,100,1246,1394
E01030689,16,6,21,101,1246,1390
E01030690,53,26,41,150,1388,1658
E01030691,40,22,43,120,1358,1583
E01030692,33,12,22,82,1160,1309
E01030652,4,11,35,70,1539,1659
E01030653,7,20,32,98,1241,1398
E01030654,2,7,20,54,1341,1424
E01030657,5,33,26,78,1346,1488
E01030659,8,10,45,76,1465,1604
E01030647,5,14,34,64,1503,1620
E01030648,12,7,27,80,1498,1624
E01030649,15,20,28,154,1446,1663
E01030650,1,17,37,104,1125,1284
E01030651,5,11,27,59,1232,1334
E01030655,10,21,25,127,1374,1557
E01030662,16,0,19,67,1468,1570
E01030677,16,35,34,257,1234,1576
E01030678,6,57,32,90,1134,1319
E01030679,0,1,11,32,1199,1243
E01030680,5,15,14,71,1429,1534
E01030645,14,38,42,112,1720,1926
E01030646,15,27,49,120,1839,2050
E01030660,6,10,24,88,1960,2088
E01030661,4,6,26,24,1610,1670
E01030684,6,17,24,43,1384,1474
E01030681,11,1,25,100,1450,1587
E01030682,1,8,18,55,1272,1354
E01030683,1,16,31,74,1220,1342
E01030693,8,4,19,34,1136,1201
E01030694,8,13,40,46,1255,1362
E01030695,4,3,22,40,1197,1266
E01030696,3,10,30,59,1373,1475
E01030743,9,43,32,267,1148,1499
E01030744,12,56,56,180,1274,1578
E01030745,28,49,32,206,1272,1587
E01030747,25,30,54,187,1075,1371
E01030709,32,39,65,212,1192,1540
E01030710,39,64,40,267,1258,1668
E01030711,20,49,41,312,1353,1775
E01030746,7,49,36,220,1320,1632
E01030707,42,37,43,253,1250,1625
E01030708,7,47,52,175,1368,1649
E01030712,11,21,29,123,1149,1333
E01030713,18,7,21,59,1124,1229
E01030714,10,44,41,80,1315,1490
E01030715,4,25,37,89,1357,1512
E01030716,10,32,31,103,1349,1525
E01030734,22,23,32,130,1310,1517
E01030735,25,15,30,120,1407,1597
E01030736,67,46,71,402,1211,1797
E01030737,14,8,40,147,1237,1446
E01030738,27,13,29,153,1282,1504
E01030701,15,19,36,78,1429,1577
E01030702,3,22,51,89,978,1143
E01030703,11,28,25,159,1356,1579
E01030704,8,29,31,96,1311,1475
E01030705,10,16,39,76,1487,1628
E01030706,2,25,20,103,1244,1394
E01030697,11,31,30,82,1408,1562
E01030698,10,18,28,80,1540,1676
E01030699,3,19,12,115,1360,1509
E01030700,12,36,43,161,1469,1721
E01030725,11,50,57,166,1471,1755
E01030729,13,17,38,74,1395,1537
E01030739,11,39,64,74,1474,1662
E01030740,16,31,37,88,1598,1770
E01030741,6,24,42,115,1578,1765
E01030748,37,42,55,145,1474,1753
E01030749,25,39,55,59,1378,1556
E01030750,22,24,57,103,1384,1590
E01030751,22,34,41,166,1274,1537
E01030752,27,54,55,242,1262,1640
E01030726,7,15,35,58,1586,1701
E01030727,15,26,64,143,1570,1818
E01030728,6,9,27,73,1547,1662
E01030742,5,13,56,126,1726,1926
E01030753,20,14,43,56,1548,1681
E01030754,10,9,44,107,1350,1520
E01030755,9,36,76,113,1701,1935
E01030756,22,16,39,98,1487,1662
E01030717,10,18,53,55,1463,1599
E01030718,12,8,30,40,1263,1353
E01030719,16,13,37,80,1428,1574
E01030720,17,15,25,40,1483,1580
E01030721,11,11,27,59,1436,1544
E01030722,5,11,25,28,1518,1587
E01030723,3,15,36,42,1470,1566
E01030724,9,2,20,42,1437,1510
E01030730,7,2,27,51,1669,1756
E01030731,15,6,33,37,1780,1871
E01030732,8,3,19,42,1400,1472
E01030733,10,9,38,49,1472,1578
E01030763,10,8,11,32,1114,1175
E01030764,6,5,28,12,1178,1229
E01030765,0,7,24,28,1336,1395
E01030809,1,1,21,23,1387,1433
E01030810,5,6,48,50,1360,1469
E01030811,7,5,20,23,1435,1490
E01030757,6,11,40,58,1476,1591
E01030758,5,2,13,70,1091,1181
E01030759,8,7,23,53,1497,1588
E01030760,8,4,11,62,1147,1232
E01030778,3,6,34,64,1713,1820
E01030779,7,6,12,68,1672,1765
E01030780,6,7,33,72,1510,1628
E01030781,1,5,26,33,1513,1578
E01030786,11,21,37,149,1573,1791
E01030787,7,24,17,112,1284,1444
E01030788,4,6,53,139,1199,1401
E01030801,20,14,33,133,1413,1613
E01030802,5,16,41,147,1469,1678
E01030796,9,15,21,83,1270,1398
E01030797,6,9,29,112,1330,1486
E01030798,29,11,25,105,1348,1518
E01030799,29,8,24,116,1211,1388
E01030800,24,32,25,170,1370,1621
E01030761,2,92,68,54,1856,2072
E01030762,2,11,34,55,1791,1893
E01030806,8,10,23,28,1505,1574
E01030807,6,10,27,61,1440,1544
E01030808,8,6,41,33,1487,1575
E01030774,7,12,20,46,1297,1382
E01030775,15,10,32,59,1334,1450
E01030776,13,8,19,86,1487,1613
E01030777,14,20,34,96,1440,1604
E01030793,20,54,49,273,1131,1527
E01030794,11,27,29,250,1281,1598
E01030795,28,22,55,141,1826,2072
E01030803,36,27,32,244,1366,1705
E01030804,2,10,38,144,1628,1822
E01030805,20,19,42,252,1292,1625
E01030789,7,27,30,98,1317,1479
E01030790,11,18,49,97,1530,1705
E01030791,22,18,19,133,1468,1660
E01030792,9,9,23,79,1216,1336
E01030766,17,29,40,269,1286,1641
E01030767,9,19,30,139,1425,1622
E01030768,4,20,16,173,1171,1384
E01030769,3,11,29,141,1347,1531
E01030770,1,8,22,57,1407,1495
E01030771,8,11,38,47,1166,1270
E01030772,2,10,19,89,1395,1515
E01030773,6,19,18,43,1351,1437
E01030782,16,11,24,42,1482,1575
E01030783,4,3,17,52,1538,1614
E01030784,39,72,47,167,2152,2477
E01030785,9,2,13,27,1384,1435
E01030855,9,17,38,89,1678,1831
E01030856,6,16,22,32,1410,1486
E01030859,17,62,91,100,1611,1881
E01030860,13,54,62,99,1791,2019
E01030844,7,40,52,69,1648,1816
E01030845,14,35,37,60,1126,1272
E01030846,2,26,51,48,1409,1536
E01030857,11,55,75,105,1953,2199
E01030858,13,42,95,124,1879,2153
E01030828,8,17,30,100,1217,1372
E01030829,13,19,54,37,1324,1447
E01030830,6,25,36,42,1218,1327
E01030850,15,70,88,105,1871,2149
E01030851,11,48,54,60,1880,2053
E01030861,7,34,49,132,1919,2141
E01030820,3,5,22,37,1668,1735
E01030847,18,43,40,72,1455,1628
E01030848,3,19,50,64,2002,2138
E01030831,7,3,21,39,2176,2246
E01030832,0,2,15,13,1293,1323
E01030836,6,15,23,60,1490,1594
E01030837,6,2,30,37,1467,1542
E01030838,4,3,20,10,1230,1267
E01030839,3,7,21,13,1401,1445
E01030840,3,18,35,15,1428,1499
E01030841,2,4,18,5,1235,1264
E01030842,6,6,25,27,1757,1821
E01030843,7,6,29,17,1486,1545
E01030812,2,9,33,22,1463,1529
E01030813,1,8,32,11,1480,1532
E01030814,3,1,27,14,1259,1304
E01030815,0,15,23,31,1375,1444
E01030824,1,9,32,16,1445,1503
E01030825,3,6,27,21,1339,1396
E01030826,1,3,28,22,1407,1461
E01030827,4,4,21,13,1547,1589
E01030821,2,22,34,42,2130,2230
E01030822,6,4,30,38,1758,1836
E01030833,4,13,21,10,1279,1327
E01030834,0,2,11,37,1343,1393
E01030835,3,0,18,9,1451,1481
E01030816,4,14,19,17,1507,1561
E01030817,6,9,20,19,1351,1405
E01030818,0,4,20,12,1214,1250
E01030819,2,13,21,44,1405,1485
E01030823,12,4,33,51,1996,2096
E01030852,4,15,48,46,1861,1974
E01030853,0,13,39,32,1606,1690
E01030854,4,19,46,40,1811,1920
E01032571,1,2,23,6,1831,1863
E01030890,7,3,23,21,1502,1556
E01030902,1,2,13,28,1275,1319
E01030903,2,4,24,26,1526,1582
E01030904,1,5,13,22,1353,1394
E01030891,6,2,16,10,1541,1575
E01030892,5,7,15,44,1236,1307
E01030899,19,4,17,19,1547,1606
E01030900,3,1,22,12,1184,1222
E01030901,4,15,20,41,1336,1416
E01030884,6,7,20,21,1419,1473
E01030885,6,8,21,39,1405,1479
E01030886,3,3,13,17,1217,1253
E01030893,6,11,20,37,1809,1883
E01030895,2,15,33,42,1437,1529
E01030881,2,2,18,32,1376,1430
E01030883,2,0,17,18,1340,1377
E01030888,3,5,18,59,1431,1516
E01030894,51,3,20,21,1509,1604
E01030911,0,3,25,29,1482,1539
E01030912,4,1,10,12,1278,1305
E01030913,10,8,15,16,1194,1243
E01030920,3,10,32,33,1428,1506
E01030921,4,12,36,20,1606,1678
E01030882,8,4,14,22,1312,1360
E01030887,10,6,21,21,1315,1373
E01030889,3,8,14,48,1422,1495
E01030896,16,12,19,46,1076,1169
E01030897,1,2,11,8,1318,1340
E01030916,8,9,21,50,1624,1712
E01030917,14,7,18,23,1028,1090
E01030918,5,7,26,30,1048,1116
E01030919,7,15,55,104,1718,1899
E01030922,2,3,12,16,1383,1416
E01030863,1,6,9,22,1876,1914
E01030865,7,21,19,51,1440,1538
E01030866,4,6,20,19,1509,1558
E01030940,2,9,14,11,1725,1761
E01030898,1,1,16,18,1578,1614
E01030905,12,8,22,29,1465,1536
E01030906,11,8,20,33,1635,1707
E01030907,2,5,21,21,1324,1373
E01030914,3,2,35,27,1287,1354
E01030915,4,10,30,23,1559,1626
E01030923,0,10,15,17,1418,1460
E01030924,4,3,15,11,1213,1246
E01030925,3,8,40,25,1538,1614
E01030877,2,1,5,20,1145,1173
E01030878,6,14,25,16,1508,1569
E01030937,2,3,22,13,1605,1645
E01030938,1,3,20,22,1278,1324
E01030939,0,2,19,14,1152,1187
E01030864,3,16,26,21,1483,1549
E01030879,1,1,6,13,1103,1124
E01030941,4,25,35,62,1451,1577
E01030942,3,4,22,17,1373,1419
E01030943,0,9,10,8,1283,1310
E01030870,1,1,13,19,1579,1613
E01030871,0,9,20,19,1593,1641
E01030872,15,13,29,29,1697,1783
E01030873,2,1,14,13,1401,1431
E01030874,4,9,23,28,1624,1688
E01030875,6,3,14,25,1253,1301
E01030876,2,3,11,29,1190,1235
E01030862,0,0,20,12,1816,1848
E01030867,3,2,12,12,1355,1384
E01030868,1,5,6,15,1297,1324
E01030869,3,0,10,13,1215,1241
E01030880,2,19,25,64,2118,2228
E01030930,8,2,26,16,1570,1622
E01030931,4,5,27,25,1624,1685
E01030932,5,3,21,7,1457,1493
E01030933,9,5,9,22,1708,1753
E01030926,10,9,20,49,1447,1535
E01030927,7,7,18,14,1251,1297
E01030928,15,22,22,28,1648,1735
E01030929,6,4,23,64,1317,1414
E01030908,2,8,33,123,1519,1685
E01030909,1,0,5,14,1182,1202
E01030910,2,3,18,27,1152,1202
E01030934,1,3,27,21,1491,1543
E01030935,2,2,26,30,1264,1324
E01032626,0,21,13,65,1326,1425
E01030946,10,11,31,74,1211,1337
E01030947,18,9,13,67,1373,1480
E01030948,10,8,35,61,1463,1577
E01030949,14,8,24,67,1619,1732
E01030950,27,15,42,63,1451,1598
E01030996,22,4,16,87,1471,1600
E01030998,23,6,34,69,1766,1898
E01031002,7,10,44,73,1621,1755
E01031003,12,20,58,62,1639,1791
E01031004,31,39,53,154,1803,2080
E01030963,5,11,31,42,1461,1550
E01030964,17,17,56,146,1536,1772
E01030965,16,7,26,81,1337,1467
E01030966,5,13,47,71,1345,1481
E01030967,6,10,30,35,1560,1641
E01030968,14,42,28,135,1074,1293
E01030980,38,63,40,1060,505,1706
E01030981,33,16,30,1017,551,1647
E01030982,12,67,29,836,892,1836
E01030983,67,49,46,881,739,1782
E01030984,18,34,37,625,1324,2038
E01030985,24,36,49,504,952,1565
E01030951,20,15,33,151,1101,1320
E01030952,40,33,55,468,965,1561
E01030953,15,18,28,129,1282,1472
E01030956,9,7,30,68,1217,1331
E01030957,13,14,31,109,1152,1319
E01030958,4,14,25,101,1315,1459
E01030959,1,17,30,83,895,1026
E01030988,26,42,47,345,1544,2004
E01030989,20,23,41,211,1426,1721
E01030990,6,20,36,75,1349,1486
E01030997,5,7,28,20,1464,1524
E01030974,13,19,38,118,1368,1556
E01030975,17,14,22,63,1299,1415
E01030976,19,7,28,87,1397,1538
E01030977,28,24,45,124,1559,1780
E01030979,22,42,65,180,1854,2163
E01030954,67,68,73,365,1650,2223
E01030969,8,7,36,91,1315,1457
E01030970,20,21,52,96,1287,1476
E01030991,19,74,57,191,1586,1927
E01030993,99,89,78,513,1672,2451
E01030960,21,13,32,105,1550,1721
E01030961,7,17,37,82,1784,1927
E01030962,6,28,33,76,1539,1682
E01031000,16,14,33,69,1404,1536
E01030955,14,17,29,197,1137,1394
E01030992,18,18,47,114,1477,1674
E01030999,11,5,36,60,1321,1433
E01031001,19,40,36,90,1502,1687
E01030971,7,37,47,132,1707,1930
E01030972,7,14,42,149,1664,1876
E01030973,6,16,42,77,1629,1770
E01030994,8,23,63,69,1643,1806
E01030995,7,21,39,113,1206,1386
E01030944,14,10,51,91,1231,1397
E01030945,7,3,14,24,1120,1168
E01030978,19,25,45,138,1279,1506
E01030986,4,8,17,35,1010,1074
E01030987,1,4,15,43,1333,1396
E01031349,15,3,12,14,1296,1340
E01031350,8,12,21,50,1118,1209
E01031351,14,10,30,20,1483,1557
E01031352,6,2,21,49,1377,1455
E01031370,12,0,31,26,1382,1451
E01031374,10,7,17,23,1455,1512
E01031338,1,2,18,31,1113,1165
E01031339,3,1,11,9,1151,1175
E01031340,3,2,11,15,1442,1473
E01031365,5,3,41,49,1441,1539
E01031367,4,4,23,11,1240,1282
E01031345,1,3,22,16,1430,1472
E01031353,1,11,16,71,1268,1367
E01031354,10,1,10,8,1202,1231
E01031355,3,5,24,19,1598,1649
E01031359,0,4,11,13,1353,1381
E01031347,20,9,37,39,1519,1624
E01031348,17,24,28,37,1537,1643
E01031366,4,5,23,54,1320,1406
E01031371,10,0,35,26,1189,1260
E01031372,3,10,17,49,1191,1270
E01031373,10,18,25,32,1383,1468
E01031375,8,14,14,17,1403,1456
E01031356,1,17,37,25,2203,2283
E01031357,17,6,37,31,2150,2241
E01031364,4,9,33,19,1390,1455
E01031368,4,2,16,19,1204,1245
E01031369,6,2,34,12,1248,1302
E01031344,4,7,24,17,1293,1345
E01031346,2,10,13,11,1345,1381
E01031361,1,15,29,20,1450,1515
E01031362,1,12,12,20,1232,1277
E01031363,7,10,9,15,1530,1571
E01031358,7,23,25,29,1438,1522
E01031360,2,8,4,17,1503,1534
E01031376,3,0,9,4,1232,1248
E01031378,8,5,14,19,1315,1361
E01031341,7,6,20,23,1295,1351
E01031342,9,10,32,11,1603,1665
E01031343,4,3,4,12,1372,1395
E01031377,3,6,19,74,1431,1533
E01031379,4,12,17,2,1538,1573
E01031390,0,3,7,8,1332,1350
E01031391,1,7,13,10,1444,1475
E01031392,0,2,7,10,1454,1473
E01031465,0,5,9,24,1405,1443
E01031386,0,1,7,7,1453,1468
E01031387,2,3,20,17,1479,1521
E01031425,2,1,5,7,1348,1363
E01031426,6,3,10,11,1164,1194
E01031393,0,3,14,18,1724,1759
E01031394,1,8,21,33,1593,1656
E01031395,4,4,16,14,1496,1534
E01031396,2,9,16,26,1866,1919
E01031397,4,1,20,16,1718,1759
E01031466,1,4,10,7,1424,1446
E01031427,0,7,12,16,1328,1363
E01031429,5,15,37,22,1372,1451
E01031430,4,4,30,23,1370,1431
E01031467,2,10,8,16,1681,1717
E01031468,4,4,40,27,2222,2297
E01031388,2,8,43,38,2554,2645
E01031389,4,4,19,10,2117,2154
E01031414,4,3,20,6,1475,1508
E01031415,2,6,18,6,1503,1535
E01031459,2,7,21,20,1739,1789
E01031470,13,76,30,40,1724,1883
E01031471,2,1,12,10,1260,1285
E01031472,3,0,12,15,1497,1527
E01031473,0,0,14,61,1156,1231
E01031407,3,2,17,10,1540,1572
E01031408,0,4,29,24,1878,1935
E01031410,0,2,6,18,1240,1266
E01031462,6,2,10,10,1442,1470
E01031463,6,5,14,16,1583,1624
E01031464,1,4,22,19,1539,1585
E01031412,0,5,8,14,1363,1390
E01031422,1,1,6,9,1485,1502
E01031423,0,2,9,10,1603,1624
E01031424,1,0,6,9,1338,1354
E01031398,2,5,22,9,1452,1490
E01031399,1,1,8,18,1640,1668
E01031409,4,1,13,20,1360,1398
E01031455,3,1,14,30,1373,1421
E01031461,1,1,10,6,1742,1760
E01031469,2,4,15,11,1645,1677
E01031411,1,2,7,11,1359,1380
E01031413,2,2,12,13,1307,1336
E01031457,0,2,11,7,1565,1585
E01031458,1,4,7,3,1770,1785
E01031460,2,1,12,27,1657,1699
E01031400,8,8,28,44,1535,1623
E01031428,10,5,13,58,1464,1550
E01031454,13,12,48,118,1964,2155
E01031456,14,26,38,126,1577,1781
E01031401,0,11,27,28,1492,1558
E01031402,7,4,18,36,1552,1617
E01031403,4,6,11,38,1354,1413
E01031405,1,7,8,30,1331,1377
E01031406,2,4,7,11,1309,1333
E01031417,2,2,9,4,1586,1603
E01031438,0,3,12,4,1601,1620
E01031439,0,5,16,10,1883,1914
E01031440,0,2,4,8,1529,1543
E01031404,1,1,6,8,1182,1198
E01031433,6,1,12,7,1414,1440
E01031434,3,8,20,13,1565,1609
E01031441,4,7,13,16,1600,1640
E01031442,3,5,28,49,1504,1589
E01031416,3,2,13,14,1550,1582
E01031418,1,2,14,22,1644,1683
E01031419,3,2,17,12,1597,1631
E01031420,0,0,12,11,1605,1628
E01031421,0,13,9,9,1694,1725
E01031443,1,6,18,20,1303,1348
E01031444,9,8,18,60,1495,1590
E01031450,1,5,10,23,1213,1252
E01031451,1,5,16,22,1423,1467
E01031452,1,6,14,32,1438,1491
E01031431,7,19,18,46,1525,1615
E01031432,6,23,40,86,1737,1892
E01031435,2,12,14,38,1621,1687
E01031436,3,11,35,58,1696,1803
E01031437,11,16,23,64,1866,1980
E01031453,1,12,27,35,1586,1661
E01031380,2,1,15,2,1534,1554
E01031381,4,2,19,25,1551,1601
E01031382,1,1,5,8,1673,1688
E01031383,0,2,9,15,1545,1571
E01031384,1,1,22,13,1673,1710
E01031385,1,3,12,4,1541,1561
E01031445,0,4,6,23,1516,1549
E01031446,0,2,9,8,1311,1330
E01031447,0,3,11,8,1506,1528
E01031448,0,6,10,10,1508,1534
E01031449,0,4,19,28,1546,1597
E01031502,2,7,21,14,1532,1576
E01031503,3,8,20,16,1627,1674
E01031504,2,2,34,24,2022,2084
E01031519,3,6,18,10,1369,1406
E01031517,0,4,18,15,1790,1827
E01031518,0,4,16,8,1523,1551
E01031544,1,10,19,11,1238,1279
E01031545,0,1,9,18,1170,1198
E01031508,6,12,18,12,1978,2026
E01031520,1,1,6,6,1308,1322
E01031521,4,2,14,9,1096,1125
E01031536,2,3,8,8,1127,1148
E01031497,1,2,8,9,1338,1358
E01031511,4,0,8,5,1443,1460
E01031512,3,2,22,28,1819,1874
E01032717,1,1,17,11,2516,2546
E01031478,1,1,7,13,1112,1134
E01031479,3,2,9,2,1051,1067
E01031498,1,1,8,8,1116,1134
E01031514,0,5,14,7,1670,1696
E01031515,0,1,20,11,1561,1593
E01031516,0,0,8,8,1437,1453
E01031477,13,10,10,18,2184,2235
E01031485,13,4,21,17,1456,1511
E01031487,10,6,19,33,1460,1528
E01031509,13,7,20,16,2309,2365
E01031506,1,0,7,4,1256,1268
E01031507,4,0,1,3,1395,1403
E01031531,1,0,12,5,1298,1316
E01031533,2,3,12,7,1126,1150
E01031543,2,1,29,14,2263,2309
E01031482,0,11,26,48,1412,1497
E01031483,12,29,51,124,2138,2354
E01031486,14,17,25,52,1684,1792
E01031488,14,56,50,83,1691,1894
E01031494,1,23,22,20,1525,1591
E01031495,2,3,7,21,1544,1577
E01031475,1,3,6,17,1329,1356
E01031476,4,13,5,5,1453,1480
E01031532,11,90,18,35,1488,1642
E01031534,6,18,17,12,1665,1718
E01031535,2,13,14,21,1572,1622
E01031480,1,10,33,87,1206,1337
E01031481,9,10,38,34,1420,1511
E01031484,8,5,22,104,1642,1781
E01031490,14,11,21,128,1735,1909
E01031491,6,9,31,58,1732,1836
E01031474,1,1,10,16,1392,1420
E01031493,0,1,9,34,1635,1679
E01031496,4,5,22,36,2161,2228
E01031505,1,6,9,13,2296,2325
E01031489,3,2,14,24,1491,1534
E01031492,6,6,15,50,1387,1464
E01031513,4,7,17,16,2208,2252
E01031530,4,7,3,22,1221,1257
E01031538,2,2,10,17,1522,1553
E01031539,1,10,10,22,1029,1072
E01031499,2,3,15,22,1789,1831
E01031500,3,2,13,10,1859,1887
E01031501,0,4,3,12,1380,1399
E01031529,0,5,9,4,1153,1171
E01031540,2,1,9,5,1347,1364
E01031541,0,5,7,6,1318,1336
E01031542,1,3,6,11,1751,1772
E01031522,2,3,17,5,1943,1970
E01031523,3,6,12,20,1524,1565
E01031524,1,4,5,12,1463,1485
E01031525,2,2,4,4,1333,1345
E01031526,0,1,11,13,1356,1381
E01031527,1,4,11,5,1518,1539
E01031528,0,1,12,19,1420,1452
E01031573,12,51,46,465,1049,1623
E01031574,33,50,76,431,1278,1868
E01031575,11,160,54,389,1162,1776
E01031576,30,56,43,596,904,1629
E01031577,17,48,43,688,563,1359
E01031586,11,42,34,164,1536,1787
E01031587,11,25,22,171,1452,1681
E01031588,11,13,52,154,1268,1498
E01031590,21,19,32,129,1392,1593
E01031593,6,10,32,130,1221,1399
E01031570,10,30,26,92,1236,1394
E01031571,10,54,47,112,1422,1645
E01031572,2,25,47,134,1303,1511
E01031609,8,34,47,163,1319,1571
E01031610,14,55,35,321,1376,1801
E01031583,29,68,76,281,1524,1978
E01031584,13,56,33,352,1209,1663
E01031585,24,48,29,367,1189,1657
E01031601,16,42,30,212,944,1244
E01032835,31,24,74,265,1079,1473
E01032836,31,36,28,310,1253,1658
E01031589,15,36,39,278,1399,1767
E01031591,21,73,54,231,1435,1814
E01031594,12,21,38,130,1217,1418
E01031600,14,7,30,176,1167,1394
E01031603,17,18,47,277,1125,1484
E01031564,13,29,32,74,1330,1478
E01031565,16,65,73,183,1831,2168
E01031566,11,40,45,171,1339,1606
E01031567,11,29,29,60,1235,1364
E01031568,5,29,34,57,1266,1391
E01031596,18,91,59,235,1472,1875
E01031597,4,41,56,249,1148,1498
E01031598,25,65,58,149,1420,1717
E01031599,21,71,39,225,1395,1751
E01031608,19,55,70,244,1360,1748
E01031578,13,19,51,107,1600,1790
E01031580,17,59,63,172,2037,2348
E01031581,13,21,47,135,1569,1785
E01031592,13,15,35,136,1821,2020
E01031560,4,13,33,134,1292,1476
E01031561,2,8,21,115,1286,1432
E01031562,2,27,27,198,1033,1287
E01031563,10,10,29,121,1134,1304
E01031579,14,27,43,170,1374,1628
E01031582,10,59,44,82,1623,1818
E01031547,20,60,34,145,1073,1332
E01031548,32,145,50,244,1125,1596
E01031549,14,88,55,233,1092,1482
E01031550,34,79,44,170,1128,1455
E01031569,7,46,59,40,1425,1577
E01031595,10,53,55,241,1333,1692
E01031604,6,26,38,103,1390,1563
E01031605,12,61,53,121,1327,1574
E01031606,10,21,35,86,1371,1523
E01031607,21,35,28,137,1197,1418
E01031546,9,127,52,232,1035,1455
E01031551,18,96,62,257,1112,1545
E01031553,33,73,48,256,1149,1559
E01031554,15,102,75,211,1311,1714
E01031555,25,98,45,437,958,1563
E01031552,23,175,75,301,1324,1898
E01031556,21,49,72,122,1391,1655
E01031557,18,41,49,123,1495,1726
E01031558,17,116,99,126,1214,1572
E01031559,9,104,68,205,1143,1529
E01031670,4,13,40,78,1429,1564
E01031671,2,12,28,47,1539,1628
E01031673,0,1,16,31,1519,1567
E01031676,5,18,31,38,2630,2722
E01031644,1,3,12,35,1390,1441
E01031645,1,8,37,41,1352,1439
E01031646,1,8,22,47,1451,1529
E01031647,5,5,34,39,1114,1197
E01031649,5,3,19,49,1071,1147
E01031650,3,5,15,22,1275,1320
E01031666,7,11,22,31,1531,1602
E01031668,5,3,13,39,1471,1531
E01031620,1,7,20,26,1547,1601
E01031648,4,5,37,29,1595,1670
E01031651,8,11,45,21,1608,1693
E01031658,6,14,20,40,1988,2068
E01031689,5,3,29,20,1509,1566
E01031654,2,4,24,35,1532,1597
E01031655,6,14,37,65,1402,1524
E01031667,3,2,30,52,1478,1565
E01031669,5,14,29,70,1452,1570
E01031672,7,13,27,65,1618,1730
E01031657,3,14,24,29,1985,2055
E01031659,0,4,3,14,1544,1565
E01031674,5,3,7,106,1216,1337
E01031675,2,2,8,19,1354,1385
E01031636,18,39,42,226,1874,2199
E01031652,3,9,42,105,1608,1767
E01031653,3,10,39,62,1617,1731
E01031656,7,26,44,96,1567,1740
E01031688,6,7,7,22,1329,1371
E01031691,5,14,29,52,1552,1652
E01031619,1,4,23,23,1460,1511
E01031637,0,11,22,32,1818,1883
E01031638,2,3,32,38,1716,1791
E01031690,0,6,17,24,1469,1516
E01031639,3,6,16,39,1810,1874
E01031640,2,2,28,19,1757,1808
E01031660,3,3,8,11,1217,1242
E01031661,6,9,19,6,1517,1557
E01031679,6,145,113,66,1708,2038
E01031677,4,3,5,17,1461,1490
E01031678,2,2,18,7,1602,1631
E01031680,2,1,22,6,1363,1394
E01031681,5,7,23,16,1461,1512
E01031682,2,9,21,15,1141,1188
E01031683,2,8,17,41,1409,1477
E01031611,2,2,24,18,1566,1612
E01031612,4,11,25,23,2046,2109
E01031613,0,7,23,32,2001,2063
E01031614,3,5,24,33,1989,2054
E01031615,1,7,26,19,1488,1541
E01031632,1,1,15,19,1439,1475
E01031633,0,6,7,4,1276,1293
E01031634,1,0,9,11,1285,1306
E01031635,1,1,17,8,1399,1426
E01031621,2,0,8,16,1638,1664
E01031623,1,1,11,7,1693,1713
E01031627,0,0,11,9,1972,1992
E01031664,2,1,11,28,1573,1615
E01031626,1,2,25,13,1449,1490
E01031630,0,3,20,19,1655,1697
E01031631,0,2,11,17,1529,1559
E01031662,0,2,14,16,1522,1554
E01031663,3,3,15,32,1720,1773
E01031665,0,1,8,7,1189,1205
E01031618,2,11,12,11,1303,1339
E01031641,3,2,21,34,1578,1638
E01031642,8,1,20,21,1799,1849
E01031643,2,2,13,24,1598,1639
E01031687,0,25,21,50,1572,1668
E01031622,1,1,12,5,1590,1609
E01031624,2,2,14,16,1483,1517
E01031625,1,1,25,6,1402,1435
E01031628,1,12,16,17,1424,1470
E01031629,4,1,19,5,1406,1435
E01031616,1,1,17,11,1570,1600
E01031617,1,5,21,24,2324,2375
E01031684,3,4,18,8,1424,1457
E01031685,0,3,10,5,1705,1723
E01031686,0,1,15,6,1399,1421
E01031731,2,23,43,75,1867,2010
E01031732,4,3,33,35,1806,1881
E01031733,7,9,29,55,1664,1764
E01031734,9,2,20,35,1598,1664
E01031741,4,15,24,129,1474,1646
E01031742,3,24,12,59,1773,1871
E01031743,9,19,28,85,1503,1644
E01031718,4,10,22,48,1762,1846
E01031719,3,23,22,43,1701,1792
E01031720,11,4,13,36,1390,1454
E01031722,5,7,27,60,1336,1435
E01031695,2,8,31,28,1496,1565
E01031696,2,5,14,14,1284,1319
E01031729,4,1,33,42,1712,1792
E01031730,9,14,32,52,1714,1821
E01031735,8,4,17,20,1642,1691
E01031736,2,6,21,18,1629,1676
E01031737,2,7,23,42,1465,1539
E01031738,0,7,12,12,1215,1246
E01031739,2,17,24,35,1684,1762
E01031740,0,4,19,30,1272,1325
E01031721,1,8,14,11,1468,1502
E01031723,2,4,22,17,1363,1408
E01031724,0,0,29,19,1338,1386
E01031725,0,4,11,17,1442,1474
E01031694,5,5,23,55,1848,1936
E01031764,0,0,9,7,1441,1457
E01031765,0,10,25,10,1559,1604
E01031766,1,8,16,15,2141,2181
E01031692,3,16,37,22,2100,2178
E01031693,2,3,12,14,1886,1917
E01031697,0,2,15,6,1216,1239
E01031727,4,4,34,13,1698,1753
E01031758,3,1,18,49,1321,1392
E01031760,5,15,40,44,1663,1767
E01031772,3,7,19,10,1624,1663
E01031773,1,0,15,12,1945,1973
E01031774,2,5,20,19,1591,1637
E01031775,1,1,18,24,1677,1721
E01031751,13,46,48,216,2290,2613
E01031759,7,8,21,103,1508,1647
E01031761,19,39,32,290,1655,2035
E01032837,2,16,27,27,1334,1406
E01032838,3,23,35,31,1227,1319
E01032839,2,23,13,61,1034,1133
E01031752,2,23,26,80,1301,1432
E01031753,3,12,24,45,1279,1363
E01031754,6,12,23,105,1434,1580
E01031755,6,15,21,62,1219,1323
E01031757,1,9,41,47,1422,1520
E01031726,3,21,14,18,1418,1474
E01031728,7,11,9,6,1996,2029
E01031749,6,3,22,57,1387,1475
E01031750,8,8,26,55,1381,1478
E01031756,15,6,24,41,1743,1829
E01031763,7,5,21,47,1665,1745
E01031699,0,3,30,36,1608,1677
E01031700,5,16,26,48,1616,1711
E01031701,2,16,29,48,1752,1847
E01031714,0,3,23,23,1489,1538
E01031704,1,10,27,68,1639,1745
E01031706,2,22,22,36,1612,1694
E01031711,4,10,20,19,1695,1748
E01031712,4,5,28,40,1409,1486
E01031713,1,14,17,9,1352,1393
E01031705,11,7,28,66,1456,1568
E01031707,2,2,11,46,1517,1578
E01031708,8,29,39,196,1387,1659
E01031709,9,8,13,82,1494,1606
E01031716,0,5,16,55,1190,1266
E01031717,5,6,15,66,1314,1406
E01031702,0,3,18,33,1433,1487
E01031703,3,3,23,64,1609,1702
E01031710,3,6,20,22,1380,1431
E01031715,5,5,26,45,1486,1567
E01031698,1,2,20,17,1628,1668
E01031767,3,5,10,11,1504,1533
E01031769,0,4,37,10,1732,1783
E01031770,11,1,19,16,1619,1666
E01031771,2,2,22,17,1533,1576
E01031744,5,2,13,10,1439,1469
E01031745,2,2,21,15,1756,1796
E01031746,0,6,31,25,1578,1640
E01031747,1,2,17,8,1405,1433
E01031748,0,1,27,16,1285,1329
E01031768,1,3,16,6,1500,1526
E01031793,5,6,13,31,1283,1338
E01031820,0,5,16,26,1654,1701
E01031821,2,0,15,19,1627,1663
E01031828,1,0,23,20,1273,1317
E01031829,2,0,30,23,1507,1562
E01031822,6,6,34,26,1504,1576
E01031825,1,5,17,28,1558,1609
E01031826,1,7,22,34,1295,1359
E01031827,2,6,18,26,1377,1429
E01031839,6,4,21,24,1683,1738
E01031792,1,5,18,27,1305,1356
E01031794,1,11,14,2,1299,1327
E01031795,6,10,26,15,1450,1507
E01031818,4,12,35,41,1988,2080
E01031830,10,15,23,34,1535,1617
E01031778,3,23,29,16,1443,1514
E01031797,6,4,9,14,1260,1293
E01031800,5,2,10,13,1536,1566
E01031823,3,0,19,33,1375,1430
E01031824,2,1,18,17,1311,1349
E01031776,1,10,19,20,1525,1575
E01031777,7,20,21,88,1546,1682
E01031780,8,18,22,51,1457,1556
E01031781,6,7,32,29,1594,1668
E01031798,11,17,35,38,1433,1534
E01031783,0,16,40,71,1406,1533
E01031785,7,7,17,53,1389,1473
E01031786,3,8,22,35,1442,1510
E01031817,9,6,39,29,1510,1593
E01031819,6,14,26,33,1221,1300
E01031782,1,4,24,28,1619,1676
E01031784,10,13,30,75,1700,1828
E01031836,6,18,45,60,1551,1680
E01031838,4,6,30,40,1540,1620
E01031840,2,3,14,23,1649,1691
E01031791,21,39,57,104,1890,2111
E01031796,3,13,53,94,1424,1587
E01031799,10,21,41,69,1444,1585
E01031801,6,21,61,102,1618,1808
E01031837,12,18,34,76,1777,1917
E01031779,2,20,34,79,1243,1378
E01031831,11,11,30,176,1452,1680
E01031832,4,16,22,38,1548,1628
E01031833,7,30,31,114,1463,1645
E01031834,8,16,37,88,1450,1599
E01031790,18,20,29,95,1660,1822
E01031807,4,4,40,31,1644,1723
E01031809,10,30,30,48,1413,1531
E01031810,8,37,35,56,1450,1586
E01031811,14,17,19,47,1388,1485
E01031787,30,48,43,122,1650,1893
E01031788,13,39,62,251,1744,2109
E01031789,12,41,39,107,1756,1955
E01031808,17,33,43,91,1350,1534
E01031835,17,27,51,99,1631,1825
E01031812,5,4,40,37,1473,1559
E01031813,6,18,30,48,1693,1795
E01031814,3,9,18,18,1453,1501
E01031815,4,10,19,21,1480,1534
E01031816,12,15,37,33,1513,1610
E01031802,3,3,8,25,1517,1556
E01031803,7,4,33,29,1434,1507
E01031804,2,3,9,41,1598,1653
E01031805,1,6,11,24,1568,1610
E01031806,9,7,14,67,1567,1664
E01014399,0,7,16,12,1589,1624
E01014400,2,25,19,22,1876,1944
E01014401,7,3,28,2,1605,1645
E01014402,5,8,26,7,1638,1684
E01014403,2,7,13,8,1641,1671
E01014404,1,11,27,16,1614,1669
E01014395,2,0,8,16,1209,1235
E01014396,1,9,20,38,1366,1434
E01014397,1,1,11,14,1285,1312
E01014398,4,1,12,13,1393,1423
E01014409,0,28,48,12,1502,1590
E01014410,3,15,27,47,1678,1770
E01014411,9,20,41,41,1998,2109
E01014477,3,20,19,43,1369,1454
E01014478,8,15,27,43,1096,1189
E01014479,8,3,22,39,1348,1420
E01014480,17,23,36,115,1070,1261
E01014465,6,22,45,32,1412,1517
E01014466,4,44,50,65,1100,1263
E01014467,21,27,26,37,1509,1620
E01014468,8,14,37,83,1378,1520
E01014370,35,17,48,194,1506,1800
E01014371,24,20,32,148,1642,1866
E01014372,26,25,39,86,1828,2004
E01014412,7,5,21,20,1409,1462
E01014413,15,13,30,106,1434,1598
E01014414,11,34,48,33,1403,1529
E01014427,16,18,30,31,1256,1351
E01014428,14,17,32,60,1309,1432
E01014429,6,28,51,49,1480,1614
E01014430,2,16,29,60,1434,1541
E01014405,9,25,57,56,1929,2076
E01014407,32,26,48,152,977,1235
E01033080,18,49,64,110,1964,2205
E01014373,9,9,34,17,1476,1545
E01014374,4,6,22,20,1389,1441
E01014375,5,1,22,18,1208,1254
E01014376,2,6,18,16,1457,1499
E01014377,5,4,29,27,1343,1408
E01033078,2,12,25,47,1802,1888
E01033079,2,2,15,5,1140,1164
E01014461,0,26,48,26,1074,1174
E01014462,2,23,54,19,1378,1476
E01014463,3,23,56,28,1274,1384
E01014464,0,33,49,29,1170,1281
E01014380,31,32,71,375,2874,3383
E01014381,30,15,28,133,1274,1480
E01014481,11,9,42,174,1209,1445
E01014482,3,8,29,46,1192,1278
E01014483,14,10,43,90,1320,1477
E01014484,10,17,45,79,1419,1570
E01014473,9,18,18,64,1563,1672
E01014474,1,11,31,38,1102,1183
E01014475,11,27,50,104,1983,2175
E01014476,1,13,45,46,1334,1439
E01014435,19,8,29,124,1413,1593
E01014436,4,18,23,74,1465,1584
E01014437,5,15,17,28,1360,1425
E01014438,11,20,33,35,1181,1280
E01014455,7,11,21,32,1246,1317
E01014456,3,40,19,44,1397,1503
E01014457,2,11,20,27,1260,1320
E01014458,3,19,25,28,1314,1389
E01014391,4,2,13,21,1392,1432
E01014392,2,5,15,16,1035,1073
E01014452,1,1,13,14,1442,1471
E01014453,2,6,9,28,1217,1262
E01014454,3,9,18,14,1296,1340
E01014459,1,4,16,14,1421,1456
E01014460,0,2,3,4,1159,1168
E01014415,7,6,38,46,1904,2001
E01014416,7,16,26,38,1627,1714
E01014417,5,1,21,21,1742,1790
E01014387,3,15,29,28,1157,1232
E01014388,4,9,17,23,1252,1305
E01014389,6,11,33,41,1270,1361
E01014390,15,11,61,27,1407,1521
E01014431,12,15,17,30,1151,1225
E01014432,17,18,40,62,1140,1277
E01014433,19,26,25,51,1237,1358
E01014434,10,12,24,53,1722,1821
E01014385,1,2,18,5,1354,1380
E01014386,0,1,9,8,1139,1157
E01014419,1,1,7,26,1257,1292
E01014446,1,1,8,4,1105,1119
E01014447,8,0,5,8,1333,1354
E01014382,1,2,13,7,2363,2386
E01014383,4,2,9,1,1000,1016
E01014384,0,4,21,7,1329,1361
E01014418,11,0,3,5,1372,1391
E01014379,3,10,31,20,2371,2435
E01014442,1,4,18,17,1687,1727
E01014443,3,4,5,30,1533,1575
E01014444,0,5,18,27,1473,1523
E01014445,4,9,25,12,1571,1621
E01014393,0,2,16,16,1316,1350
E01014394,1,4,15,11,1624,1655
E01014439,1,2,5,10,1771,1789
E01014440,4,3,22,25,1843,1897
E01014441,3,3,8,23,1579,1616
E01014448,3,8,16,8,1542,1577
E01014449,4,1,25,10,1428,1468
E01014450,0,2,17,8,1289,1316
E01014451,0,1,7,7,1244,1259
E01014420,8,1,8,15,1539,1571
E01014421,1,0,8,14,1400,1423
E01014422,4,1,6,2,1496,1509
E01014423,6,16,10,22,1318,1372
E01014469,2,7,11,0,1246,1266
E01014470,0,2,9,29,1580,1620
E01014471,3,6,15,20,1506,1550
E01014472,2,1,13,5,1397,1418
E01014424,1,0,7,14,1669,1691
E01014425,2,7,14,10,1958,1991
E01014426,5,2,10,17,1406,1440
E01015301,13,7,16,27,1420,1483
E01015303,7,12,10,18,1473,1520
E01015305,12,13,29,13,1487,1554
E01015306,3,6,26,11,1624,1670
E01015302,3,3,23,27,1794,1850
E01015304,3,9,17,8,1674,1711
E01015308,4,3,24,14,1662,1707
E01015311,2,4,6,10,1318,1340
E01015332,4,4,20,33,1463,1524
E01015333,2,2,10,32,1535,1581
E01015334,4,0,13,26,1568,1611
E01015335,5,12,14,6,1646,1683
E01015337,13,10,29,37,1608,1697
E01015343,11,15,34,33,1458,1551
E01015349,7,14,35,65,1393,1514
E01015351,4,11,25,26,1443,1509
E01015352,9,4,28,32,1456,1529
E01015353,7,1,11,10,1121,1150
E01015354,8,7,36,81,1597,1729
E01015307,13,3,24,10,1343,1393
E01015309,11,4,20,24,1391,1450
E01015312,14,2,6,6,1213,1241
E01015313,10,18,30,22,1289,1369
E01015359,11,15,17,36,1487,1566
E01015320,9,1,28,26,1622,1686
E01015323,11,7,28,28,1511,1585
E01015324,16,9,27,70,1427,1549
E01015325,7,12,30,45,1612,1706
E01015350,5,12,35,20,1379,1451
E01015310,3,2,27,36,1468,1536
E01015336,3,6,21,42,1529,1601
E01015355,8,14,33,50,1584,1689
E01015357,9,11,25,14,1502,1561
E01015358,9,7,37,52,1850,1955
E01015338,19,19,26,90,1661,1815
E01015339,19,9,56,56,1447,1587
E01015340,6,15,22,49,1485,1577
E01015341,30,9,51,87,1313,1490
E01015321,13,20,38,75,1715,1861
E01015356,7,11,37,56,1655,1766
E01015374,18,24,86,136,2046,2310
E01015375,25,25,50,136,1671,1907
E01015377,2,8,44,81,1502,1637
E01015322,19,12,31,65,1533,1660
E01015330,36,12,48,75,1649,1820
E01015342,12,10,29,23,1503,1577
E01015373,31,17,62,82,1512,1704
E01015378,20,22,46,68,1579,1735
E01015314,3,6,20,38,1460,1527
E01015315,12,6,42,105,1767,1932
E01015318,19,19,39,87,1500,1664
E01015319,14,16,37,148,1223,1438
E01015344,14,9,25,87,1652,1787
E01015346,29,12,47,52,1525,1665
E01015348,33,15,48,64,1670,1830
E01015360,17,23,32,59,1656,1787
E01015326,52,19,68,149,1636,1924
E01015331,44,53,83,194,1941,2315
E01015345,27,20,68,122,1662,1899
E01015376,31,16,62,129,1535,1773
E01015316,3,9,17,33,1529,1591
E01015317,6,13,30,17,1508,1574
E01015361,6,18,40,37,1314,1415
E01015362,13,4,27,23,1182,1249
E01015363,10,5,34,57,1589,1695
E01015292,22,24,52,86,1512,1696
E01015293,16,25,40,30,1419,1530
E01015294,30,67,87,95,1670,1949
E01015327,37,33,79,125,1690,1964
E01015329,39,29,66,80,1446,1660
E01015272,4,11,25,48,1634,1722
E01015273,9,34,46,87,1788,1964
E01015275,3,26,39,93,1619,1780
E01015276,15,19,41,58,1567,1700
E01015277,7,26,59,102,1750,1944
E01015283,51,54,97,170,1499,1871
E01015286,24,24,54,89,1719,1910
E01015287,31,44,67,164,1923,2229
E01015328,38,42,53,130,1587,1850
E01033242,12,18,45,97,838,1010
E01033285,33,7,48,68,924,1080
E01015274,8,15,31,18,1694,1766
E01015297,2,20,18,28,1423,1491
E01015364,9,9,31,27,1524,1600
E01015365,7,12,45,49,1595,1708
E01015366,12,4,25,32,1734,1807
E01015279,20,26,56,86,1653,1841
E01015280,14,26,66,84,1793,1983
E01015281,14,20,56,87,1546,1723
E01015282,19,63,68,105,1718,1973
E01033241,8,12,23,41,1028,1112
E01033283,12,5,19,51,1124,1211
E01015295,3,1,11,4,1425,1444
E01015296,7,8,41,24,1646,1726
E01015298,0,4,12,8,1531,1555
E01015299,3,4,16,23,1654,1700
E01015300,16,3,33,18,1500,1570
E01015285,39,59,101,376,2096,2671
E01015288,30,42,55,146,1604,1877
E01015289,34,39,54,107,1637,1871
E01015290,28,51,48,184,1515,1826
E01015291,26,8,37,181,1687,1939
E01015371,13,17,44,54,1406,1534
E01015372,13,11,42,50,1708,1824
E01033286,9,6,34,30,987,1066
E01033288,11,6,14,27,987,1045
E01015367,45,33,99,117,1727,2021
E01015368,27,20,30,59,1544,1680
E01015369,12,10,17,31,1598,1668
E01015370,11,11,28,27,1561,1638
E01014601,14,50,42,131,1425,1662
E01014602,8,92,51,51,1639,1841
E01014603,11,61,68,105,1889,2134
E01014605,13,79,69,65,1389,1615
E01032516,7,25,52,52,1745,1881
E01032517,13,62,87,66,1338,1566
E01014688,4,98,60,92,1462,1716
E01014689,7,79,43,79,1396,1604
E01014690,19,146,79,224,1557,2025
E01014691,7,53,48,133,1698,1939
E01014692,14,87,72,144,1347,1664
E01014693,4,18,23,71,1256,1372
E01014694,25,62,37,159,1353,1636
E01014497,6,32,33,37,1455,1563
E01014498,10,72,49,31,1421,1583
E01014638,3,66,35,23,1497,1624
E01014639,7,92,45,18,1332,1494
E01014640,2,39,25,29,1396,1491
E01014631,13,55,30,132,957,1187
E01014632,12,150,51,183,1147,1543
E01014633,7,51,47,85,1385,1575
E01014636,12,124,79,57,1224,1496
E01014630,24,197,135,184,1551,2091
E01014634,29,100,67,160,1343,1699
E01014659,16,395,118,232,1314,2075
E01014661,7,146,82,164,1265,1664
E01014616,11,11,39,43,1417,1521
E01014719,8,17,27,59,1255,1366
E01014720,18,28,66,39,1447,1598
E01014721,10,13,45,42,1447,1557
E01014641,7,24,31,21,1320,1403
E01014642,14,34,38,49,1314,1449
E01014643,1,15,37,30,1281,1364
E01014644,6,17,35,29,1425,1512
E01014492,9,18,42,18,1391,1478
E01014493,9,42,23,34,1380,1488
E01014494,2,14,16,18,1423,1473
E01014495,14,23,27,35,1562,1661
E01014496,5,16,20,38,1549,1628
E01014499,3,3,31,43,1531,1611
E01014715,16,2,16,40,1537,1611
E01014716,4,5,23,42,1453,1527
E01014717,12,21,44,171,1452,1700
E01014718,2,11,36,90,1256,1395
E01014510,11,74,76,71,1728,1960
E01014635,10,74,70,138,1573,1865
E01014637,6,29,54,46,1236,1371
E01014662,17,98,52,131,1277,1575
E01014615,10,22,26,59,1408,1525
E01014617,5,6,27,41,1260,1339
E01014618,5,12,42,45,1443,1547
E01014620,6,26,44,29,1351,1456
E01014571,16,95,81,119,1278,1589
E01014577,16,38,65,199,1207,1525
E01014586,17,59,52,73,1285,1486
E01014587,18,66,62,188,1037,1371
E01014588,15,148,83,140,1751,2137
E01014589,24,145,99,101,1050,1419
E01014590,13,144,110,150,1396,1813
E01014591,15,85,52,100,1528,1780
E01014592,13,98,50,91,1358,1610
E01014660,11,124,72,142,1223,1572
E01014663,6,159,82,97,1094,1438
E01014664,17,234,68,160,1175,1654
E01014665,53,459,126,366,1098,2102
E01014709,6,15,17,42,1081,1161
E01014710,13,14,29,69,1243,1368
E01014711,22,5,23,38,1129,1217
E01014712,19,25,53,63,1113,1273
E01014713,9,19,17,76,1149,1270
E01014714,14,26,80,175,2685,2980
E01014507,4,28,53,43,1536,1664
E01014508,11,75,69,63,1504,1722
E01014509,11,75,87,98,1790,2061
E01014511,7,48,59,35,1319,1468
E01014512,11,35,41,59,1359,1505
E01014513,13,34,47,17,1480,1591
E01014514,22,38,67,64,1709,1900
E01014619,17,27,41,41,1419,1545
E01014621,7,26,47,35,1354,1469
E01014666,9,25,64,102,1624,1824
E01014667,13,13,52,82,1477,1637
E01014672,18,50,70,75,1836,2049
E01014624,3,136,75,108,1416,1738
E01014629,2,131,88,164,1092,1477
E01032518,17,178,104,204,1345,1848
E01032519,8,54,54,99,944,1159
E01014572,22,135,114,301,1285,1857
E01014573,30,206,81,200,1320,1837
E01014575,27,230,81,373,851,1562
E01014576,66,200,123,218,1313,1920
E01014487,26,55,74,68,1777,2000
E01014491,17,102,101,86,1656,1962
E01014668,21,30,64,31,1492,1638
E01014669,9,28,38,36,1394,1505
E01014670,9,25,76,56,1347,1513
E01014671,10,47,68,70,1440,1635
E01014622,22,64,59,203,1182,1530
E01014623,31,128,71,144,1257,1631
E01014626,49,250,87,199,1391,1976
E01014627,9,133,76,84,1843,2145
E01014557,10,15,50,66,1494,1635
E01014558,8,66,61,97,1643,1875
E01014559,16,38,56,71,1801,1982
E01014560,7,21,65,81,1495,1669
E01014562,11,25,50,86,1666,1838
E01014485,12,264,119,128,1294,1817
E01014486,53,678,176,250,1160,2317
E01014488,4,255,95,109,1530,1993
E01014489,34,398,151,153,1667,2403
E01033347,33,287,110,98,594,1122
E01033348,25,441,73,79,486,1104
E01033366,62,979,119,52,295,1507
E01014539,11,31,66,128,1598,1834
E01014561,16,28,59,55,1583,1741
E01014563,13,52,71,63,1615,1814
E01033342,74,164,73,469,1101,1881
E01033367,22,310,77,87,791,1287
E01014551,13,8,88,82,1590,1781
E01014552,10,21,73,73,1649,1826
E01014553,11,20,59,64,1564,1718
E01014554,20,25,61,101,1490,1697
E01014556,15,8,22,54,1613,1712
E01014673,13,67,72,76,1515,1743
E01014674,14,102,50,81,1325,1572
E01014675,7,53,40,58,1351,1509
E01014676,2,38,32,66,1397,1535
E01014682,25,78,43,63,1367,1576
E01014683,7,90,74,105,1401,1677
E01014685,42,167,45,196,1132,1582
E01014686,10,188,76,72,1284,1630
E01014687,17,109,57,72,1325,1580
E01014565,13,183,136,98,1267,1697
E01014566,23,105,76,107,1358,1669
E01014567,36,187,118,93,1475,1909
E01014681,18,174,129,117,1704,2142
E01014684,34,116,104,53,1401,1708
E01014544,22,34,45,177,1246,1524
E01014545,16,7,44,45,1463,1575
E01014546,16,12,37,34,1350,1449
E01014547,14,5,52,44,1531,1646
E01014538,14,45,75,315,1491,1940
E01014540,87,260,112,258,1959,2676
E01014542,47,60,84,274,1851,2316
E01033344,23,65,69,326,1144,1627
E01033345,21,49,41,363,870,1344
E01033350,9,29,26,35,936,1035
E01014677,5,41,34,36,1297,1413
E01014678,14,96,34,28,1386,1558
E01014679,4,40,27,47,1422,1540
E01014680,6,18,29,28,1206,1287
E01014548,28,47,71,42,1502,1690
E01014549,9,41,39,79,1023,1191
E01014550,23,29,72,101,1937,2162
E01014555,23,50,50,193,1531,1847
E01014528,0,30,46,31,1390,1497
E01014529,7,108,50,44,1222,1431
E01014530,18,52,43,66,1205,1384
E01014531,8,57,63,34,1499,1661
E01014532,5,26,48,24,1365,1468
E01014537,4,63,46,36,1624,1773
E01014695,11,47,51,30,1572,1711
E01014696,3,15,67,29,1582,1696
E01014698,29,16,77,41,1676,1839
E01014699,5,28,59,23,1427,1542
E01014700,5,9,24,34,1487,1559
E01014701,21,34,69,43,1523,1690
E01014730,4,68,93,100,1348,1613
E01014731,10,41,67,124,1284,1526
E01014732,12,63,97,114,1411,1697
E01014735,13,44,40,45,1538,1680
E01014523,4,32,23,7,1285,1351
E01014524,2,27,28,40,1377,1474
E01014525,1,30,43,30,1482,1586
E01014526,0,60,49,34,1374,1517
E01014527,7,26,42,24,1245,1344
E01014500,10,11,29,26,1483,1559
E01014502,5,20,63,53,1575,1716
E01033359,10,85,59,112,976,1242
E01033361,7,33,57,57,1110,1264
E01033362,11,25,52,57,969,1114
E01033364,3,22,54,23,1455,1557
E01014729,14,88,82,91,1160,1435
E01014733,24,62,77,33,1532,1728
E01014734,5,46,36,39,1452,1578
E01014736,22,102,88,85,1626,1923
E01014501,2,12,34,26,1610,1684
E01014504,6,6,39,14,1434,1499
E01014505,4,22,41,24,1649,1740
E01014506,2,4,31,13,1529,1579
E01014645,1,41,31,67,1425,1565
E01014646,3,15,35,55,1465,1573
E01014648,10,25,55,136,1422,1648
E01014649,4,12,25,95,1513,1649
E01014651,8,25,49,26,1523,1631
E01014533,9,37,40,45,1338,1469
E01014534,10,43,69,45,1452,1619
E01014535,13,47,43,84,1741,1928
E01014536,3,33,32,36,1333,1437
E01014578,17,59,44,73,1486,1679
E01014583,3,50,39,17,1331,1440
E01014585,9,51,108,57,1707,1932
E01014647,5,32,49,34,1565,1685
E01014650,9,14,45,97,1399,1564
E01014579,5,35,37,58,1269,1404
E01014580,2,28,72,33,1355,1490
E01014581,2,27,43,34,1423,1529
E01014582,6,69,23,19,1283,1400
E01014584,9,42,45,57,1240,1393
E01014518,3,11,29,27,1581,1651
E01014519,6,14,22,11,1259,1312
E01014520,6,6,30,24,1461,1527
E01014521,1,9,29,35,1258,1332
E01014607,2,11,22,30,1296,1361
E01014608,0,43,38,43,1568,1692
E01014609,0,30,51,20,1676,1777
E01014610,9,28,19,21,1346,1423
E01014613,9,35,43,23,1373,1483
E01014614,4,9,6,49,1183,1251
E01014594,2,33,43,13,1415,1506
E01014598,0,8,16,9,1432,1465
E01014599,1,2,19,13,1245,1280
E01014600,0,15,21,6,1345,1387
E01014702,4,3,16,16,1394,1433
E01014703,3,15,27,9,1366,1420
E01014704,5,32,45,37,1770,1889
E01014705,1,5,1,13,1381,1401
E01014706,10,29,26,25,1158,1248
E01014707,2,17,29,24,1519,1591
E01014708,10,31,31,38,1710,1820
E01014515,9,26,35,13,1405,1488
E01014516,2,25,37,7,1336,1407
E01014517,3,16,32,2,1156,1209
E01014522,6,17,50,21,1556,1650
E01014593,6,18,40,10,1441,1515
E01014595,7,18,42,14,1336,1417
E01014596,2,17,22,18,1525,1584
E01014597,3,26,23,17,1251,1320
E01014611,1,4,13,4,1263,1285
E01014612,1,10,13,8,1419,1451
E01014722,1,7,11,14,1459,1492
E01014723,0,3,20,6,1315,1344
E01014725,1,14,11,6,1436,1468
E01014726,8,24,35,8,1575,1650
E01014727,2,18,24,8,1487,1539
E01032514,6,23,67,21,1853,1970
E01032515,7,18,17,14,1320,1376
E01033352,9,156,91,68,929,1253
E01033353,23,132,78,98,798,1129
E01033355,7,43,62,104,859,1075
E01033358,74,703,153,141,981,2052
E01033370,24,133,68,109,791,1125
E01014564,17,406,132,297,1011,1863
E01014653,102,1236,199,412,647,2596
E01014655,71,834,132,561,767,2365
E01014654,60,920,156,521,666,2323
E01014658,73,978,125,142,859,2177
E01033356,25,557,66,101,670,1419
E01033369,61,665,81,95,526,1428
E01014568,97,560,171,533,1070,2431
E01014569,71,481,152,433,1011,2148
E01014570,18,234,129,229,1214,1824
E01014574,43,558,204,477,883,2165
E01018753,1,0,5,1,1601,1608
E01018754,0,6,18,3,1516,1543
E01018755,1,1,19,6,1463,1490
E01018756,2,0,14,3,1593,1612
E01018777,2,0,16,4,1993,2015
E01018782,2,1,20,6,1447,1476
E01018783,1,1,13,3,1518,1536
E01018784,1,0,10,6,1437,1454
E01018750,0,1,5,14,2245,2265
E01018751,0,4,8,29,1464,1505
E01018752,2,6,15,19,1974,2016
E01018779,0,0,10,6,2215,2231
E01018758,3,20,12,5,2385,2425
E01018768,1,2,16,12,1942,1973
E01018769,5,4,19,3,1820,1851
E01018778,11,2,11,0,1692,1716
E01018767,0,2,14,11,1463,1490
E01018770,0,1,7,10,1228,1246
E01018771,1,3,6,19,1271,1300
E01018772,0,0,4,5,1548,1557
E01018764,0,0,3,4,1429,1436
E01018787,0,1,8,8,1543,1560
E01018795,2,1,6,7,1194,1210
E01018796,1,4,4,1,1196,1206
E01018757,7,2,24,5,2028,2066
E01018763,0,0,5,4,1106,1115
E01018765,0,0,23,4,1452,1479
E01018785,2,2,17,3,1922,1946
E01018786,1,3,9,11,1281,1305
E01018788,0,2,10,8,1393,1413
E01018790,1,0,7,3,1169,1180
E01018794,1,1,11,1,1368,1382
E01018789,0,1,8,5,1442,1456
E01018791,3,5,11,3,1200,1222
E01018792,1,2,37,10,2732,2782
E01018793,1,2,12,14,1674,1703
E01018759,1,0,10,1,1482,1494
E01018760,0,0,5,1,1236,1242
E01018761,0,0,10,1,1478,1489
E01018766,6,1,5,4,1809,1825
E01018774,1,3,15,4,1380,1403
E01018797,1,0,9,4,1113,1127
E01018798,2,0,18,6,1458,1484
E01018799,3,0,4,13,1162,1182
E01018800,3,5,9,8,1593,1618
E01018780,2,11,23,13,2229,2278
E01018781,1,0,12,8,1818,1839
E01033294,1,4,13,9,2279,2306
E01018762,0,0,4,7,1192,1203
E01018773,0,4,2,23,1488,1517
E01018775,0,1,17,18,1400,1436
E01018776,1,2,7,22,1137,1169
E01018815,2,2,7,2,2013,2026
E01018831,0,2,11,1,1293,1307
E01018832,0,0,10,5,1312,1327
E01018847,5,3,9,4,1492,1513
E01018833,0,0,11,22,1453,1486
E01018842,0,0,6,2,1394,1402
E01018843,1,1,8,1,1281,1292
E01018844,1,3,17,22,1183,1226
E01018825,1,3,9,8,1533,1554
E01018826,5,1,8,20,2093,2127
E01018851,1,1,15,12,1354,1383
E01018852,1,1,20,7,2472,2501
E01018823,3,0,19,22,1420,1464
E01018824,9,4,35,45,2460,2553
E01018853,7,7,29,48,2408,2499
E01018854,8,1,15,7,1313,1344
E01018819,2,14,19,32,1408,1475
E01018822,0,5,6,17,1206,1234
E01018855,14,9,43,122,2194,2382
E01018856,5,2,17,22,1345,1391
E01018857,0,0,10,11,1152,1173
E01018858,8,0,21,17,1412,1458
E01018807,1,1,14,25,1262,1303
E01018808,8,0,22,18,1403,1451
E01018809,10,3,33,72,1842,1960
E01018810,0,0,10,18,1326,1354
E01018816,7,2,20,18,1636,1683
E01018817,0,2,14,19,2014,2049
E01018818,5,0,4,5,1602,1616
E01018820,3,1,13,17,1772,1806
E01018821,0,0,11,6,1210,1227
E01018845,1,1,12,13,1551,1578
E01018846,1,1,9,4,1306,1321
E01018848,2,3,9,2,1598,1614
E01018849,7,0,17,7,1832,1863
E01018850,2,1,7,0,1324,1334
E01018827,6,5,7,9,1476,1503
E01018828,2,4,7,1,1475,1489
E01018829,1,7,10,7,1328,1353
E01018830,0,6,6,1,1446,1459
E01018834,2,0,3,3,1790,1798
E01018835,4,9,23,22,1700,1758
E01018836,10,2,23,14,1531,1580
E01018837,1,4,25,9,1918,1957
E01018838,7,4,26,11,1509,1557
E01018839,4,5,16,14,1139,1178
E01018840,3,3,32,37,1561,1636
E01018841,2,1,17,11,1404,1435
E01018860,6,0,23,19,1871,1919
E01018803,1,3,20,24,1700,1748
E01018804,19,22,40,39,1758,1878
E01018805,3,3,23,16,1413,1458
E01018806,5,5,31,10,1481,1532
E01018811,0,0,10,5,1475,1490
E01018812,2,1,26,10,1335,1374
E01018813,0,0,6,9,1409,1424
E01018814,1,0,15,15,1406,1437
E01018859,2,0,13,19,1697,1731
E01018889,1,0,3,0,1330,1334
E01018890,0,1,10,8,1401,1420
E01018891,0,1,10,2,1284,1297
E01018892,1,0,10,5,1320,1336
E01018893,3,0,11,3,1336,1353
E01018908,0,0,8,5,1655,1668
E01018909,0,1,13,3,1574,1591
E01018910,4,2,17,15,1823,1861
E01018911,8,1,10,20,1645,1684
E01018912,0,1,7,2,1457,1467
E01018913,3,1,23,20,1790,1837
E01018914,1,2,14,5,1851,1873
E01018915,17,13,13,4,1990,2037
E01018916,0,1,6,4,1317,1328
E01018917,0,1,3,8,1361,1373
E01018918,3,0,12,7,1750,1772
E01018919,0,2,5,6,1335,1348
E01018894,0,2,7,4,1797,1810
E01018895,1,2,9,20,1642,1674
E01018896,0,2,11,27,1488,1528
E01018897,1,7,11,13,1384,1416
E01018898,0,2,6,5,1280,1293
E01018865,1,5,15,22,1857,1900
E01018866,0,1,8,9,1583,1601
E01018867,4,0,13,6,1912,1935
E01018868,0,4,13,50,1701,1768
E01018874,1,0,14,11,1278,1304
E01018875,0,2,18,6,1322,1348
E01018876,1,3,12,6,1367,1389
E01018877,0,0,10,4,1406,1420
E01018878,3,1,20,19,1362,1405
E01018869,3,2,17,2,1546,1570
E01018870,2,0,23,12,1256,1293
E01018871,4,1,17,10,1625,1657
E01018872,9,1,10,1,1229,1250
E01018873,3,0,13,3,1278,1297
E01018863,3,3,13,6,1627,1652
E01018864,0,3,6,8,1622,1639
E01018921,0,4,20,16,2061,2101
E01018922,0,0,8,4,2360,2372
E01018879,1,3,16,5,1728,1753
E01018880,8,0,17,5,2107,2137
E01018899,6,35,44,31,2485,2601
E01018900,0,0,18,9,1459,1486
E01018901,7,3,12,17,1629,1668
E01018882,1,2,8,11,1499,1521
E01018883,1,1,6,2,1560,1570
E01018884,0,1,17,6,1631,1655
E01018885,3,2,14,4,1463,1486
E01018886,15,15,21,6,1894,1951
E01018887,0,8,18,17,1544,1587
E01018888,0,6,23,8,1875,1912
E01018861,2,1,6,1,1424,1434
E01018862,0,3,10,3,1368,1384
E01018905,5,0,8,1,1302,1316
E01018906,0,1,10,2,1212,1225
E01018907,1,1,10,5,1209,1226
E01018881,1,1,10,3,1827,1842
E01018902,1,1,4,6,1188,1200
E01018903,7,24,22,2,1721,1776
E01018904,6,3,14,5,2063,2091
E01018920,4,0,8,4,1992,2008
E01018936,4,2,7,26,1479,1518
E01018937,2,0,10,14,1872,1898
E01018938,3,3,20,8,1641,1675
E01018959,4,1,7,8,1425,1445
E01018960,0,0,8,6,1906,1920
E01018961,0,1,20,14,1443,1478
E01018943,1,4,11,1,2104,2121
E01018951,2,6,14,6,2226,2254
E01018974,1,2,17,3,2547,2570
E01018940,4,0,3,0,1551,1558
E01018941,1,0,7,3,1543,1554
E01018942,0,4,13,9,1493,1519
E01018969,4,4,16,7,2219,2250
E01018953,0,0,7,3,1199,1209
E01018968,2,2,13,2,2496,2515
E01033291,1,2,6,6,1581,1596
E01033292,0,2,16,6,1325,1349
E01018946,1,3,18,13,1456,1491
E01018947,0,5,18,28,2937,2988
E01018948,3,3,10,17,1644,1677
E01018949,2,2,14,8,1395,1421
E01018950,1,5,27,66,1540,1639
E01018925,10,3,10,9,2121,2153
E01018952,0,2,9,4,1152,1167
E01018965,1,3,11,14,2449,2478
E01018966,1,0,6,6,1079,1092
E01018967,0,1,4,7,1355,1367
E01018924,10,0,8,4,1118,1140
E01018962,1,1,18,26,2128,2174
E01033289,9,5,11,39,2175,2239
E01018954,2,2,14,0,1218,1236
E01018955,1,6,8,3,1588,1606
E01018956,0,0,3,8,1074,1085
E01018957,0,0,6,5,1271,1282
E01018958,8,0,6,8,1330,1352
E01018970,1,3,1,6,1510,1521
E01018971,0,5,15,14,1981,2015
E01018972,0,2,1,6,1780,1789
E01018973,0,1,13,4,1378,1396
E01018923,1,0,4,2,1243,1250
E01018926,0,1,17,3,2333,2354
E01018944,0,0,10,3,1181,1194
E01018945,0,2,11,0,1278,1291
E01018932,1,4,16,13,1646,1680
E01018933,3,3,22,42,1348,1418
E01018934,5,3,6,16,1960,1990
E01018935,0,4,13,11,2231,2259
E01018927,4,3,13,9,1545,1574
E01018928,5,6,23,13,1707,1754
E01018929,2,3,10,18,1241,1274
E01018930,1,1,14,7,1580,1603
E01018931,2,1,9,1,1171,1184
E01019008,1,1,7,2,1417,1428
E01019009,2,0,20,13,1485,1520
E01019010,1,2,13,12,1344,1372
E01019011,4,1,16,8,1416,1445
E01019012,8,4,13,25,1728,1778
E01018978,1,0,5,20,1455,1481
E01018981,6,1,15,14,2010,2046
E01018982,5,2,23,7,2112,2149
E01018983,3,0,19,28,1559,1609
E01018984,1,2,18,11,2086,2118
E01018985,7,5,24,21,2267,2324
E01018986,2,0,14,1,1551,1568
E01018987,1,1,15,5,2059,2081
E01018975,0,0,17,20,1957,1994
E01018979,1,1,9,8,1371,1390
E01018980,1,1,8,11,1386,1407
E01018990,2,1,16,7,1784,1810
E01019007,1,2,17,8,2174,2202
E01018988,0,0,8,3,1526,1537
E01018989,10,0,16,0,1750,1776
E01018991,0,0,12,2,1504,1518
E01019006,2,1,8,1,1604,1616
E01018976,0,0,20,8,2116,2144
E01018977,0,0,12,1,1415,1428
E01018994,2,2,21,23,1584,1632
E01018996,1,1,20,8,1560,1590
E01018997,2,0,22,3,1444,1471
E01018995,3,0,42,28,1996,2069
E01018998,9,0,19,9,1430,1467
E01018999,4,2,21,13,1407,1447
E01019001,17,17,20,42,1589,1685
E01018992,5,1,23,8,1587,1624
E01018993,5,0,17,9,1639,1670
E01019005,7,1,20,17,2036,2081
E01019000,1,4,15,4,1379,1403
E01019002,2,0,7,7,1374,1390
E01019003,0,0,13,5,1698,1716
E01019004,9,3,15,19,1557,1603
E01019048,12,5,16,10,1785,1828
E01019049,5,1,19,6,1786,1817
E01019050,0,2,11,8,1407,1428
E01019051,2,1,16,2,1577,1598
E01019060,3,1,22,7,1626,1659
E01019061,0,2,8,1,1717,1728
E01019062,2,5,20,7,1910,1944
E01019063,1,0,12,4,1946,1963
E01019064,0,3,8,10,1910,1931
E01019065,1,1,13,10,1301,1326
E01019028,2,4,46,47,1999,2098
E01019029,3,3,23,7,1417,1453
E01019030,1,2,10,4,1765,1782
E01019031,10,1,19,13,1515,1558
E01019018,1,1,8,2,1599,1611
E01019019,7,5,10,11,1384,1417
E01019020,13,2,24,25,1377,1441
E01019021,0,1,15,5,1465,1486
E01019022,0,17,14,22,1673,1726
E01019023,2,2,6,26,1560,1596
E01019052,1,2,14,6,1785,1808
E01019053,1,1,14,16,1910,1942
E01019054,0,3,14,3,1796,1816
E01019055,0,1,10,5,1468,1484
E01019035,1,2,7,10,1499,1519
E01019036,1,3,9,4,1670,1687
E01019037,2,0,14,3,1489,1508
E01019074,8,1,17,5,1754,1785
E01019075,1,1,17,3,1709,1731
E01019076,16,1,26,16,1811,1870
E01019069,0,1,16,7,1284,1308
E01019070,0,6,10,9,1974,1999
E01019071,1,1,9,7,1562,1580
E01019072,2,1,14,2,1495,1514
E01019073,3,2,6,7,1408,1426
E01019056,2,2,16,1,1607,1628
E01019057,4,1,11,7,1895,1918
E01019058,2,1,11,6,1753,1773
E01019059,1,2,15,5,1531,1554
E01019024,1,1,6,1,1437,1446
E01019025,1,0,6,3,1431,1441
E01019026,1,2,14,5,1436,1458
E01019027,2,1,23,10,1477,1513
E01019013,0,4,17,16,2177,2214
E01019014,1,0,15,10,1369,1395
E01019015,5,2,6,2,1452,1467
E01019016,5,1,11,8,1856,1881
E01019017,11,6,18,14,2293,2342
E01019032,0,1,11,8,1462,1482
E01019034,1,1,8,11,1502,1523
E01019045,2,2,13,6,2122,2145
E01019047,0,4,23,12,1155,1194
E01019033,4,7,28,9,1355,1403
E01019041,11,3,16,9,1724,1763
E01019042,3,5,12,37,1652,1709
E01019043,3,0,12,8,1535,1558
E01019044,0,1,7,3,1476,1487
E01019046,1,1,4,6,1355,1367
E01019038,7,0,8,8,1083,1106
E01019039,2,1,6,1,1401,1411
E01019040,0,0,12,0,1208,1220
E01019066,3,3,8,1,1197,1212
E01019067,2,1,5,0,1135,1143
E01019068,0,0,0,1,1619,1620
E01019077,4,2,18,2,2177,2203
E01014790,4,4,18,19,1444,1489
E01014795,11,4,12,39,1300,1366
E01014797,2,0,21,5,1699,1727
E01032675,12,1,25,27,1290,1355
E01032676,7,3,29,27,1268,1334
E01032681,5,0,13,9,1205,1232
E01014789,1,0,10,9,1307,1327
E01014793,4,3,16,11,1478,1512
E01014794,1,2,8,14,1618,1643
E01014798,1,4,16,8,1503,1532
E01014792,1,5,17,16,1779,1818
E01014796,3,3,11,4,1674,1695
E01032677,0,2,17,19,1327,1365
E01032678,1,3,26,15,1544,1589
E01032682,2,1,11,13,1032,1059
E01014766,6,2,24,17,1303,1352
E01014767,4,2,12,9,1276,1303
E01014786,6,3,14,6,1567,1596
E01014787,3,3,21,36,1866,1929
E01014752,1,2,12,11,1489,1515
E01014754,1,5,5,14,1120,1145
E01014758,1,4,10,8,1330,1353
E01014759,0,1,1,4,1390,1396
E01014849,0,4,15,28,1503,1550
E01014850,2,3,30,28,2010,2073
E01014851,0,7,58,34,2460,2559
E01014852,5,3,16,16,1571,1611
E01032674,5,2,30,24,2422,2483
E01032680,0,5,22,4,1801,1832
E01014750,3,3,16,23,1576,1621
E01014751,0,3,15,14,1595,1627
E01014753,0,6,11,19,1774,1810
E01014755,1,2,9,9,1365,1386
E01014760,0,2,10,5,1440,1457
E01014780,0,6,13,31,1495,1545
E01014781,1,0,16,4,1584,1605
E01014782,0,2,7,15,1367,1391
E01014783,0,1,14,29,1505,1549
E01014784,0,5,14,11,1539,1569
E01014785,0,0,4,7,1375,1386
E01014775,0,3,9,6,1213,1231
E01014776,0,7,3,7,1300,1317
E01014777,4,1,14,44,1484,1547
E01014778,3,3,5,3,1284,1298
E01014779,1,0,7,16,1168,1192
E01014756,1,6,11,35,1570,1623
E01014757,0,1,4,10,1458,1473
E01014761,0,2,13,8,1591,1614
E01014762,1,0,12,11,1413,1437
E01014763,7,1,12,24,1780,1824
E01014737,5,3,12,9,1478,1507
E01014738,2,6,41,12,1404,1465
E01014739,2,7,11,19,1449,1488
E01014740,0,4,7,6,1311,1328
E01014855,1,0,10,10,1416,1437
E01014856,0,2,12,11,1515,1540
E01014857,2,2,19,9,1489,1521
E01014858,3,1,16,16,1685,1721
E01014859,7,0,13,13,1538,1571
E01014860,6,4,18,19,1436,1483
E01014847,5,4,17,18,1669,1713
E01014848,1,1,3,3,1261,1269
E01014853,1,5,24,7,1608,1645
E01014854,1,1,7,3,1336,1348
E01014764,4,0,16,12,1574,1606
E01014765,4,3,18,15,1851,1891
E01014773,1,5,20,9,1655,1690
E01014774,8,10,22,8,1642,1690
E01014821,3,2,12,12,1189,1218
E01014822,1,0,7,20,1446,1474
E01014823,0,4,9,11,1268,1292
E01014824,2,3,11,3,1438,1457
E01014825,3,0,11,1,1211,1226
E01014826,2,7,26,3,1535,1573
E01014827,3,5,8,12,1331,1359
E01014817,1,10,8,12,1489,1520
E01014820,0,2,11,11,1377,1401
E01014835,0,4,10,30,1370,1414
E01014836,4,11,6,19,1428,1468
E01014838,0,7,6,3,1380,1396
E01014840,1,14,16,27,1332,1390
E01014812,1,0,6,15,1384,1406
E01014813,1,0,16,16,1701,1734
E01014815,3,0,13,8,1316,1340
E01014816,6,1,10,10,1430,1457
E01014818,7,3,13,7,1668,1698
E01014819,1,4,7,13,1506,1531
E01014841,9,11,22,15,1613,1670
E01014842,3,17,17,14,1435,1486
E01014843,2,8,18,9,1428,1465
E01014844,7,15,15,22,1174,1233
E01014845,1,2,6,26,1186,1221
E01014846,5,7,16,7,1473,1508
E01014799,11,27,34,63,1429,1564
E01014800,10,19,25,72,1409,1535
E01014801,5,10,31,81,1422,1549
E01014802,12,20,22,57,1438,1549
E01014809,9,14,17,49,1626,1715
E01014811,4,2,17,25,1546,1594
E01014829,1,8,35,37,1745,1826
E01014830,3,12,40,46,1470,1571
E01014831,1,8,30,22,1192,1253
E01014832,1,3,25,10,1379,1418
E01014833,0,6,24,22,1414,1466
E01014804,1,9,9,26,1302,1347
E01014806,27,18,10,17,1571,1643
E01014807,1,21,31,33,1551,1637
E01014808,0,1,9,12,1404,1426
E01014744,0,0,10,6,1326,1342
E01014746,7,1,16,6,1380,1410
E01014769,2,1,17,28,2301,2349
E01014770,0,0,3,2,1349,1354
E01014771,1,2,4,12,1367,1386
E01014772,0,0,5,8,1315,1328
E01014741,2,2,8,3,1423,1438
E01014742,3,11,18,80,1453,1565
E01014745,4,2,6,0,1531,1543
E01014747,1,5,14,4,1329,1353
E01014748,0,0,11,17,1078,1106
E01014749,2,3,13,13,1325,1356
E01014803,1,10,12,41,1443,1507
E01014805,2,1,12,15,1407,1437
E01014828,3,3,24,44,1366,1440
E01014834,1,12,21,66,1293,1393
E01014839,5,17,11,25,1542,1600
E01032666,0,0,7,7,1139,1153
E01032667,4,12,5,11,1057,1089
E01032668,9,4,27,12,1444,1496
E01032672,1,7,16,16,1290,1330
E01032673,5,3,11,22,1261,1302
E01014810,1,1,14,32,1264,1312
E01032669,8,2,16,14,1429,1469
E01032670,4,9,17,21,1594,1645
E01032671,2,14,16,10,1355,1397
E01032679,5,2,15,19,1240,1281
E01015025,6,7,17,27,1519,1576
E01015097,5,4,12,18,1630,1669
E01015160,5,0,8,16,1456,1485
E01015164,16,16,31,25,1911,1999
E01015027,13,11,19,23,1557,1623
E01015159,4,1,10,4,1590,1609
E01015161,0,0,7,10,1466,1483
E01015162,1,1,7,13,1425,1447
E01015166,10,4,16,20,1821,1871
E01015023,3,9,20,18,1594,1644
E01015026,1,9,17,2,1553,1582
E01015028,0,9,21,8,1408,1446
E01015163,4,1,12,15,1419,1451
E01015165,2,5,9,55,1613,1684
E01015024,1,1,11,10,1408,1431
E01015082,0,3,16,4,1602,1625
E01015083,0,5,16,5,1446,1472
E01015084,3,2,15,3,1444,1467
E01015090,2,0,2,16,1350,1370
E01015091,6,1,6,10,1516,1539
E01015092,12,7,17,123,1411,1570
E01015093,1,1,7,34,1335,1378
E01015094,1,1,8,4,1391,1405
E01015085,1,4,10,9,1587,1611
E01015087,1,2,17,16,1558,1594
E01015088,2,9,29,5,1556,1601
E01015147,2,0,10,9,1228,1249
E01015148,1,7,14,12,1481,1515
E01015030,2,5,5,8,1546,1566
E01015070,17,31,30,74,2367,2519
E01015081,0,6,22,12,1515,1555
E01015086,0,5,11,10,1316,1342
E01015089,2,5,15,13,1637,1672
E01015029,2,31,27,37,1813,1910
E01015064,0,5,22,14,1582,1623
E01015065,16,8,26,32,1382,1464
E01015071,11,24,14,15,1460,1524
E01015076,0,4,15,5,1414,1438
E01015142,0,1,10,14,1287,1312
E01015143,1,1,10,9,1323,1344
E01015144,1,1,13,11,1503,1529
E01015146,3,11,19,19,1720,1772
E01015149,1,1,8,3,1438,1451
E01015150,0,4,12,2,1360,1378
E01015063,1,5,6,5,1423,1440
E01015068,0,6,14,16,1592,1628
E01015069,3,4,6,12,1569,1594
E01015095,4,5,11,6,1368,1394
E01015096,0,1,4,4,1434,1443
E01015074,7,0,14,13,1485,1519
E01015077,7,13,8,20,1666,1714
E01015079,0,5,13,13,1450,1481
E01015102,3,6,27,57,1594,1687
E01015104,4,7,10,12,1501,1534
E01015035,8,0,11,11,1507,1537
E01015037,2,7,9,6,1316,1340
E01015058,0,5,24,9,1433,1471
E01015066,1,3,6,4,1471,1485
E01015067,0,1,2,11,1500,1514
E01015072,2,0,14,21,1560,1597
E01015073,0,3,8,4,1435,1450
E01015078,0,8,18,15,1204,1245
E01015080,0,5,11,10,1380,1406
E01015106,3,0,9,8,1212,1232
E01015039,5,15,14,4,1254,1292
E01015040,4,23,26,10,1442,1505
E01015041,3,5,21,13,1377,1419
E01015075,0,17,5,22,1400,1444
E01015145,5,1,19,5,1789,1819
E01015120,5,1,11,7,1542,1566
E01015121,0,2,17,7,1482,1508
E01015123,0,2,11,11,1671,1695
E01015124,0,0,5,7,1586,1598
E01015125,0,6,9,6,1517,1538
E01015033,8,7,19,13,1523,1570
E01015034,11,5,29,29,1327,1401
E01015036,0,9,10,13,1449,1481
E01015038,6,12,18,24,1658,1718
E01015101,3,7,20,30,1564,1624
E01015098,3,11,23,49,1479,1565
E01015099,2,15,18,15,1426,1476
E01015100,9,9,26,57,1376,1477
E01015103,3,3,15,12,1443,1476
E01015105,5,9,25,13,1430,1482
E01015107,0,7,15,3,1527,1552
E01015110,0,10,4,6,1568,1588
E01015111,1,4,10,14,1612,1641
E01015119,1,4,16,1,1703,1725
E01015112,0,1,21,15,1460,1497
E01015113,0,0,7,6,1482,1495
E01015114,5,2,12,5,1455,1479
E01015118,1,3,9,4,1617,1634
E01015122,1,3,12,7,1569,1592
E01015042,8,15,23,20,1407,1473
E01015044,10,10,30,16,1388,1454
E01015167,7,8,18,11,1503,1547
E01015168,13,9,25,32,1731,1810
E01015171,16,13,34,22,1645,1730
E01015055,0,2,2,10,1419,1433
E01015056,1,12,13,6,1534,1566
E01015057,5,9,12,28,1439,1493
E01015059,1,6,13,15,1520,1555
E01015060,2,20,8,15,1528,1573
E01015176,1,6,17,35,1405,1464
E01015108,7,5,21,13,1906,1952
E01015109,2,3,12,9,1431,1457
E01015115,1,7,10,5,1412,1435
E01015116,0,8,14,8,1467,1497
E01015117,0,1,17,1,1431,1450
E01015031,33,26,22,37,1490,1608
E01015032,15,21,54,88,1844,2022
E01015049,12,13,28,57,1511,1621
E01015050,40,21,46,98,1650,1855
E01015051,23,63,65,94,1690,1935
E01015169,18,55,56,64,1797,1990
E01015170,12,14,23,18,1547,1614
E01015173,14,13,33,70,1603,1733
E01015174,8,9,39,35,1548,1639
E01015061,19,25,28,33,1352,1457
E01015062,15,41,62,59,1927,2104
E01015175,6,14,28,40,1575,1663
E01015177,2,18,25,21,1678,1744
E01015178,13,9,55,68,1905,2050
E01015043,10,14,21,27,1419,1491
E01015045,9,13,24,40,1383,1469
E01015046,8,25,33,28,1911,2005
E01015047,2,19,33,18,1432,1504
E01015048,7,25,28,11,1105,1176
E01015053,18,23,45,89,1321,1496
E01015054,16,34,44,84,2097,2275
E01015152,33,41,84,68,1611,1837
E01015156,9,15,34,35,1399,1492
E01032657,12,24,29,64,1396,1525
E01032658,19,13,46,72,1111,1261
E01015052,26,26,62,90,1763,1967
E01015179,16,17,44,79,1554,1710
E01015180,6,31,34,50,1639,1760
E01015181,23,55,81,73,1824,2056
E01015182,14,10,32,41,1750,1847
E01015151,31,59,69,135,1623,1917
E01015153,30,47,54,110,1521,1762
E01015155,29,26,25,68,1601,1749
E01015157,13,14,43,58,1951,2079
E01015158,39,21,73,44,1986,2163
E01015172,13,28,37,35,1685,1798
E01015126,2,0,2,3,1422,1429
E01015127,2,8,11,6,1475,1502
E01015131,0,1,5,7,1463,1476
E01015132,10,7,4,10,1476,1507
E01015133,1,1,7,4,1522,1535
E01015135,2,3,16,13,1511,1545
E01015136,1,7,12,4,1493,1517
E01015137,1,5,13,9,1544,1572
E01015138,3,2,10,12,1491,1518
E01015139,1,1,14,4,1434,1454
E01015141,0,7,11,6,1796,1820
E01015128,0,1,6,4,1623,1634
E01015129,1,8,12,1,1459,1481
E01015130,0,14,18,8,1674,1714
E01015134,0,5,12,4,1517,1538
E01015140,8,12,11,7,1478,1516
E01015431,3,3,26,27,1428,1487
E01015432,0,0,12,14,1617,1643
E01015433,3,1,3,8,1465,1480
E01015434,1,2,16,9,1603,1631
E01015379,1,15,36,12,1397,1461
E01015435,4,6,16,21,1476,1523
E01015436,1,4,26,10,1307,1348
E01015437,3,7,11,14,1245,1280
E01015395,0,3,19,35,1270,1327
E01015396,3,1,21,22,1493,1540
E01015397,1,5,17,35,1438,1496
E01015398,0,1,16,28,1345,1390
E01015399,0,0,5,9,1495,1509
E01015400,0,0,8,13,1497,1518
E01015401,2,1,3,15,1502,1523
E01015412,1,0,10,18,1278,1307
E01015413,4,2,15,21,1415,1457
E01015414,1,3,15,36,1399,1454
E01015415,3,8,21,12,1218,1262
E01015416,6,13,14,32,1270,1335
E01015407,1,3,8,37,1429,1478
E01015408,3,1,13,5,1383,1405
E01015409,7,2,18,26,1454,1507
E01015410,6,7,13,8,1481,1515
E01015411,2,3,22,21,1311,1359
E01015417,2,3,19,16,1420,1460
E01015418,0,0,11,8,1503,1522
E01015419,1,1,6,11,1737,1756
E01015420,0,8,11,13,1528,1560
E01015421,7,4,4,26,1394,1435
E01015422,2,1,16,12,1416,1447
E01015380,8,4,13,13,1678,1716
E01015381,3,7,20,19,1580,1629
E01015382,3,23,40,52,1741,1859
E01015383,2,2,14,26,1375,1419
E01015384,6,5,41,45,1511,1608
E01015385,7,11,25,24,1664,1731
E01015438,3,9,29,31,1457,1529
E01015439,4,8,21,73,1617,1723
E01015441,1,7,30,58,1776,1872
E01015442,1,4,26,23,1869,1923
E01015443,7,9,22,38,1715,1791
E01015444,5,6,17,32,1675,1735
E01015386,11,15,41,89,1510,1666
E01015387,6,5,12,40,1406,1469
E01015388,5,17,42,149,1384,1597
E01015389,12,5,24,39,1394,1474
E01015390,6,4,25,76,1577,1688
E01015391,7,5,21,27,1395,1455
E01015392,9,3,16,27,1366,1421
E01015393,1,4,32,26,1197,1260
E01015394,10,8,40,38,1495,1591
E01015440,3,10,23,53,1853,1942
E01015447,8,2,9,20,1587,1626
E01015449,5,10,18,24,1633,1690
E01015456,1,7,26,19,1731,1784
E01015457,6,4,15,37,1586,1648
E01015445,4,2,19,68,1834,1927
E01015446,1,6,20,70,1486,1583
E01015448,3,1,9,29,1483,1525
E01015450,1,6,10,22,1699,1738
E01015451,1,1,15,31,1417,1465
E01015458,4,5,26,12,1448,1495
E01015460,6,24,44,79,1593,1746
E01015461,10,8,39,53,1482,1592
E01015462,8,6,29,28,1521,1592
E01015463,1,4,28,45,1479,1557
E01015464,15,3,9,19,1568,1614
E01015427,6,8,23,24,1625,1686
E01015428,1,10,16,22,2115,2164
E01015429,3,1,24,15,1659,1702
E01015430,0,5,16,13,1513,1547
E01015465,18,6,33,87,1606,1750
E01015466,1,9,27,112,1565,1714
E01015468,7,23,35,132,1762,1959
E01032659,3,4,32,60,1070,1169
E01032660,10,14,46,117,1482,1669
E01032661,6,3,13,49,1234,1305
E01032662,0,2,24,39,1052,1117
E01015423,9,6,30,50,1915,2010
E01015424,3,0,4,13,1349,1369
E01015425,0,1,7,8,1276,1292
E01015426,5,5,12,13,1336,1371
E01015452,2,3,17,16,1762,1800
E01015453,6,2,30,38,1764,1840
E01015454,8,12,33,54,1722,1829
E01015455,6,3,24,16,1829,1878
E01015459,1,1,10,34,1713,1759
E01015402,14,5,26,62,1549,1656
E01015403,10,5,16,33,1688,1752
E01015404,10,7,12,56,1575,1660
E01015405,12,7,23,32,1737,1811
E01015406,7,10,42,53,1629,1741
E01014985,1,4,22,14,1342,1383
E01014986,1,2,14,29,1545,1591
E01014987,2,2,11,24,1225,1264
E01014988,0,1,2,6,1394,1403
E01014989,3,12,17,11,1234,1277
E01014990,1,2,9,11,1461,1484
E01014991,5,5,44,20,2090,2164
E01014992,0,4,10,22,1447,1483
E01014993,0,4,14,8,1416,1442
E01014884,5,63,26,36,1918,2048
E01014885,1,2,8,16,1841,1868
E01014929,8,4,12,10,1987,2021
E01014930,8,6,9,4,1951,1978
E01014863,4,5,6,9,1472,1496
E01014864,4,4,16,6,1427,1457
E01014962,2,2,8,16,1720,1748
E01014963,4,1,21,7,1847,1880
E01014861,1,20,15,36,1792,1864
E01014862,12,12,40,32,2745,2841
E01014953,16,2,18,37,2035,2108
E01014954,4,3,16,6,1510,1539
E01015014,1,0,14,16,1435,1466
E01015015,4,7,23,20,1415,1469
E01015016,0,6,8,7,1196,1217
E01015017,3,3,12,43,1386,1447
E01015018,0,8,7,39,1470,1524
E01015019,4,14,22,36,1700,1776
E01015020,1,2,29,14,1510,1556
E01015021,1,9,14,12,1535,1571
E01015022,2,2,14,19,1513,1550
E01014886,1,4,28,25,1745,1803
E01014887,0,0,6,7,1384,1397
E01014888,3,1,9,8,1432,1453
E01014889,0,1,1,20,1545,1567
E01014872,10,24,21,104,1434,1593
E01014874,7,30,24,83,1354,1498
E01014876,27,39,31,134,1485,1716
E01014877,17,12,52,125,1357,1563
E01014879,9,6,29,125,1543,1712
E01014881,11,16,57,176,1696,1956
E01015009,0,4,11,14,1355,1384
E01015010,7,5,10,17,1283,1322
E01015011,0,3,19,16,1518,1556
E01015012,1,0,3,9,1201,1214
E01015013,1,5,18,15,1310,1349
E01014946,1,17,12,20,1524,1574
E01014947,3,10,7,30,1372,1422
E01014948,6,32,32,48,1575,1693
E01014949,1,28,43,33,1315,1420
E01014950,6,7,20,51,1344,1428
E01014951,3,30,37,35,1217,1322
E01014952,18,18,22,53,1541,1652
E01014873,7,14,36,40,1410,1507
E01014875,39,33,39,318,1363,1792
E01014878,22,34,48,156,1853,2113
E01014880,24,25,36,148,1600,1833
E01014882,9,23,61,204,1787,2084
E01014883,7,13,18,56,1138,1232
E01014911,0,4,16,23,1343,1386
E01014912,0,2,18,10,1805,1835
E01014913,0,0,11,3,1608,1622
E01014914,0,12,22,14,1629,1677
E01014892,0,9,24,35,1592,1660
E01014893,1,3,13,21,1456,1494
E01014894,2,9,9,9,1279,1308
E01014895,0,0,12,18,1392,1422
E01014896,1,4,9,14,1304,1332
E01014979,7,8,29,45,1426,1515
E01014980,8,10,29,37,1537,1621
E01014982,9,22,22,17,1449,1519
E01014983,4,15,22,39,1438,1518
E01014984,4,14,15,33,1415,1481
E01014998,0,5,13,24,1511,1553
E01014999,13,5,16,12,1548,1594
E01015000,2,6,20,41,1473,1542
E01015001,0,5,35,17,1552,1609
E01014978,5,21,23,80,1401,1530
E01014981,9,55,72,194,2544,2874
E01014996,33,24,31,65,1476,1629
E01033331,20,57,71,190,1892,2230
E01033333,24,40,63,140,1977,2244
E01014904,7,36,34,83,1327,1487
E01014905,6,24,47,134,1428,1639
E01014906,3,43,41,148,1437,1672
E01014907,2,38,41,148,1301,1530
E01014908,14,17,33,59,1197,1320
E01014909,10,73,44,148,1213,1488
E01014910,6,29,25,131,1280,1471
E01014867,6,19,25,10,1292,1352
E01014868,0,10,17,16,1509,1552
E01014994,5,4,21,16,1687,1733
E01014995,3,0,18,15,1630,1666
E01033338,21,22,21,37,1474,1575
E01033339,7,4,23,21,1374,1429
E01014901,15,20,26,44,1580,1685
E01014902,13,2,13,41,1250,1319
E01014903,0,8,10,37,1432,1487
E01014965,0,10,17,40,1427,1494
E01014964,15,13,10,63,1610,1711
E01014966,5,35,33,63,1440,1576
E01014967,20,9,28,59,2001,2117
E01014969,9,9,22,29,1530,1599
E01033334,1,16,34,72,1486,1609
E01033336,16,9,16,40,1676,1757
E01014897,7,20,16,14,1441,1498
E01014898,6,10,14,33,1605,1668
E01014899,12,25,20,62,1516,1635
E01014900,13,35,17,55,1373,1493
E01014959,12,8,31,17,1319,1387
E01014960,13,8,15,33,1562,1631
E01014961,5,10,42,31,1563,1651
E01014968,8,2,25,25,1652,1712
E01014865,0,1,33,12,1842,1888
E01014869,9,2,21,7,1677,1716
E01014870,1,2,3,11,1589,1606
E01014871,0,4,7,12,1197,1220
E01014890,5,2,12,8,2045,2072
E01014891,3,1,9,11,1641,1665
E01014955,3,8,20,12,1261,1304
E01014956,0,14,13,12,1540,1579
E01014957,6,10,8,11,1220,1255
E01014974,2,24,16,16,1517,1575
E01014977,8,21,23,49,1174,1275
E01014922,2,18,26,26,1311,1383
E01014923,0,36,18,27,1442,1523
E01014924,12,22,38,68,1625,1765
E01014973,2,25,20,16,1401,1464
E01014975,2,43,33,40,1456,1574
E01014976,3,25,42,20,1360,1450
E01014925,5,15,14,13,1447,1494
E01014926,1,22,41,23,1598,1685
E01014927,1,34,29,16,1597,1677
E01014928,3,15,26,11,1471,1526
E01014958,5,17,26,16,1111,1175
E01014915,0,20,39,42,1468,1569
E01015003,0,10,19,29,1563,1621
E01015005,6,38,40,53,1863,2000
E01015007,2,33,32,37,1589,1693
E01015008,4,23,24,22,1626,1699
E01014943,2,8,21,14,1677,1722
E01014944,2,8,17,15,1818,1860
E01014972,2,5,19,10,1716,1752
E01015002,1,11,28,31,1505,1576
E01015004,1,17,21,7,1672,1718
E01015006,3,8,12,39,1509,1571
E01014936,4,5,17,10,1438,1474
E01014938,1,9,23,3,1512,1548
E01014939,1,2,14,6,1168,1191
E01014940,0,9,7,11,1304,1331
E01014941,1,11,18,21,1565,1616
E01014942,4,4,32,14,1431,1485
E01014945,0,23,20,17,1639,1699
E01014916,1,3,39,13,1452,1508
E01014917,1,12,32,16,1395,1456
E01014918,0,6,9,25,1393,1433
E01014919,1,9,16,13,1232,1271
E01014920,0,11,15,29,1283,1338
E01014921,5,5,15,11,1351,1387
E01014866,0,4,6,23,1588,1621
E01014931,4,3,2,11,1403,1423
E01014932,0,8,24,10,1599,1641
E01014933,4,2,6,7,1441,1460
E01014934,4,2,7,4,1220,1237
E01014935,1,5,19,16,1465,1506
E01014937,0,0,11,3,1268,1282
E01015519,0,4,20,15,1432,1471
E01015520,1,1,22,40,1142,1206
E01015521,7,4,7,17,1397,1432
E01015522,4,3,19,22,1393,1441
E01015523,5,0,17,17,1471,1510
E01015524,3,4,17,29,1146,1199
E01015543,5,7,19,20,1311,1362
E01015544,7,21,33,19,1586,1666
E01015545,9,12,43,34,1500,1598
E01015546,7,25,55,11,1604,1702
E01015513,2,7,31,82,1433,1555
E01015514,0,7,11,19,1229,1266
E01015515,0,8,10,34,1379,1431
E01015516,0,10,21,23,1249,1303
E01015517,7,6,12,18,1395,1438
E01015555,1,7,16,27,1415,1466
E01015556,4,6,17,17,1556,1600
E01015557,0,8,3,26,1358,1395
E01015558,0,13,31,45,1454,1543
E01015559,11,10,12,55,1384,1472
E01015560,0,15,26,21,1557,1619
E01015526,7,16,18,14,1425,1480
E01015528,4,33,43,35,1702,1817
E01015529,0,11,20,38,1472,1541
E01015530,3,12,28,41,1593,1677
E01015506,3,19,32,56,1441,1551
E01015507,2,35,48,24,1504,1613
E01015527,3,24,54,35,1635,1751
E01015580,2,6,17,52,1583,1660
E01015473,4,11,24,30,1647,1716
E01015474,1,1,15,11,1616,1644
E01015547,2,4,12,50,1681,1749
E01015548,3,2,10,44,1518,1577
E01015549,7,14,11,53,1680,1765
E01015550,2,16,28,82,1674,1802
E01015551,5,11,16,45,1457,1534
E01015552,1,24,29,74,1978,2106
E01015553,3,24,22,50,1532,1631
E01015554,0,3,5,31,1397,1436
E01015508,5,24,39,85,1247,1400
E01015509,12,34,36,113,1425,1620
E01015510,22,36,51,250,1515,1874
E01015511,19,22,39,174,1302,1556
E01015562,5,21,32,68,1411,1537
E01015563,9,14,28,104,1414,1569
E01015565,2,21,41,94,1449,1607
E01015566,9,20,29,109,1426,1593
E01015578,3,20,31,101,1451,1606
E01015579,4,9,15,96,1461,1585
E01015581,1,9,21,52,1433,1516
E01015582,13,16,37,194,1614,1874
E01032708,15,59,61,104,1403,1642
E01032716,6,16,34,141,1252,1449
E01015481,3,33,39,80,1589,1744
E01015482,1,5,7,45,1220,1278
E01015483,7,7,17,30,1377,1438
E01015484,1,31,24,46,1301,1403
E01015485,6,13,8,29,1384,1440
E01015486,5,20,20,72,1322,1439
E01015561,9,17,43,109,1288,1466
E01015564,10,23,28,104,1401,1566
E01015567,3,28,15,137,1309,1492
E01015568,3,39,28,63,1299,1432
E01015475,12,66,54,1192,858,2182
E01015476,21,50,79,438,1663,2251
E01015477,16,37,62,139,1294,1548
E01015480,27,111,89,1341,803,2371
E01015538,6,28,38,144,1551,1767
E01015572,1,24,47,69,1109,1250
E01015573,10,75,89,207,1757,2138
E01015575,2,33,46,129,974,1184
E01015479,19,57,38,249,1255,1618
E01015493,9,38,31,502,1193,1773
E01015574,3,24,25,172,1416,1640
E01015576,20,5,22,118,1394,1559
E01015499,5,19,30,60,1156,1270
E01015500,3,18,61,66,1375,1523
E01015504,7,14,31,87,1233,1372
E01015505,9,31,36,76,1344,1496
E01015494,13,69,43,251,1407,1783
E01015496,12,34,49,134,1385,1614
E01015497,5,19,32,101,1435,1592
E01032714,6,17,55,299,909,1286
E01032715,3,23,30,52,890,998
E01015537,1,46,83,86,1557,1773
E01015539,4,33,39,117,1427,1620
E01015540,6,50,31,202,1570,1859
E01015541,23,25,46,240,1457,1791
E01015542,8,25,28,104,1306,1471
E01015478,1,16,43,81,1342,1483
E01015498,12,17,44,74,1585,1732
E01015532,6,6,45,48,1451,1556
E01032706,8,22,63,96,1309,1498
E01032707,7,15,32,114,1708,1876
E01015501,9,26,29,88,1217,1369
E01015502,9,13,51,85,1387,1545
E01015503,12,23,39,61,1179,1314
E01015569,10,12,43,57,1388,1510
E01015570,15,46,51,92,1327,1531
E01015571,6,52,39,127,1366,1590
E01015487,6,22,33,118,1436,1615
E01015488,3,26,18,67,1325,1439
E01015489,3,13,23,175,1224,1438
E01015490,1,12,34,73,1165,1285
E01015491,7,38,20,64,1344,1473
E01015492,5,23,16,98,1292,1434
E01015533,0,9,10,43,1442,1504
E01015534,7,14,32,101,1750,1904
E01015535,4,21,22,76,1371,1494
E01015536,2,25,28,121,2224,2400
E01015583,0,9,34,43,2196,2282
E01015584,1,1,8,11,1396,1417
E01015585,4,13,35,33,1557,1642
E01015586,1,4,10,8,1414,1437
E01015587,9,6,18,36,1828,1897
E01015588,5,9,12,22,1789,1837
E01015525,6,12,37,36,1487,1578
E01032700,9,19,21,44,1519,1612
E01032703,1,12,29,50,1376,1468
E01032705,11,19,40,25,1384,1479
E01032709,5,27,29,46,1251,1358
E01032713,17,31,49,62,1603,1762
E01032701,6,42,30,56,1085,1219
E01032702,1,43,25,84,1260,1413
E01032704,6,12,44,54,1303,1419
E01032711,7,47,38,57,1181,1330
E01032712,6,28,26,57,1291,1408
E01015471,4,29,23,98,1501,1655
E01015472,17,36,66,112,2523,2754
E01015512,5,23,50,82,1555,1715
E01015518,2,21,48,94,1396,1561
E01032710,1,15,28,65,1234,1343
E01015262,1,1,10,13,1327,1352
E01015263,1,4,22,19,1492,1538
E01015264,1,0,6,3,1313,1323
E01015265,1,2,14,7,1447,1471
E01015266,0,3,22,10,1459,1494
E01015236,1,4,6,16,1457,1484
E01015237,0,3,18,18,1319,1358
E01015238,1,2,22,27,1399,1451
E01015239,4,2,16,32,1475,1529
E01015249,5,4,27,28,1414,1478
E01015250,0,4,11,12,1411,1438
E01015251,2,1,11,39,1147,1200
E01015252,4,15,31,42,2291,2383
E01015253,6,4,41,51,1525,1627
E01015254,8,1,13,37,1340,1399
E01015257,5,2,8,15,1324,1354
E01015258,5,8,35,32,1849,1929
E01015259,2,0,13,12,1369,1396
E01015260,4,5,25,19,1491,1544
E01015240,9,4,17,14,1419,1463
E01015241,0,2,26,19,1432,1479
E01015242,0,4,10,23,1201,1238
E01015243,2,2,10,22,1224,1260
E01015214,3,4,18,19,1363,1407
E01015215,1,0,20,6,1431,1458
E01015216,3,2,22,22,1380,1429
E01015218,2,1,17,4,1429,1453
E01015217,5,7,36,14,1466,1528
E01015255,6,7,34,32,1540,1619
E01015256,12,2,43,36,1700,1793
E01015261,3,3,30,27,1894,1957
E01015267,7,3,23,11,1483,1527
E01015268,5,7,30,18,1510,1570
E01015269,5,10,14,14,1588,1631
E01015270,12,17,29,36,1533,1627
E01015271,2,3,10,4,1403,1422
E01015224,8,3,8,5,1469,1493
E01015225,3,1,12,19,1432,1467
E01015226,0,2,11,12,1386,1411
E01015227,2,3,10,6,1514,1535
E01015228,1,2,7,11,1484,1505
E01015230,0,1,7,10,1397,1415
E01015202,1,2,13,11,1486,1513
E01015203,1,4,2,3,1262,1272
E01015204,1,1,17,11,1345,1375
E01015205,1,0,19,5,1464,1489
E01015206,1,2,12,19,1450,1484
E01015190,0,3,18,4,1641,1666
E01015191,1,7,19,5,1630,1662
E01015192,2,1,24,5,1418,1450
E01015193,4,2,5,5,1267,1283
E01015194,10,0,28,7,1355,1400
E01015195,1,3,14,10,1480,1508
E01015196,5,2,18,6,1477,1508
E01015229,3,1,13,16,1335,1368
E01015231,3,2,33,46,1509,1593
E01015232,1,1,14,20,1615,1651
E01015233,2,9,17,24,1347,1399
E01015234,4,7,12,15,1280,1318
E01015235,2,4,14,7,1662,1689
E01015219,1,6,12,14,1360,1393
E01015220,1,3,19,0,1347,1370
E01015221,0,0,13,7,1410,1430
E01015222,1,1,15,6,1390,1413
E01015223,0,1,8,14,1281,1304
E01015197,6,1,6,7,1419,1439
E01015198,2,0,3,11,1551,1567
E01015199,0,1,5,2,1291,1299
E01015200,0,0,10,4,1002,1016
E01015201,5,2,13,1,1315,1336
E01015183,0,0,7,4,1309,1320
E01015184,0,1,8,4,1298,1311
E01015185,1,2,7,5,1310,1325
E01015186,0,1,16,24,1298,1339
E01015187,2,0,1,7,1374,1384
E01015188,2,2,16,3,1459,1482
E01015189,0,0,8,4,1158,1170
E01015244,1,1,13,2,1446,1463
E01015245,0,2,10,4,1296,1312
E01015246,0,1,10,4,1425,1440
E01015247,0,0,13,3,1691,1707
E01015248,1,1,14,5,1419,1440
E01015207,6,7,11,8,1545,1577
E01015208,10,3,20,38,1781,1852
E01015209,2,7,18,20,1348,1395
E01015210,8,2,17,64,1416,1507
E01015211,1,0,9,7,1461,1478
E01015212,0,0,16,20,1358,1394
E01015213,1,0,15,26,1391,1433
E01031841,1,1,13,19,1799,1833
E01031868,0,0,16,42,1719,1777
E01031873,4,2,20,15,1828,1869
E01031874,4,1,10,14,1500,1529
E01031884,2,7,8,21,1589,1627
E01031861,2,3,20,30,2354,2409
E01031862,1,9,18,12,1514,1554
E01031863,11,1,11,21,1127,1171
E01031864,2,2,18,46,1261,1329
E01031865,2,5,32,38,1855,1932
E01031866,8,1,7,8,1543,1567
E01031869,1,0,9,18,1831,1859
E01031870,0,1,15,19,1740,1775
E01031871,1,2,15,11,1630,1659
E01031850,1,1,18,14,1860,1894
E01031851,3,4,20,18,1473,1518
E01031852,0,9,12,52,1968,2041
E01032688,0,4,20,7,1300,1331
E01032689,0,3,11,26,1310,1350
E01032692,2,4,10,16,1206,1238
E01032693,3,3,25,20,1320,1371
E01031853,1,17,22,19,1361,1420
E01031854,5,16,23,27,1696,1767
E01031855,0,5,5,12,1489,1511
E01031856,5,3,19,8,1529,1564
E01031845,3,1,15,8,1550,1577
E01031846,2,3,17,3,1626,1651
E01031848,4,24,37,17,2060,2142
E01031872,0,8,20,3,1591,1622
E01031876,1,3,8,2,1488,1502
E01031843,2,3,23,3,1751,1782
E01031847,0,5,20,9,1738,1772
E01031849,0,1,17,54,1607,1679
E01031877,3,1,11,7,1814,1836
E01031844,3,1,21,10,1891,1926
E01031857,0,0,16,13,1602,1631
E01031858,2,5,40,80,1957,2084
E01031883,0,0,9,3,1763,1775
E01031842,0,1,8,4,1896,1909
E01031867,0,5,8,7,1808,1828
E01031882,1,3,14,10,2003,2031
E01031859,4,18,27,24,1670,1743
E01031860,7,7,16,4,1476,1510
E01031878,8,69,43,50,2451,2621
E01031879,36,227,76,131,1650,2120
E01031880,23,130,67,60,3622,3902
E01032697,19,77,48,61,1276,1481
E01032698,8,60,25,14,1564,1671
E01031887,1,3,16,10,1732,1762
E01031934,3,5,8,17,1718,1751
E01031935,2,6,30,28,1687,1753
E01031936,0,2,8,14,1454,1478
E01031885,1,2,14,7,1563,1587
E01031947,4,7,18,28,1600,1657
E01031948,3,9,25,44,2024,2105
E01031949,2,3,21,23,1759,1808
E01031954,1,2,22,21,1301,1347
E01031955,3,2,16,17,1585,1623
E01031956,2,6,25,6,1262,1301
E01031962,5,0,11,41,1273,1330
E01031886,0,0,5,4,1405,1414
E01031892,0,0,8,5,1377,1390
E01031893,0,1,18,9,1548,1576
E01031894,0,1,17,10,1489,1517
E01031957,1,2,8,8,1458,1477
E01031958,5,6,10,4,1350,1375
E01031959,2,5,10,6,1592,1615
E01031960,10,122,23,115,1118,1388
E01031963,9,9,23,48,1742,1831
E01031964,1,6,27,37,1616,1687
E01031967,2,7,21,30,1848,1908
E01031969,0,5,14,14,1405,1438
E01031944,2,4,13,2,1043,1064
E01031946,7,50,36,73,1924,2090
E01031961,3,5,21,13,1267,1309
E01031965,1,14,22,12,1336,1385
E01031966,2,7,18,11,1499,1537
E01031968,13,9,19,17,1541,1599
E01032699,3,49,32,106,2116,2306
E01031939,1,12,29,25,2104,2171
E01031940,1,3,18,14,2199,2235
E01031950,1,3,15,3,1375,1397
E01031951,1,20,21,93,1296,1431
E01031907,6,10,30,59,2419,2524
E01031910,3,17,34,43,1356,1453
E01031914,1,22,46,14,1242,1325
E01031915,1,4,28,38,1312,1383
E01031919,0,13,23,28,1530,1594
E01031920,2,5,14,14,1227,1262
E01031905,2,8,20,27,1408,1465
E01031906,0,12,20,26,1409,1467
E01031908,1,12,43,18,1554,1628
E01031909,0,9,10,11,1246,1276
E01031925,1,16,17,21,1125,1180
E01031926,2,15,14,40,1436,1507
E01031927,0,11,18,23,1254,1306
E01031911,0,9,26,28,1306,1369
E01031912,1,23,44,52,1246,1366
E01031913,4,8,21,22,1342,1397
E01031917,6,17,31,35,1327,1416
E01031918,4,3,31,55,2367,2460
E01031928,1,14,23,19,1288,1345
E01031891,2,4,23,6,2266,2301
E01031904,1,3,15,18,2117,2154
E01031937,2,2,7,11,1109,1131
E01031938,1,0,8,5,1402,1416
E01031916,1,14,21,11,1252,1299
E01031921,3,12,21,17,1415,1468
E01031922,3,4,24,16,1226,1273
E01031923,1,8,15,13,1337,1374
E01031924,2,3,18,25,1615,1663
E01031895,7,9,8,3,1567,1594
E01031896,0,4,17,7,1156,1184
E01031897,0,10,30,23,2146,2209
E01031898,1,22,28,40,1717,1808
E01032690,6,4,12,21,1751,1794
E01032691,2,18,32,26,1459,1537
E01031900,3,1,12,18,2175,2209
E01031901,1,1,15,6,1435,1458
E01031902,5,1,12,7,1132,1157
E01031903,11,1,17,10,2285,2324
E01031888,0,2,4,2,1325,1333
E01031889,6,15,33,16,1789,1859
E01031890,3,4,22,8,1447,1484
E01031929,0,1,21,3,1293,1318
E01031930,8,15,22,24,1585,1654
E01031931,0,9,13,25,1594,1641
E01031932,0,1,4,10,1432,1447
E01031933,0,4,25,18,1539,1586
E01031941,1,1,16,6,1574,1598
E01031942,6,2,18,8,1397,1431
E01031952,3,5,27,35,2353,2423
E01031953,1,2,36,25,2822,2886
E01031988,30,183,40,77,1258,1588
E01031998,15,186,53,43,2727,3024
E01032026,7,6,3,4,1581,1601
E01032696,9,56,37,30,2848,2980
E01031989,0,25,8,10,1519,1562
E01031996,5,13,32,12,1335,1397
E01031997,4,18,13,6,1393,1434
E01031999,1,1,13,8,1501,1524
E01031974,4,12,8,17,1223,1264
E01031975,0,8,9,11,1232,1260
E01031976,0,8,14,25,1373,1420
E01031977,4,15,53,41,2831,2944
E01031978,0,14,26,16,1697,1753
E01031979,3,19,15,54,1992,2083
E01032013,4,7,16,23,2049,2099
E01032032,0,8,9,10,1574,1601
E01032033,3,2,11,5,1403,1424
E01032034,2,7,11,15,1367,1402
E01032010,0,2,7,12,2069,2090
E01032035,0,2,5,12,1516,1535
E01032036,0,1,3,2,1459,1465
E01032037,0,1,5,7,1457,1470
E01031984,1,3,10,40,1546,1600
E01031985,2,0,16,37,1254,1309
E01031986,6,0,22,28,1192,1248
E01032017,1,4,18,14,1451,1488
E01031980,1,1,22,27,1487,1538
E01031981,1,7,28,18,1582,1636
E01031982,0,1,19,45,1383,1448
E01031983,6,13,23,20,1685,1747
E01032018,3,6,17,9,1573,1608
E01032019,3,9,25,30,1462,1529
E01032020,3,6,13,19,1454,1495
E01032025,0,9,9,11,1443,1472
E01031990,1,7,18,2,1937,1965
E01032004,1,0,12,9,2247,2269
E01032027,2,6,13,5,1307,1333
E01032038,0,1,2,5,1313,1321
E01032039,1,3,12,13,1334,1363
E01032040,0,2,7,5,1445,1459
E01032001,6,1,17,1,1490,1515
E01032002,6,3,14,42,1330,1395
E01032003,4,14,18,68,1354,1458
E01032024,10,15,34,62,2223,2344
E01032014,2,9,13,79,1618,1721
E01032015,4,9,15,39,1376,1443
E01032016,4,10,25,29,1299,1367
E01032021,0,7,19,76,1504,1606
E01032000,3,5,15,91,2200,2314
E01032011,2,18,30,64,2418,2532
E01032012,1,10,8,21,1766,1806
E01032008,1,8,8,20,1476,1513
E01032009,1,9,7,40,1762,1819
E01032022,8,9,21,62,1571,1671
E01032005,2,10,7,39,1248,1306
E01032006,0,2,8,24,1220,1254
E01032007,3,0,15,67,1263,1348
E01032023,0,19,33,91,1661,1804
E01031970,9,2,9,8,1547,1575
E01031971,6,3,15,4,1154,1182
E01031972,1,2,19,4,1478,1504
E01032041,0,2,13,6,1904,1925
E01032042,0,2,16,8,1697,1723
E01031991,2,1,14,24,2080,2121
E01032029,2,3,9,10,1349,1373
E01032030,1,2,6,13,1528,1550
E01032031,1,2,6,3,1063,1075
E01031973,1,1,26,17,1830,1875
E01031992,2,1,22,8,1450,1483
E01031993,2,3,11,15,1425,1456
E01031994,7,2,6,9,1337,1361
E01031995,6,3,18,3,1587,1617
E01032063,6,21,18,12,1853,1910
E01032064,3,19,19,7,1287,1335
E01032065,2,5,16,19,1527,1569
E01032073,1,22,25,23,1351,1422
E01032074,0,7,2,5,1094,1108
E01032043,3,5,19,26,1268,1321
E01032044,1,2,15,3,1353,1374
E01032057,2,0,5,3,1183,1193
E01032070,1,9,20,4,1476,1510
E01032071,5,3,15,18,2270,2311
E01032072,2,19,26,23,1965,2035
E01032062,6,15,39,27,1548,1635
E01032066,2,5,16,19,1472,1514
E01032067,0,7,29,28,1467,1531
E01032068,1,15,13,19,1339,1387
E01032069,0,0,8,13,1245,1266
E01032058,3,2,23,10,1377,1415
E01032059,1,3,26,12,1771,1813
E01032060,0,1,15,9,1521,1546
E01032061,1,1,29,7,1124,1162
E01032045,2,2,18,9,1445,1476
E01032046,0,5,21,4,1519,1549
E01032047,0,3,12,5,1362,1382
E01032048,11,13,27,5,1642,1698
E01032049,2,2,16,3,1527,1550
E01032050,3,4,23,17,1700,1747
E01032077,5,2,19,14,1638,1678
E01032078,21,27,45,9,2770,2872
E01032079,8,1,22,5,1460,1496
E01032080,5,13,28,8,1665,1719
E01032085,8,15,37,35,1557,1652
E01032086,19,38,78,67,2199,2401
E01032087,19,35,42,24,1993,2113
E01032099,15,23,42,38,2841,2959
E01032100,14,21,18,18,1436,1507
E01032101,7,18,27,34,1584,1670
E01032102,14,15,22,17,1495,1563
E01032096,12,17,51,16,1780,1876
E01032097,1,7,19,10,1820,1857
E01032098,8,7,11,28,1694,1748
E01032092,10,18,18,7,1349,1402
E01032093,29,35,67,12,1717,1860
E01032094,47,32,55,74,2121,2329
E01032095,22,6,33,28,1609,1698
E01032088,2,8,10,26,1478,1524
E01032089,9,25,36,18,1390,1478
E01032090,9,14,21,9,1382,1435
E01032091,1,16,22,12,1181,1232
E01032053,3,7,13,4,1397,1424
E01032083,8,7,29,3,2227,2274
E01032084,3,8,29,12,2517,2569
E01032052,2,2,4,5,1261,1274
E01032054,0,5,14,16,1250,1285
E01032055,3,0,7,1,1224,1235
E01032056,1,2,15,6,1333,1357
E01032121,5,2,11,8,1539,1565
E01032115,2,4,16,28,1699,1749
E01032116,1,5,22,16,2538,2582
E01032117,5,5,23,25,2599,2657
E01032118,0,6,18,7,1520,1551
E01032119,2,9,28,15,1812,1866
E01032694,1,2,14,12,1619,1648
E01032695,1,3,13,4,1416,1437
E01032104,6,12,27,23,1281,1349
E01032105,0,2,9,18,1429,1458
E01032107,18,74,26,54,1382,1554
E01032108,1,12,23,3,1297,1336
E01032110,3,8,5,25,1563,1604
E01032111,1,9,15,5,1242,1272
E01032112,3,3,15,17,1441,1479
E01032113,4,0,12,7,1350,1373
E01032103,2,19,19,44,1596,1680
E01032106,0,4,15,18,1360,1397
E01032109,1,1,8,10,1452,1472
E01032114,1,6,14,45,1450,1516
E01032051,0,1,4,4,1315,1324
E01032075,2,9,10,2,1319,1342
E01032076,2,5,8,2,1204,1221
E01032081,0,1,11,7,1207,1226
E01032082,0,0,5,8,1212,1225
E01019902,1,1,15,1,1982,2000
E01019938,3,0,10,4,2184,2201
E01019967,2,0,3,3,1283,1291
E01019927,2,3,11,16,1202,1234
E01019932,2,2,16,36,1556,1612
E01019933,2,2,15,15,1174,1208
E01019934,1,1,16,9,1838,1865
E01019928,0,1,6,4,1439,1450
E01019929,1,2,11,1,1430,1445
E01019930,2,3,8,8,1364,1385
E01019931,2,2,12,6,1262,1284
E01019925,2,0,6,4,1276,1288
E01019959,0,1,7,7,1137,1152
E01019960,1,1,4,9,1347,1362
E01019962,3,3,23,9,2342,2380
E01032628,1,1,8,5,2034,2049
E01019886,10,2,15,14,2562,2603
E01019887,1,7,7,12,1399,1426
E01019888,1,3,13,45,1537,1599
E01019889,3,0,6,3,1470,1482
E01019966,0,1,8,2,1059,1070
E01019891,0,2,10,9,1441,1462
E01019892,3,2,15,11,1522,1553
E01019893,4,2,14,5,1802,1827
E01019903,2,2,18,10,2009,2041
E01019899,2,0,1,8,1324,1335
E01019900,1,0,7,3,1819,1830
E01019935,0,0,8,9,1220,1237
E01019936,0,0,5,5,1111,1121
E01019961,1,0,17,13,2490,2521
E01019939,1,0,8,11,1464,1484
E01019940,0,5,21,13,1538,1577
E01019942,1,1,10,10,1761,1783
E01019943,0,2,9,13,1550,1574
E01019944,0,1,11,14,1515,1541
E01019890,0,1,5,6,1812,1824
E01019901,1,1,15,13,1298,1328
E01019951,0,1,8,7,2171,2187
E01019946,0,0,5,5,1391,1401
E01019947,4,1,26,83,1673,1787
E01019948,2,0,6,5,1254,1267
E01019949,5,1,11,9,1395,1421
E01019950,4,2,5,7,1202,1220
E01019952,1,2,19,1,1688,1711
E01019953,5,2,8,9,1509,1533
E01019954,1,2,10,17,1453,1483
E01019955,2,1,19,16,1607,1645
E01019956,0,2,22,27,1588,1639
E01019957,0,3,17,31,1676,1727
E01019958,0,1,9,27,1775,1812
E01019937,2,0,7,6,2080,2095
E01019945,1,0,8,9,2102,2120
E01019963,0,4,7,2,1592,1605
E01019898,4,2,14,7,2299,2326
E01019964,3,13,22,10,1844,1892
E01019965,1,2,11,6,1743,1763
E01019904,0,2,6,11,1340,1359
E01019905,4,1,13,5,1997,2020
E01019906,2,1,8,11,1424,1446
E01019907,0,0,5,3,1487,1495
E01019908,0,1,7,9,1734,1751
E01019909,1,2,14,9,1764,1790
E01019910,0,2,11,7,1617,1637
E01019911,1,0,7,4,1529,1541
E01019894,1,1,13,15,1373,1403
E01019895,0,2,3,1,1371,1377
E01019896,1,0,5,9,1619,1634
E01019897,1,1,2,6,1543,1553
E01019920,1,6,23,7,1446,1483
E01019921,2,0,5,4,1550,1561
E01019922,1,0,12,5,1414,1432
E01019923,1,2,5,9,1215,1232
E01019924,1,1,9,7,1497,1515
E01019916,9,8,29,38,1807,1891
E01019917,0,5,14,23,1495,1537
E01019918,2,5,32,19,1822,1880
E01019919,0,2,18,38,1659,1717
E01019912,4,0,6,11,1667,1688
E01019913,2,2,4,10,1556,1574
E01019914,2,0,16,10,2167,2195
E01019915,3,8,9,9,1659,1688
E01019998,29,8,23,111,1252,1423
E01019999,17,4,23,64,1194,1302
E01020001,12,6,26,57,1201,1302
E01033233,50,64,117,641,4120,4992
E01019990,12,1,14,22,1295,1344
E01019991,19,4,21,43,1413,1500
E01019993,3,1,9,19,1142,1174
E01020000,4,9,29,74,1200,1316
E01020007,42,13,44,96,1296,1491
E01019992,9,2,12,30,1450,1503
E01020002,1,3,11,15,1452,1482
E01020003,13,3,19,14,1582,1631
E01020004,1,4,10,10,1455,1480
E01020005,13,20,29,18,1781,1861
E01019997,33,7,30,130,1330,1530
E01020019,14,9,38,94,1628,1783
E01020020,21,19,43,145,1520,1748
E01020021,27,18,54,128,1426,1653
E01020022,53,10,52,203,1389,1707
E01019980,22,3,21,39,1596,1681
E01019982,7,6,38,48,1529,1628
E01019983,14,3,19,18,1415,1469
E01019984,8,6,22,10,1317,1363
E01019985,4,1,15,12,1373,1405
E01019987,12,18,34,136,1505,1705
E01019989,2,13,13,34,1111,1173
E01020006,27,13,35,117,1849,2041
E01020008,12,23,52,103,1583,1773
E01020009,6,10,30,57,1378,1481
E01019986,5,7,20,27,1446,1505
E01020036,3,8,19,30,1425,1485
E01020037,6,7,20,18,1342,1393
E01020039,11,13,27,25,1792,1868
E01020040,8,5,24,11,1258,1306
E01019994,18,29,46,113,1326,1532
E01019995,24,16,26,91,1260,1417
E01020016,45,25,35,216,1826,2147
E01020017,79,23,69,355,1962,2488
E01020018,52,14,38,148,1748,2000
E01019996,14,6,47,80,1225,1372
E01020023,18,17,42,61,2065,2203
E01020024,14,2,31,41,1443,1531
E01020025,12,12,49,27,1381,1481
E01019975,1,5,7,28,1328,1369
E01020029,11,2,14,42,1532,1601
E01020030,12,13,31,65,1691,1812
E01020031,4,8,30,43,1505,1590
E01020032,13,5,18,30,1386,1452
E01020026,4,2,13,11,1706,1736
E01020027,1,9,7,31,1538,1586
E01020035,12,5,24,37,1537,1615
E01020038,10,1,17,15,1393,1436
E01033232,7,15,31,39,1370,1462
E01033234,11,14,17,36,1394,1472
E01019973,3,3,16,6,1423,1451
E01019974,3,1,17,5,1396,1422
E01019976,0,1,10,13,1354,1378
E01019977,1,1,12,16,1451,1481
E01019981,0,0,11,14,1418,1443
E01019988,10,12,22,29,1368,1441
E01020010,2,12,23,69,1719,1825
E01020013,7,18,41,68,1189,1323
E01020014,11,18,21,23,1495,1568
E01020015,6,7,16,24,1766,1819
E01019968,4,3,20,35,1479,1541
E01019969,6,5,11,3,1285,1310
E01019970,6,2,12,20,1323,1363
E01019971,11,9,32,73,1491,1616
E01019972,2,1,15,33,1350,1401
E01020011,10,2,13,4,1190,1219
E01020012,7,3,21,20,1417,1468
E01020033,2,0,16,8,1629,1655
E01033235,7,4,11,13,1197,1232
E01033236,3,1,13,11,989,1017
E01020046,0,2,12,6,1551,1571
E01020049,1,0,6,2,1298,1307
E01020050,0,4,4,6,2091,2105
E01020077,0,0,8,6,1589,1603
E01020047,2,1,6,9,2128,2146
E01020051,1,1,5,2,1791,1800
E01020066,0,6,12,32,2785,2835
E01020080,0,1,7,7,1251,1266
E01020063,2,2,26,10,2408,2448
E01020074,2,1,15,3,2116,2137
E01020075,1,1,10,7,1883,1902
E01020052,2,4,13,12,1756,1787
E01020053,0,5,7,6,1445,1463
E01020065,0,4,18,49,1907,1978
E01020067,1,1,17,9,1944,1972
E01020048,3,6,17,27,2026,2079
E01020078,3,2,6,9,1347,1367
E01020079,0,2,5,0,1354,1361
E01020081,0,1,11,6,1263,1281
E01020045,0,0,4,3,1640,1647
E01020059,1,2,20,4,2069,2096
E01020062,1,1,8,2,1535,1547
E01020064,0,1,16,10,1786,1813
E01020054,0,7,7,9,2056,2079
E01020055,3,0,10,40,1867,1920
E01020057,2,11,16,10,1677,1716
E01020058,0,3,8,8,1909,1928
E01020043,2,0,15,1,2023,2041
E01020044,0,0,12,4,1586,1602
E01020056,1,1,14,11,2017,2044
E01020071,2,0,9,4,1860,1875
E01020072,1,1,10,3,1645,1660
E01020073,1,0,8,3,1617,1629
E01020076,0,2,20,2,1684,1708
E01020082,1,1,4,1,1151,1158
E01020068,1,5,16,17,1481,1520
E01020069,0,1,7,6,1522,1536
E01020070,0,0,19,8,1866,1893
E01020083,0,0,21,6,2303,2330
E01020041,6,4,12,16,2138,2176
E01020042,1,5,8,17,1617,1648
E01020060,6,3,7,18,1648,1682
E01020061,1,2,8,17,2066,2094
E01020111,1,1,14,15,1420,1451
E01020112,9,2,27,22,1562,1622
E01020114,2,4,9,2,1215,1232
E01020115,0,3,10,9,1190,1212
E01020099,0,0,8,5,1367,1380
E01020100,0,0,8,3,1084,1095
E01020101,0,0,6,5,1455,1466
E01020126,0,3,25,7,1612,1647
E01020113,0,3,30,22,1400,1455
E01020116,1,1,16,8,1625,1651
E01020117,1,1,13,6,1477,1498
E01020118,0,3,5,10,1370,1388
E01020090,0,3,19,1,1700,1723
E01020108,1,1,21,8,2277,2308
E01020109,6,1,5,3,1425,1440
E01020089,4,3,25,14,2230,2276
E01020091,0,1,6,2,1287,1296
E01020092,6,0,15,6,1394,1421
E01020093,2,3,12,6,1389,1412
E01020110,24,27,15,67,2540,2673
E01020088,3,0,8,4,2102,2117
E01020120,9,0,20,42,1833,1904
E01020127,0,0,5,3,1871,1879
E01020132,5,2,12,17,1769,1805
E01020133,6,9,18,27,1412,1472
E01020134,2,0,7,42,1124,1175
E01020139,3,0,17,27,1350,1397
E01020094,7,15,18,55,1611,1706
E01020095,8,6,18,22,1467,1521
E01020140,2,3,13,13,1156,1187
E01020141,0,1,16,16,1753,1786
E01020096,3,8,24,41,1607,1683
E01020123,0,4,10,5,1430,1449
E01020124,0,4,19,9,1332,1364
E01020125,1,4,8,6,1267,1286
E01020102,5,3,18,24,1631,1681
E01020103,2,1,24,12,1458,1497
E01020104,0,2,20,9,1382,1413
E01020128,1,3,14,16,1277,1311
E01020129,7,3,17,10,1142,1179
E01020130,2,2,12,28,1489,1533
E01020105,0,0,5,4,1496,1505
E01020106,0,0,1,0,1129,1130
E01020107,0,3,8,10,1654,1675
E01020119,2,2,6,8,1483,1501
E01020084,1,2,10,15,1474,1502
E01020085,0,2,15,11,1521,1549
E01020086,4,0,13,18,1479,1514
E01020121,2,1,19,7,1922,1951
E01020122,1,1,14,6,1686,1708
E01020097,2,1,15,5,2232,2255
E01020131,0,3,8,36,2159,2206
E01020135,0,2,10,8,1548,1568
E01020136,2,1,14,8,1720,1745
E01020137,4,6,11,40,1501,1562
E01020087,1,2,3,2,1903,1911
E01020098,3,0,12,1,2065,2081
E01020138,2,2,14,7,2288,2313
E01020144,11,5,18,27,1477,1538
E01020145,2,3,15,15,1966,2001
E01020146,6,4,18,17,1139,1184
E01020149,0,2,11,14,1175,1202
E01020148,0,0,5,1,1113,1119
E01020157,2,1,22,14,2282,2321
E01020160,0,2,15,1,1866,1884
E01020176,1,0,12,3,1134,1150
E01020177,0,4,5,9,1391,1409
E01020180,1,12,36,19,1804,1872
E01020181,3,2,21,8,1676,1710
E01020182,0,3,16,7,1457,1483
E01020183,7,8,35,8,1344,1402
E01020184,6,3,17,18,1565,1609
E01020153,0,0,2,4,1211,1217
E01020156,0,1,9,7,1860,1877
E01020170,1,4,14,3,2101,2123
E01020188,0,1,12,13,1920,1946
E01020161,3,4,31,31,2408,2477
E01020162,2,3,10,3,1637,1655
E01020163,1,3,4,4,1795,1807
E01020164,1,0,8,5,1534,1548
E01020165,0,1,9,10,1515,1535
E01020166,0,2,8,3,1430,1443
E01020167,3,1,8,1,1373,1386
E01020142,0,5,14,15,2231,2265
E01020143,4,1,34,6,2172,2217
E01020150,3,3,26,8,1713,1753
E01020151,1,10,9,7,1557,1584
E01020152,2,0,10,20,1392,1424
E01020154,40,6,10,4,1499,1559
E01020155,3,2,5,7,1021,1038
E01020147,1,1,11,4,1934,1951
E01020158,0,4,4,7,1662,1677
E01020159,0,0,16,11,1416,1443
E01020190,0,5,29,6,2009,2049
E01020171,1,0,11,6,1796,1814
E01020185,3,2,6,2,1302,1315
E01020186,0,3,5,6,1411,1425
E01020187,0,0,13,8,1694,1715
E01020168,1,2,8,10,2053,2074
E01020169,5,0,20,35,2247,2307
E01020189,1,2,16,24,1999,2042
E01020174,0,0,7,3,1519,1529
E01020175,1,1,4,3,1918,1927
E01020178,2,1,4,8,1880,1895
E01020172,4,2,13,7,1774,1800
E01020173,0,0,4,1,1548,1553
E01020179,2,2,13,5,1864,1886
E01020243,4,1,2,7,1179,1193
E01020262,2,2,5,8,1226,1243
E01020263,1,0,2,0,1469,1472
E01020274,0,0,3,3,1279,1285
E01020240,2,2,20,5,1515,1544
E01020241,2,5,14,23,1700,1744
E01020242,0,0,7,9,1409,1425
E01020244,0,1,4,11,1396,1412
E01020245,1,3,11,6,1613,1634
E01020205,1,0,6,5,1435,1447
E01020258,2,0,16,14,1671,1703
E01020259,1,1,7,1,1093,1103
E01020273,1,0,17,3,1362,1383
E01020203,4,0,10,9,1628,1651
E01020206,0,0,7,4,1517,1528
E01020220,3,0,16,9,1339,1367
E01020221,2,0,12,10,1742,1766
E01020222,2,1,5,4,1233,1245
E01020223,1,0,11,13,1722,1747
E01020229,0,0,6,9,1652,1667
E01020230,1,1,14,7,1664,1687
E01020231,0,1,11,16,1441,1469
E01020232,1,0,15,8,1603,1627
E01020228,4,5,14,44,1686,1753
E01020233,3,1,9,6,1707,1726
E01020234,0,1,2,8,1448,1459
E01020235,4,0,20,17,1732,1773
E01020202,0,4,13,8,1515,1540
E01020204,0,0,16,17,1522,1555
E01020236,0,0,7,2,1280,1289
E01020237,0,0,4,3,1566,1573
E01020265,0,1,9,3,1685,1698
E01020266,5,3,16,67,1638,1729
E01020267,4,5,6,10,1472,1497
E01020268,1,3,17,15,1401,1437
E01020270,2,0,11,5,1590,1608
E01020250,1,1,9,1,1568,1580
E01020252,1,0,9,6,1369,1385
E01020253,1,1,18,10,1478,1508
E01020254,2,0,13,3,1298,1316
E01020255,1,0,8,1,1292,1302
E01020257,2,1,6,9,1197,1215
E01020264,3,0,7,16,1489,1515
E01020269,2,8,12,27,1805,1854
E01020271,2,0,11,16,1498,1527
E01020272,1,2,16,14,1851,1884
E01020200,2,1,6,4,1076,1089
E01020201,1,3,7,4,1466,1481
E01020251,1,1,7,13,1442,1464
E01020260,2,0,8,1,1258,1269
E01020261,1,1,7,5,1182,1196
E01020208,1,0,9,11,1240,1261
E01020209,1,0,9,4,1428,1442
E01020210,0,0,4,5,1168,1177
E01020219,1,3,19,11,2025,2059
E01020191,0,16,24,10,1624,1674
E01020194,0,3,11,2,1438,1454
E01020207,5,0,4,8,1146,1163
E01020256,2,2,15,37,1321,1377
E01020211,2,1,11,11,1502,1527
E01020217,2,0,15,45,1595,1657
E01020218,7,3,24,53,1392,1479
E01020224,5,0,15,21,1215,1256
E01020216,1,3,11,12,1625,1652
E01020225,0,5,16,16,1227,1264
E01020226,3,0,5,15,1243,1266
E01020227,0,2,16,11,1439,1468
E01020212,0,1,7,3,1205,1216
E01020213,0,0,10,4,1403,1417
E01020214,1,2,9,6,1535,1553
E01020215,1,0,5,5,1365,1376
E01020195,0,1,24,4,1716,1745
E01020196,0,0,28,11,1647,1686
E01020197,0,0,16,9,1233,1258
E01020198,0,0,13,1,1373,1387
E01020199,1,1,24,14,1602,1642
E01020246,0,2,4,6,1085,1097
E01020247,3,1,14,8,1598,1624
E01020248,0,1,17,11,1587,1616
E01020249,2,2,8,8,1322,1342
E01020192,2,2,12,0,1544,1560
E01020193,2,1,9,5,1475,1492
E01020238,0,1,3,3,1190,1197
E01020239,3,4,5,4,1256,1272
E01020275,0,3,15,1,1290,1309
E01020276,0,2,13,4,1489,1508
E01020297,0,3,16,3,1536,1558
E01020299,0,1,9,6,1793,1809
E01020298,1,1,13,7,2038,2060
E01020300,1,1,11,5,1688,1706
E01020310,0,1,21,7,2083,2112
E01020280,20,0,32,18,2104,2174
E01020281,3,0,12,43,1864,1922
E01020282,1,1,17,5,1597,1621
E01020277,3,1,18,7,1992,2021
E01020278,0,0,11,7,1646,1664
E01020279,3,3,21,5,2273,2305
E01020283,0,1,7,6,1373,1387
E01020284,4,6,19,10,1923,1962
E01020285,0,1,25,11,1972,2009
E01020288,0,1,4,5,1617,1627
E01020292,8,0,6,12,1424,1450
E01020295,2,3,15,3,1666,1689
E01020296,1,2,7,0,1478,1488
E01020304,0,1,11,7,1702,1721
E01020305,2,4,12,13,1050,1081
E01020306,1,0,5,1,1242,1249
E01020307,1,2,2,6,1652,1663
E01020287,1,1,16,0,1519,1537
E01020303,2,0,11,0,1630,1643
E01020308,2,0,6,6,1654,1668
E01020311,1,1,20,3,2043,2068
E01020291,0,0,7,10,1552,1569
E01020293,2,0,8,8,2193,2211
E01020294,2,6,4,7,1717,1736
E01020302,0,1,7,1,1725,1734
E01020309,0,3,8,7,1661,1679
E01020286,2,0,4,3,1641,1650
E01020289,0,0,4,3,1527,1534
E01020290,2,1,7,4,1702,1716
E01020301,2,0,5,27,1965,1999
E01020320,1,3,17,8,1666,1695
E01020321,3,2,10,18,2185,2218
E01020322,2,1,13,2,2006,2024
E01020326,0,1,8,7,2010,2026
E01020327,0,0,6,10,1792,1808
E01020328,7,1,24,18,2227,2277
E01020329,3,1,15,12,1547,1578
E01020330,5,3,16,33,1780,1837
E01020318,1,3,16,5,1424,1449
E01020319,2,2,13,6,1591,1614
E01020323,7,30,42,30,1938,2047
E01020339,0,0,19,3,1661,1683
E01020314,5,1,6,7,1591,1610
E01020325,3,0,6,5,1603,1617
E01020331,1,0,7,2,1612,1622
E01020340,0,0,9,2,1669,1680
E01020332,2,1,18,28,1737,1786
E01020333,3,1,23,16,1885,1928
E01020334,4,0,25,16,1882,1927
E01020335,0,0,12,3,1511,1526
E01020336,0,2,8,4,1346,1360
E01020337,2,0,11,15,1391,1419
E01020338,1,1,10,14,2308,2334
E01020317,0,2,5,3,1435,1445
E01020324,3,0,5,3,1548,1559
E01020341,0,2,10,2,1592,1606
E01020342,0,0,14,6,1489,1509
E01020312,1,0,13,2,1547,1563
E01020313,0,1,8,3,1414,1426
E01020315,0,1,9,10,1519,1539
E01020316,6,0,4,7,1824,1841
E01020343,0,1,13,4,1487,1505
E01020344,1,1,18,12,1428,1460
E01020345,0,0,10,13,1189,1212
E01020365,7,3,11,11,1564,1596
E01020351,0,2,19,11,1277,1309
E01020352,3,3,20,29,1304,1359
E01020353,5,7,20,38,1628,1698
E01020359,3,5,23,19,1243,1293
E01020366,6,2,22,24,2070,2124
E01020349,6,8,20,20,1707,1761
E01020350,4,0,8,9,1674,1695
E01020357,0,6,21,20,2062,2109
E01020358,2,6,6,2,1513,1529
E01020369,2,2,8,1,1305,1318
E01020370,1,1,11,20,1460,1493
E01020371,0,0,6,11,1526,1543
E01020372,0,0,11,6,1216,1233
E01020346,4,4,26,24,1532,1590
E01020347,4,3,20,20,1565,1612
E01020348,12,2,22,15,1622,1673
E01020363,2,2,9,3,1186,1202
E01020360,1,5,38,18,1489,1551
E01020361,3,8,22,37,1556,1626
E01020364,2,1,31,23,1542,1599
E01020367,2,5,22,29,1793,1851
E01020368,5,4,36,42,2296,2383
E01020354,0,0,7,15,1461,1483
E01020355,2,0,10,10,1883,1905
E01020356,1,2,7,4,1575,1589
E01020362,0,0,8,5,1438,1451
E01020373,0,1,5,6,1319,1331
E01020374,3,0,12,10,1492,1517
E01020389,1,5,13,7,2163,2189
E01020397,0,0,17,6,1405,1428
E01020416,2,2,6,5,1478,1493
E01020417,0,4,5,4,1061,1074
E01020418,3,1,13,11,1427,1455
E01020419,0,3,7,7,1848,1865
E01020420,2,2,11,20,1299,1334
E01020411,4,2,11,17,1120,1154
E01020412,1,1,19,17,1455,1493
E01020413,2,2,14,5,1440,1463
E01020414,2,4,23,39,1924,1992
E01020415,1,1,2,5,1520,1529
E01020403,12,2,10,11,1525,1560
E01020404,2,2,5,27,1531,1567
E01020405,2,2,13,27,1417,1461
E01020406,2,5,6,12,2246,2271
E01020396,0,1,6,2,1054,1063
E01020398,1,1,10,6,2268,2286
E01020409,0,1,12,16,1242,1271
E01020410,0,0,1,12,1298,1311
E01020421,0,1,6,20,1364,1391
E01020422,2,2,11,6,1632,1653
E01020423,1,0,8,2,1442,1453
E01020424,1,0,10,6,1375,1392
E01020425,0,3,6,12,1651,1672
E01020377,0,6,11,9,1608,1634
E01020379,1,2,19,2,1434,1458
E01020380,0,1,2,6,1075,1084
E01020381,2,4,11,4,1196,1217
E01020390,2,3,12,20,1326,1363
E01020391,0,0,8,16,1409,1433
E01020392,4,5,12,30,1493,1544
E01020393,2,12,9,47,1501,1571
E01020394,3,2,17,31,1679,1732
E01020375,2,2,19,12,1335,1370
E01020376,0,0,1,2,1084,1087
E01020378,1,1,12,5,1515,1534
E01020407,2,0,5,8,1191,1206
E01020408,0,1,6,4,1126,1137
E01020426,2,1,22,24,1783,1832
E01020427,0,0,13,12,1598,1623
E01020428,3,1,16,11,1863,1894
E01020429,1,2,19,14,1629,1665
E01020395,3,3,11,21,1791,1829
E01020399,1,6,16,23,2456,2502
E01020400,1,0,5,8,1596,1610
E01020401,0,2,6,16,1487,1511
E01020402,5,0,16,10,1498,1529
E01020382,0,0,8,13,1504,1525
E01020383,1,1,4,7,1743,1756
E01020384,1,0,17,19,1720,1757
E01020385,3,1,6,6,1232,1248
E01020386,0,1,12,4,1192,1209
E01020387,0,0,4,14,1105,1123
E01020388,0,1,13,21,1480,1515
E01020443,0,2,28,29,2450,2509
E01020447,0,5,7,3,1758,1773
E01020463,1,6,17,13,1640,1677
E01020464,0,3,7,5,1528,1543
E01020440,0,4,7,6,1888,1905
E01020450,1,5,27,7,2257,2297
E01020462,2,2,9,6,1767,1786
E01033156,1,2,19,2,1718,1742
E01033158,0,7,13,19,1435,1474
E01020454,6,3,24,39,2049,2121
E01020455,0,7,22,31,1845,1905
E01020456,1,0,8,9,1762,1780
E01020457,1,12,14,33,1448,1508
E01020433,1,5,16,7,1746,1775
E01020434,1,8,5,14,1771,1799
E01020449,0,1,10,4,1983,1998
E01020458,0,0,13,10,2156,2179
E01020459,2,2,20,20,2534,2578
E01020444,1,0,11,9,1753,1774
E01020445,2,7,11,21,1478,1519
E01020446,3,5,11,5,1501,1525
E01020460,1,32,36,20,2188,2277
E01020442,2,6,5,4,1976,1993
E01020452,3,7,16,32,2378,2436
E01020453,3,0,14,2,1692,1711
E01033154,9,36,39,185,1936,2205
E01033159,0,13,13,56,1015,1097
E01020435,3,1,6,12,1759,1781
E01020436,2,0,28,39,1993,2062
E01020437,1,1,20,19,1835,1876
E01020438,3,0,18,57,1915,1993
E01020439,5,4,21,49,2192,2271
E01020430,2,1,4,2,1430,1439
E01020431,2,9,11,11,1199,1232
E01020432,1,1,13,3,1208,1226
E01020441,1,0,1,6,1842,1850
E01020448,0,0,8,7,1952,1967
E01020465,0,0,8,4,1933,1945
E01020469,0,0,11,3,1917,1931
E01020470,1,0,1,3,1811,1816
E01020471,1,4,9,8,1376,1398
E01020472,0,1,15,2,1369,1387
E01020473,0,3,16,9,1431,1459
E01020474,0,0,6,4,1680,1690
E01020475,2,1,16,11,2019,2049
E01020476,0,0,5,5,1225,1235
E01020477,1,2,11,4,1521,1539
E01020485,1,0,12,5,1424,1442
E01020486,0,0,16,8,1282,1306
E01020487,4,0,11,11,1261,1287
E01020488,0,0,10,12,1439,1461
E01020489,0,1,11,9,1443,1464
E01020490,0,1,13,11,1593,1618
E01020491,1,2,13,4,1551,1571
E01020492,1,0,11,2,1139,1153
E01020493,4,15,27,14,2526,2586
E01020466,0,5,10,3,1762,1780
E01020467,0,1,5,6,1752,1764
E01020468,0,0,3,2,1486,1491
E01020478,1,0,10,8,1072,1091
E01020479,5,1,14,17,1165,1202
E01020480,0,1,11,4,1462,1478
E01020481,4,4,18,6,1481,1513
E01020482,1,2,20,33,1562,1618
E01020483,0,0,5,2,1267,1274
E01020484,1,4,8,21,1391,1425
E01020542,0,0,11,10,1283,1304
E01020543,1,6,8,19,1418,1452
E01020544,5,6,14,110,1531,1666
E01020546,9,17,36,84,1672,1818
E01020547,0,1,7,5,1104,1117
E01032642,4,6,17,29,2110,2166
E01020497,1,6,5,2,1900,1914
E01020508,1,1,12,23,1963,2000
E01020541,0,3,6,7,1995,2011
E01020550,1,1,5,6,1551,1564
E01020494,0,0,6,2,1142,1150
E01020495,1,3,1,4,1378,1387
E01020496,1,2,13,1,1553,1570
E01020506,1,1,3,3,1728,1736
E01020530,6,2,15,7,1818,1848
E01020534,1,3,14,12,2051,2081
E01020509,4,2,28,9,2756,2799
E01020510,0,3,3,9,1954,1969
E01020529,0,3,14,5,2188,2210
E01020539,1,3,11,19,1954,1988
E01020540,0,0,23,11,2403,2437
E01020511,0,0,9,9,1679,1697
E01020532,3,3,14,6,1588,1614
E01020533,2,1,23,38,1993,2057
E01020535,1,0,13,7,1696,1717
E01020498,1,7,16,9,2005,2038
E01020499,1,7,7,1,1378,1394
E01020500,6,3,21,13,1582,1625
E01020501,0,2,16,4,1381,1403
E01020507,2,1,14,9,1871,1897
E01020517,7,0,14,3,1721,1745
E01020531,2,2,18,3,1672,1697
E01020536,3,1,16,12,2048,2080
E01020502,0,8,3,2,1644,1657
E01020503,2,1,11,9,1739,1762
E01020504,1,3,12,4,2236,2256
E01020526,0,4,14,12,1338,1368
E01020527,2,9,21,36,1440,1508
E01020528,1,3,24,61,1869,1958
E01032641,0,3,18,31,1555,1607
E01032643,7,9,21,61,1585,1683
E01032644,3,9,3,20,1038,1073
E01032645,8,4,9,11,1061,1093
E01020518,3,5,28,18,1468,1522
E01020519,6,5,24,27,1743,1805
E01020520,1,2,19,20,1352,1394
E01020523,2,0,12,21,1229,1264
E01020524,1,2,16,14,1433,1466
E01020525,0,1,6,9,1303,1319
E01020505,2,0,9,11,1848,1870
E01020537,0,3,22,4,1924,1953
E01020538,0,0,10,13,1828,1851
E01020549,1,0,6,14,2074,2095
E01020512,1,0,14,10,2069,2094
E01020513,1,2,12,8,1520,1543
E01020514,0,0,4,10,1238,1252
E01020515,0,0,11,9,1193,1213
E01020516,0,0,8,8,1491,1507
E01020551,0,1,6,17,1859,1883
E01020552,0,4,24,6,1771,1805
E01020570,0,0,6,18,1557,1581
E01020571,1,2,16,20,2008,2047
E01020557,5,0,8,19,1495,1527
E01020558,1,2,4,4,1709,1720
E01020559,0,0,3,15,1565,1583
E01020560,2,3,12,17,1889,1923
E01020561,8,4,15,45,1816,1888
E01020574,0,2,27,22,1841,1892
E01020575,0,2,14,25,1621,1662
E01020576,1,2,15,24,1669,1711
E01020579,0,2,13,12,1937,1964
E01020580,0,2,13,10,1415,1440
E01020553,0,5,9,41,1247,1302
E01020554,3,13,41,42,1679,1778
E01020555,4,6,28,22,1301,1361
E01020556,1,5,5,33,1393,1437
E01020581,3,7,23,28,1958,2019
E01020582,10,6,18,37,1502,1573
E01020572,2,4,29,17,1909,1961
E01020573,3,2,16,14,1787,1822
E01020577,3,5,16,33,1543,1600
E01020578,2,0,13,1,2066,2082
E01020583,0,6,29,12,1883,1930
E01020584,1,0,16,7,1678,1702
E01020585,1,1,13,2,1542,1559
E01020586,0,0,7,8,1258,1273
E01020587,0,1,6,4,1479,1490
E01020588,0,0,8,10,1303,1321
E01020589,2,4,10,9,1462,1487
E01020563,7,70,57,13,1483,1630
E01020569,0,1,13,1,1445,1460
E01033200,13,145,56,32,2307,2553
E01020562,0,4,12,10,2000,2026
E01020564,0,2,19,1,1599,1621
E01020565,0,0,11,6,1447,1464
E01020566,0,8,22,3,2057,2090
E01022163,5,5,17,110,1357,1494
E01022164,7,11,32,55,1289,1394
E01022165,6,5,11,28,1442,1492
E01022166,2,4,17,78,1219,1320
E01022143,13,9,12,26,1402,1462
E01022144,4,1,11,16,1093,1125
E01022145,0,0,11,12,1196,1219
E01022146,4,5,5,12,1333,1359
E01022122,1,10,32,29,1299,1371
E01022160,4,11,48,37,2002,2102
E01022161,0,20,16,22,1358,1416
E01022162,0,3,25,17,1498,1543
E01022139,3,6,19,30,1214,1272
E01022151,2,8,28,122,1551,1711
E01022152,7,11,18,71,1033,1140
E01022153,6,28,57,86,1464,1641
E01022154,20,22,42,121,1706,1911
E01022120,2,9,21,30,1489,1551
E01022121,8,16,31,46,1674,1775
E01022147,8,15,46,23,1528,1620
E01022157,4,10,35,66,1419,1534
E01022159,1,27,34,76,1337,1475
E01022131,2,9,16,18,1216,1261
E01022132,3,17,34,54,1317,1425
E01022133,3,2,24,41,1414,1484
E01022134,11,6,25,49,1470,1561
E01022148,11,9,16,26,1495,1557
E01022149,7,1,21,57,1314,1400
E01022150,14,5,22,50,1440,1531
E01022155,8,30,13,130,1325,1506
E01022156,7,10,39,79,1458,1593
E01022158,9,15,44,164,1969,2201
E01022100,1,11,26,41,1720,1799
E01022101,6,10,34,44,1720,1814
E01022102,16,25,42,124,1574,1781
E01022140,0,1,14,34,1144,1193
E01022141,1,8,32,38,1305,1384
E01022142,4,18,26,67,1363,1478
E01022116,15,18,35,90,1366,1524
E01022117,5,20,37,40,1607,1709
E01022119,4,3,23,26,1249,1305
E01022124,10,11,20,20,1170,1231
E01022125,7,10,17,32,1216,1282
E01022126,11,8,28,50,1324,1421
E01022127,6,66,90,254,1573,1989
E01022106,2,8,23,27,1698,1758
E01022107,9,1,13,18,1486,1527
E01022108,2,1,17,37,1729,1786
E01022123,9,9,53,124,2010,2205
E01022135,1,21,39,91,1566,1718
E01022136,1,5,9,35,1453,1503
E01022137,0,22,29,38,1627,1716
E01022138,1,14,24,62,1651,1752
E01022174,1,1,20,16,1309,1347
E01022103,10,9,41,54,2279,2393
E01022104,3,4,28,34,1567,1636
E01022105,2,2,14,16,1397,1431
E01022109,0,7,16,19,1434,1476
E01022110,7,6,23,28,1324,1388
E01022111,2,10,23,11,1420,1466
E01022112,1,5,15,22,1255,1298
E01022167,2,5,10,6,1200,1223
E01022168,7,4,9,15,1069,1104
E01022169,9,4,19,38,1436,1506
E01022170,7,5,20,41,1410,1483
E01022171,4,4,13,56,1273,1350
E01022172,1,1,7,20,1404,1433
E01022173,1,5,15,34,1283,1338
E01022113,6,4,10,23,1632,1675
E01022114,0,1,13,18,1520,1552
E01022115,9,3,37,26,1549,1624
E01022118,3,2,20,37,1351,1413
E01022128,0,2,13,24,1567,1606
E01022129,3,4,27,30,2027,2091
E01022130,3,3,32,34,1506,1578
E01022179,0,4,9,7,2021,2041
E01022182,1,5,9,10,1473,1498
E01022183,0,1,7,16,1482,1506
E01022184,1,2,1,2,1445,1451
E01022185,0,2,12,6,1413,1433
E01022177,8,2,11,20,2001,2042
E01022178,2,2,17,5,1297,1323
E01022205,2,1,9,13,1769,1794
E01022211,1,3,6,10,1825,1845
E01022212,0,2,15,12,1619,1648
E01022180,1,5,27,15,2040,2088
E01022181,0,2,12,19,1555,1588
E01022214,0,2,18,33,2050,2103
E01022222,1,3,18,25,1853,1900
E01022186,2,3,5,3,1692,1705
E01022187,6,6,22,43,1893,1970
E01022201,1,2,14,10,1766,1793
E01022216,1,3,17,9,1799,1829
E01022175,1,8,30,9,1836,1884
E01022207,1,2,11,12,1763,1789
E01022213,0,7,12,7,1828,1854
E01022215,0,1,24,8,1733,1766
E01022188,1,2,5,12,1332,1352
E01022189,0,3,17,23,1298,1341
E01022190,1,2,7,14,1355,1379
E01022196,4,6,20,9,1711,1750
E01022197,7,1,9,12,1835,1864
E01022194,2,8,33,46,1569,1658
E01022195,2,14,14,15,1593,1638
E01022199,2,3,17,25,1692,1739
E01022200,1,4,10,31,1224,1270
E01022191,2,14,11,25,1324,1376
E01022192,0,2,7,11,1300,1320
E01022193,0,2,5,11,1065,1083
E01022198,6,25,22,40,1213,1306
E01022225,6,32,21,34,1693,1786
E01022202,0,1,6,2,1086,1095
E01022203,8,1,23,8,1438,1478
E01022204,0,2,8,22,1426,1458
E01022208,2,2,17,9,1545,1575
E01022209,0,12,1,3,1107,1123
E01022210,0,6,9,21,1239,1275
E01022221,4,5,17,19,1910,1955
E01022223,0,1,16,13,2344,2374
E01022224,1,0,10,4,1532,1547
E01022176,2,1,21,10,1896,1930
E01022206,3,2,19,17,1846,1887
E01022217,0,0,11,7,1276,1294
E01022218,0,2,11,15,1286,1314
E01022219,1,1,7,6,1241,1256
E01022220,1,7,18,36,1546,1608
E01022233,1,1,7,7,1885,1901
E01022235,0,6,7,8,1739,1760
E01022247,4,17,19,23,2433,2496
E01022270,0,2,8,8,1838,1856
E01022271,0,0,15,6,1643,1664
E01022261,0,4,27,7,1903,1941
E01022262,2,0,17,12,1795,1826
E01022267,3,5,15,11,1549,1583
E01022251,1,4,11,3,1412,1431
E01022252,0,1,9,1,1710,1721
E01022258,0,3,12,6,1129,1150
E01022259,0,0,6,9,1618,1633
E01022260,0,1,6,4,1813,1824
E01022236,0,4,5,30,2011,2050
E01022237,0,4,12,15,1464,1495
E01022238,0,2,6,15,1253,1276
E01022239,1,1,7,2,1618,1629
E01022240,0,17,17,32,1978,2044
E01022249,0,4,12,10,1950,1976
E01022250,0,1,10,18,1763,1792
E01022228,0,1,11,5,1697,1714
E01022230,1,1,21,17,1714,1754
E01022265,2,3,20,8,1634,1667
E01022266,0,0,10,6,1405,1421
E01022234,0,8,4,6,1502,1520
E01022253,1,1,11,6,1648,1667
E01022263,2,3,19,2,1796,1822
E01022229,0,2,7,8,1635,1652
E01022241,2,2,7,25,1562,1598
E01022242,0,2,2,20,1450,1474
E01022243,1,0,4,15,1204,1224
E01022244,2,0,6,5,1446,1459
E01022245,0,2,6,6,1300,1314
E01022246,0,1,5,3,1281,1290
E01022231,1,9,8,0,1624,1642
E01022232,0,4,3,8,1514,1529
E01022264,1,0,14,9,1451,1475
E01022268,0,2,4,1,1568,1575
E01022269,1,1,13,8,1924,1947
E01022226,1,1,7,2,1537,1548
E01022227,3,3,12,7,1521,1546
E01022254,3,5,5,10,1882,1905
E01022255,2,0,5,3,1547,1557
E01022256,5,0,7,3,1570,1585
E01022257,5,1,19,3,1824,1852
E01022248,2,6,14,5,1663,1690
E01022272,2,9,16,5,1310,1342
E01022273,5,43,26,40,1257,1371
E01022274,0,5,8,2,1158,1173
E01022275,8,7,6,8,1571,1600
E01022313,0,13,37,42,1597,1689
E01022315,1,16,20,37,1431,1505
E01022316,10,12,28,31,1500,1581
E01022317,10,6,21,42,1485,1564
E01022318,4,12,19,19,1688,1742
E01022309,7,38,34,98,1369,1546
E01022310,7,29,41,60,1600,1737
E01022311,16,71,44,160,1523,1814
E01022312,13,90,74,269,1868,2314
E01022314,1,5,14,46,1385,1451
E01022295,0,8,17,20,1385,1430
E01022296,1,17,43,37,1360,1458
E01022297,2,15,15,29,1215,1276
E01022298,3,31,50,52,1476,1612
E01022332,4,73,53,163,1319,1612
E01022347,6,77,70,104,1432,1689
E01022348,7,63,70,76,2394,2610
E01032932,3,40,24,69,1071,1207
E01032937,0,37,48,52,964,1101
E01022288,10,147,95,308,1179,1739
E01022289,14,120,70,598,780,1582
E01022290,12,109,79,362,813,1375
E01022291,30,151,92,666,800,1739
E01022292,10,136,83,585,597,1411
E01022283,2,5,11,14,1478,1510
E01022303,7,19,36,26,1319,1407
E01022304,7,16,17,23,1480,1543
E01022305,1,9,24,8,1349,1391
E01022308,2,5,28,24,1363,1422
E01022278,7,48,47,30,1456,1588
E01022279,1,61,44,32,1342,1480
E01022282,8,52,58,77,2662,2857
E01022284,6,63,61,62,1085,1277
E01022285,1,33,118,23,1234,1409
E01022286,0,42,66,57,1414,1579
E01022287,4,21,47,27,1586,1685
E01022293,9,193,77,274,1023,1576
E01022294,7,121,73,103,1227,1531
E01022323,10,87,107,37,1536,1777
E01022328,3,85,71,40,1129,1328
E01022329,2,97,84,66,1356,1605
E01022326,5,24,51,36,1191,1307
E01022327,0,48,45,44,1459,1596
E01022330,6,50,52,40,1295,1443
E01022331,1,34,48,23,1256,1362
E01022333,1,96,76,21,1199,1393
E01022334,1,45,35,21,1499,1601
E01022276,5,14,18,28,1562,1627
E01022277,2,18,19,22,1428,1489
E01022280,3,17,35,48,1438,1541
E01022281,1,20,22,20,1707,1770
E01022306,3,18,26,21,1336,1404
E01022307,0,16,37,40,1566,1659
E01022319,2,78,77,15,1247,1419
E01022320,3,36,41,29,1392,1501
E01022321,2,65,32,65,1346,1510
E01022322,0,58,43,30,1159,1290
E01022324,1,60,59,30,1296,1446
E01022325,0,29,24,46,1235,1334
E01022343,1,35,48,34,1259,1377
E01022344,2,20,38,10,1452,1522
E01022345,5,9,20,23,1413,1470
E01022346,2,48,53,20,1397,1520
E01022299,0,6,26,10,1350,1392
E01022300,4,11,11,11,1318,1355
E01022301,2,42,46,16,1438,1544
E01022302,1,14,19,14,1500,1548
E01022339,2,9,28,37,1644,1720
E01022340,1,32,32,12,1382,1459
E01022341,8,38,67,31,2067,2211
E01022342,4,11,33,23,1637,1708
E01022335,0,7,23,26,1444,1500
E01022336,0,16,15,12,1124,1167
E01022338,6,25,43,18,1256,1348
E01032933,3,50,52,34,1367,1506
E01032934,2,22,16,11,1393,1444
E01032935,6,29,38,39,1474,1586
E01032936,3,63,107,31,1666,1870
E01022378,4,3,23,5,1787,1822
E01022379,0,15,22,19,1380,1436
E01022380,3,3,4,5,1510,1525
E01022412,3,18,49,32,2743,2845
E01022354,0,2,10,12,2118,2142
E01022390,0,1,15,11,1175,1202
E01022391,1,1,4,6,1413,1425
E01022392,1,0,12,7,1511,1531
E01022376,1,0,12,14,1767,1794
E01022396,2,3,7,5,1694,1711
E01022397,1,1,19,4,1888,1913
E01022398,1,1,6,11,1117,1136
E01022355,1,2,10,11,1651,1675
E01022356,3,6,41,21,2203,2274
E01022357,2,4,17,5,1743,1771
E01022358,4,5,16,11,1560,1596
E01022377,1,6,33,8,2118,2166
E01022389,1,4,24,11,1707,1747
E01022400,1,6,30,22,1758,1817
E01022401,2,2,17,16,1373,1410
E01022402,1,6,17,6,1549,1579
E01022403,2,3,9,7,1356,1377
E01022404,1,9,27,44,1461,1542
E01022365,2,9,40,22,2077,2150
E01022399,9,16,30,11,2075,2141
E01022410,10,6,37,20,2077,2150
E01022411,1,8,22,24,2160,2215
E01022414,2,14,53,28,2340,2437
E01022393,1,1,14,7,1441,1464
E01022394,2,11,34,13,1495,1555
E01022395,6,2,30,7,1479,1524
E01022408,1,0,11,5,1054,1071
E01022409,1,0,10,3,1242,1256
E01022366,0,2,26,13,1743,1784
E01022367,1,0,11,1,1642,1655
E01022368,2,3,7,4,1380,1396
E01022369,2,4,13,3,1652,1674
E01022370,2,0,12,6,1220,1240
E01022371,0,1,2,2,1054,1059
E01022405,0,1,5,10,1408,1424
E01022406,0,1,20,2,1186,1209
E01022407,0,1,6,2,1318,1327
E01022350,2,0,9,3,2102,2116
E01022382,0,2,20,15,1574,1611
E01022383,4,1,8,8,1304,1325
E01022384,1,1,6,6,1407,1421
E01022359,0,1,17,16,1458,1492
E01022360,0,0,13,6,1375,1394
E01022361,1,7,10,3,1227,1248
E01022362,1,2,12,2,1142,1159
E01022363,6,4,15,3,1727,1755
E01022364,1,2,11,0,1100,1114
E01022351,3,2,8,2,1397,1412
E01022352,1,0,19,12,1318,1350
E01022353,2,0,10,11,1396,1419
E01022413,1,1,14,6,1857,1879
E01022385,2,5,30,13,1573,1623
E01022386,3,3,16,6,1602,1630
E01022387,0,2,21,30,1556,1609
E01022388,2,5,24,14,1707,1752
E01022372,0,17,12,13,1730,1772
E01022373,1,4,21,14,1661,1701
E01022374,3,10,33,9,1908,1963
E01022375,1,1,18,12,1229,1261
E01022381,2,1,18,11,2064,2096
E01022415,1,4,16,7,1593,1621
E01022416,2,1,9,2,1439,1453
E01022417,2,2,3,21,1686,1714
E01022418,6,1,16,30,1669,1722
E01022450,6,13,31,18,2043,2111
E01022451,2,0,10,7,1502,1521
E01022452,0,2,5,24,1417,1448
E01022455,1,3,17,11,1937,1969
E01032938,1,7,12,15,1483,1518
E01032939,2,2,18,15,1573,1610
E01032940,5,13,13,10,1365,1406
E01022456,0,1,14,13,1276,1304
E01022457,1,2,15,4,1355,1377
E01022458,0,1,24,25,1363,1413
E01022459,3,2,14,12,1422,1453
E01022460,0,1,10,16,1673,1700
E01022461,0,0,10,7,1363,1380
E01022462,3,0,17,7,1641,1668
E01022449,2,0,6,11,1936,1955
E01022463,1,3,4,6,1454,1468
E01022464,0,5,8,23,1544,1580
E01022465,2,1,12,7,1504,1526
E01022466,0,1,9,4,1707,1721
E01022434,7,1,23,14,2078,2123
E01022441,3,0,10,11,1496,1520
E01022445,0,0,11,5,1352,1368
E01022453,0,0,16,17,1559,1592
E01022432,0,5,14,49,1941,2009
E01022433,1,3,20,35,2022,2081
E01022435,1,3,29,32,2262,2327
E01022436,0,9,10,23,1879,1921
E01022437,2,4,11,18,1413,1448
E01022438,3,4,14,23,1308,1352
E01022439,1,1,15,36,1502,1555
E01022440,4,2,13,13,1495,1527
E01022442,0,0,10,11,1477,1498
E01022443,1,1,8,9,1315,1334
E01022444,2,1,11,17,1473,1504
E01022425,2,4,16,12,1181,1215
E01022426,2,6,9,6,1414,1437
E01022427,1,8,12,14,1411,1446
E01022428,8,12,37,38,1750,1845
E01022429,2,6,14,12,1527,1561
E01022430,1,4,5,2,1428,1440
E01022431,1,10,24,26,1985,2046
E01022447,12,39,44,52,1383,1530
E01022420,1,1,13,11,2098,2124
E01022448,1,7,9,15,1325,1357
E01022454,2,3,23,33,1875,1936
E01022421,5,7,24,37,1682,1755
E01022422,0,8,21,19,1591,1639
E01022423,11,15,26,31,1832,1915
E01022424,2,13,23,17,1609,1664
E01022446,5,21,12,28,1680,1746
E01029022,0,3,9,2,1327,1341
E01029023,1,5,10,4,1173,1193
E01029044,0,1,14,4,1314,1333
E01029053,1,3,27,10,2234,2275
E01029057,2,5,26,10,1998,2041
E01029024,1,3,17,10,2031,2062
E01029025,0,4,4,7,1299,1314
E01029026,0,3,4,0,992,999
E01029068,3,6,21,13,1493,1536
E01029069,1,1,9,3,1046,1060
E01029030,1,0,8,11,1919,1939
E01029031,0,3,4,17,1631,1655
E01029032,0,0,3,2,1013,1018
E01029033,0,1,12,8,1412,1433
E01029034,1,3,15,22,1332,1373
E01029036,2,16,23,30,1540,1611
E01029041,0,6,25,38,1932,2001
E01029042,1,7,29,24,1487,1548
E01029043,0,2,18,5,1515,1540
E01029045,1,5,20,11,1528,1565
E01029052,1,0,8,2,2101,2112
E01029060,0,1,13,1,1935,1950
E01029061,1,0,13,9,2213,2236
E01029083,2,5,21,46,1293,1367
E01029018,1,3,18,13,2328,2363
E01029056,1,4,27,14,2292,2338
E01029064,2,9,18,28,1531,1588
E01029084,0,3,9,12,1479,1503
E01029029,0,4,16,8,1666,1694
E01029035,1,1,15,21,1489,1527
E01029037,2,3,23,10,1344,1382
E01029038,0,4,21,13,1347,1385
E01029039,0,4,3,12,1540,1559
E01029040,0,1,10,13,1616,1640
E01029078,2,1,22,19,1700,1744
E01029079,0,1,6,20,1497,1524
E01029080,1,0,13,17,1451,1482
E01029081,0,3,10,17,1541,1571
E01029082,2,3,10,13,1317,1345
E01029062,5,3,12,17,1378,1415
E01029063,1,7,20,20,2442,2490
E01029065,1,1,11,6,1645,1664
E01029066,0,3,11,23,1719,1756
E01029067,0,0,16,7,1433,1456
E01029020,2,3,10,4,1468,1487
E01029021,0,4,3,1,1230,1238
E01029027,0,1,0,7,1187,1195
E01029028,2,0,10,24,1103,1139
E01029058,5,2,11,13,2268,2299
E01029046,4,2,22,11,1372,1411
E01029050,0,2,39,12,2167,2220
E01029051,2,3,15,6,1529,1555
E01032627,2,6,30,21,2189,2248
E01029047,0,1,14,25,1458,1498
E01029054,0,0,13,3,1525,1541
E01029055,0,0,6,3,1227,1236
E01029074,18,21,46,75,1962,2122
E01029076,0,2,12,11,2034,2059
E01029019,3,0,15,5,2334,2357
E01029059,2,1,13,8,2054,2078
E01029077,2,4,8,2,2028,2044
E01029070,1,2,28,28,1766,1825
E01029071,2,5,17,29,1475,1528
E01029072,2,0,10,10,1617,1639
E01029073,1,9,20,20,1199,1249
E01029075,1,1,10,19,1352,1383
E01029085,1,3,26,27,2000,2057
E01029126,0,0,10,10,1495,1515
E01029127,1,1,8,17,1477,1504
E01029128,1,0,10,12,1860,1883
E01029129,0,1,16,9,1914,1940
E01029089,7,2,15,11,2227,2262
E01029113,0,1,10,10,1620,1641
E01029115,3,1,7,5,1649,1665
E01029140,4,10,28,13,2852,2907
E01032633,2,1,20,8,2138,2169
E01029086,3,0,16,5,2180,2204
E01029147,3,5,12,10,1706,1736
E01029148,4,2,17,2,1557,1582
E01029149,2,8,12,8,1448,1478
E01029114,2,2,8,5,1519,1536
E01029116,4,9,14,22,1528,1577
E01029117,2,5,15,42,1542,1606
E01029119,3,5,10,17,1544,1579
E01029120,0,2,7,16,1484,1509
E01029118,1,4,12,9,1769,1795
E01029131,0,3,33,33,1966,2035
E01029132,0,2,12,11,1448,1473
E01029133,1,2,10,13,1266,1292
E01029134,0,2,6,7,1853,1868
E01029135,1,0,5,2,1619,1627
E01029136,1,0,10,8,1952,1971
E01029145,0,1,8,4,1955,1968
E01029152,0,2,18,1,2094,2115
E01029121,1,0,7,1,1285,1294
E01029122,4,1,16,0,1464,1485
E01029123,1,0,9,2,1104,1116
E01029124,2,0,6,3,1714,1725
E01029125,0,0,4,6,1361,1371
E01029093,5,1,22,15,1554,1597
E01029096,2,1,22,9,1401,1435
E01029106,3,0,17,5,1615,1640
E01029107,0,0,12,22,1468,1502
E01029109,0,2,8,0,1395,1405
E01029094,2,4,11,15,1585,1617
E01029095,10,9,15,35,1512,1581
E01029110,2,6,29,13,2101,2151
E01029111,1,1,22,29,2467,2520
E01029112,3,9,20,33,1811,1876
E01029090,1,1,9,8,1506,1525
E01029091,1,2,12,10,1602,1627
E01029092,0,1,6,3,1536,1546
E01029108,2,0,9,9,2054,2074
E01029102,3,2,6,7,1486,1504
E01029103,2,1,4,17,1549,1573
E01029104,1,1,6,11,1504,1523
E01032631,0,1,15,21,1314,1351
E01032632,0,0,7,3,1255,1265
E01032634,0,0,8,6,1243,1257
E01029130,1,1,11,3,2114,2130
E01029137,1,2,11,1,1542,1557
E01029138,0,0,10,4,1411,1425
E01029139,2,0,14,5,1461,1482
E01029150,4,1,7,4,1275,1291
E01029151,0,0,7,2,1253,1262
E01029097,0,0,6,5,1419,1430
E01029098,6,5,10,14,1358,1393
E01029099,2,2,15,10,1319,1348
E01029100,0,2,13,4,1343,1362
E01029105,0,1,22,19,1454,1496
E01029101,1,1,11,7,1117,1137
E01029142,1,1,7,6,1471,1486
E01029143,3,0,18,6,1356,1383
E01029144,1,0,7,0,1247,1255
E01032629,5,1,8,10,1477,1501
E01032630,1,6,15,15,1559,1596
E01029157,2,5,8,25,1316,1356
E01029158,2,11,26,12,1500,1551
E01029221,1,6,15,32,2388,2442
E01029166,0,2,11,5,2252,2270
E01029167,1,7,11,3,1598,1620
E01029168,7,4,12,14,1575,1612
E01029210,4,3,6,6,1610,1629
E01029211,1,0,2,8,1365,1376
E01029224,0,8,9,8,1579,1604
E01029225,0,0,4,7,2096,2107
E01029226,1,7,13,11,1659,1691
E01029200,1,3,21,11,1394,1430
E01029201,0,3,5,11,1423,1442
E01029222,2,0,5,1,1615,1623
E01029223,2,0,7,3,1195,1207
E01029155,2,3,8,6,1766,1785
E01029227,0,1,10,9,1618,1638
E01029228,0,0,10,8,1624,1642
E01029229,9,1,20,40,1922,1992
E01029164,0,3,8,6,1508,1525
E01029165,1,1,5,7,1203,1217
E01029198,2,3,12,13,1276,1306
E01029199,6,16,20,14,2957,3013
E01029187,1,2,6,4,1011,1024
E01029188,1,3,1,1,1497,1503
E01029196,3,1,10,6,1479,1499
E01029197,0,1,13,5,1254,1273
E01029154,4,4,13,4,1789,1814
E01029156,1,1,12,11,1826,1851
E01029206,1,0,9,5,1447,1462
E01029207,3,0,6,1,1330,1340
E01029202,0,1,5,10,1164,1180
E01029203,0,1,12,9,1496,1518
E01029204,1,0,15,4,1224,1244
E01029205,6,7,21,9,1739,1782
E01029163,0,1,15,7,2188,2211
E01029216,3,0,8,5,1432,1448
E01029217,0,0,9,5,1500,1514
E01029218,2,6,10,5,1881,1904
E01029238,2,1,12,8,1519,1542
E01029252,6,5,9,19,1384,1423
E01029253,3,6,25,7,1484,1525
E01029254,1,2,13,8,1361,1385
E01029160,7,13,32,60,2547,2659
E01029248,2,8,13,24,1541,1588
E01029250,0,0,13,25,1325,1363
E01029251,1,1,7,7,1291,1307
E01029161,4,10,13,28,1542,1597
E01029162,3,2,17,28,1468,1518
E01029247,6,6,21,7,1587,1627
E01029255,0,9,13,9,1364,1395
E01029231,4,5,11,107,1437,1564
E01029233,2,0,9,57,1320,1388
E01029235,1,4,19,12,1369,1405
E01029236,0,2,11,17,1489,1519
E01029237,0,2,9,16,1454,1481
E01029232,1,10,14,112,1390,1527
E01029234,3,13,22,71,1723,1832
E01029239,5,5,16,49,1408,1483
E01029240,4,1,12,14,1519,1550
E01029241,8,10,14,21,1848,1901
E01029245,6,12,27,24,2180,2249
E01029246,1,0,10,13,1496,1520
E01029249,1,2,11,13,1324,1351
E01029189,0,2,10,1,1137,1150
E01029190,3,2,8,6,1252,1271
E01029191,0,2,13,3,1231,1249
E01029192,1,2,8,1,1450,1462
E01029212,0,0,3,2,1042,1047
E01029213,0,1,4,1,1283,1289
E01029214,0,3,11,3,1137,1154
E01029215,0,2,4,2,1145,1153
E01029159,4,0,5,8,1517,1534
E01029242,0,7,6,20,1455,1488
E01029243,7,0,4,9,1620,1640
E01029244,6,8,13,11,1482,1520
E01029193,0,5,16,11,1920,1952
E01029194,2,6,23,18,2461,2510
E01029195,3,8,2,3,1539,1555
E01029208,0,1,6,2,1121,1130
E01029209,3,0,6,2,1287,1298
E01029178,0,4,8,6,1452,1470
E01029179,0,1,7,1,1106,1115
E01029180,3,1,13,1,1386,1404
E01029181,0,1,7,12,1301,1321
E01029182,1,1,3,4,1454,1463
E01029183,0,4,6,2,1455,1467
E01029184,1,2,3,12,1755,1773
E01029185,0,0,7,33,1614,1654
E01029186,0,6,14,14,1435,1469
E01029169,6,1,9,18,1495,1529
E01029172,1,1,1,2,1491,1496
E01029173,0,2,6,3,1236,1247
E01029176,1,6,13,3,1253,1276
E01029177,2,6,11,15,1122,1156
E01029170,0,6,13,5,1086,1110
E01029171,0,3,24,12,2031,2070
E01029174,0,0,9,9,1070,1088
E01029175,2,13,30,27,2030,2102
E01029153,0,2,19,4,2309,2334
E01029219,0,2,7,4,1434,1447
E01029220,0,0,5,4,1204,1213
E01029230,2,2,15,8,2266,2293
E01029258,1,2,9,4,1448,1464
E01029259,1,6,4,4,1471,1486
E01029260,3,10,23,9,2264,2309
E01029268,2,2,10,1,1555,1570
E01029276,5,23,22,87,1496,1633
E01029278,0,2,7,7,1317,1333
E01029290,2,6,17,23,1367,1415
E01029306,5,1,19,12,1533,1570
E01029319,1,5,19,18,1474,1517
E01029267,2,2,13,2,1683,1702
E01029320,1,0,20,15,1552,1588
E01029321,0,2,14,8,2288,2312
E01029297,5,2,11,34,1217,1269
E01029298,3,5,9,10,1471,1498
E01029304,2,8,17,4,1498,1529
E01029305,1,1,20,6,1361,1389
E01029307,0,7,7,8,1434,1456
E01029271,1,2,20,11,1742,1776
E01029273,0,0,7,1,1235,1243
E01029274,0,4,8,3,1482,1497
E01029275,1,0,10,6,1251,1268
E01029279,0,1,4,1,1444,1450
E01029282,3,3,11,28,1340,1385
E01029291,1,2,7,8,1562,1580
E01029294,1,3,13,9,1766,1792
E01029317,3,1,10,17,1232,1263
E01029318,0,0,5,10,1509,1524
E01029285,6,13,40,102,2187,2348
E01029287,5,6,23,25,1449,1508
E01029288,3,8,18,22,1484,1535
E01029289,8,9,24,22,1800,1863
E01029299,4,5,11,29,1452,1501
E01029300,2,7,17,18,1506,1550
E01029256,1,7,3,20,1415,1446
E01029257,5,7,23,71,2068,2174
E01029277,4,0,11,20,1003,1038
E01032651,2,1,50,21,1812,1886
E01032652,4,7,16,7,1126,1160
E01029280,3,7,19,18,1566,1613
E01029281,2,6,11,27,1637,1683
E01029283,2,1,22,17,1734,1776
E01029292,0,0,22,44,1369,1435
E01029293,0,1,23,5,1628,1657
E01029266,11,7,15,129,1213,1375
E01029284,4,4,21,85,1600,1714
E01029286,7,13,25,39,1578,1662
E01029301,6,5,27,58,1823,1919
E01029303,2,3,17,33,1836,1891
E01029263,1,2,12,52,1337,1404
E01029264,4,1,9,30,1250,1294
E01029265,4,0,9,18,1359,1390
E01029302,9,12,27,77,1570,1695
E01029308,0,4,18,15,2035,2072
E01029309,7,9,18,48,1914,1996
E01029311,1,4,11,26,1442,1484
E01029312,0,0,7,12,1401,1420
E01029313,2,1,9,5,1338,1355
E01029316,0,7,17,37,1576,1637
E01029262,2,2,12,10,2311,2337
E01029269,2,1,10,15,2156,2184
E01029310,1,6,5,41,1816,1869
E01029314,0,10,24,11,2564,2609
E01029315,2,0,5,3,1442,1452
E01029261,2,6,19,8,2029,2064
E01029270,1,2,10,8,2143,2164
E01029295,4,1,9,23,1591,1628
E01029296,0,1,5,11,1564,1581
E01029324,4,0,11,10,1578,1603
E01029329,5,3,13,14,1745,1780
E01029330,2,3,20,39,1958,2022
E01032636,1,0,15,39,1867,1922
E01029322,2,5,20,3,1989,2019
E01029331,0,1,8,3,1446,1458
E01029333,0,1,5,4,1167,1177
E01029336,3,0,4,2,2065,2074
E01029326,0,0,4,4,1150,1158
E01029334,0,0,9,2,1100,1111
E01029339,0,0,5,5,1488,1498
E01029341,4,1,8,4,1274,1291
E01032635,0,3,11,8,2138,2160
E01029327,1,1,12,7,2008,2029
E01029335,0,0,9,5,1071,1085
E01029337,0,0,5,1,2115,2121
E01029342,2,0,2,1,1083,1088
E01029343,1,0,10,15,1507,1533
E01029325,1,0,14,5,1824,1844
E01029328,1,2,11,15,1898,1927
E01029338,0,0,12,6,1757,1775
W01000003,1,4,12,15,2475,2507
W01000004,2,1,8,4,1267,1282
W01000018,0,0,7,3,1347,1357
W01000028,0,0,14,4,1923,1941
W01000031,3,0,3,3,1536,1545
W01000010,1,0,7,1,1860,1869
W01000020,1,1,3,1,1309,1315
W01000021,3,7,13,3,2238,2264
W01000032,1,2,6,0,1055,1064
W01000016,0,10,9,25,1159,1203
W01000017,3,1,13,6,1502,1525
W01000029,2,2,13,13,1463,1493
W01000030,3,0,31,8,2244,2286
W01000033,5,1,12,7,1479,1504
W01000036,11,0,15,8,1054,1088
W01000037,1,1,6,0,1170,1178
W01000022,8,1,6,2,1631,1648
W01000034,0,0,4,5,1145,1154
W01000039,0,0,4,3,1053,1060
W01000040,1,0,4,3,1160,1168
W01000043,2,2,9,5,1199,1217
W01000044,0,0,8,2,1134,1144
W01000005,4,5,10,7,1912,1938
W01000013,13,3,25,23,2190,2254
W01000019,1,2,6,1,1503,1513
W01000026,2,4,7,1,1215,1229
W01000035,2,1,21,8,1837,1869
W01000006,0,0,10,5,1519,1534
W01000012,2,0,14,7,1461,1484
W01000014,7,0,14,12,2016,2049
W01000041,0,2,8,11,1562,1583
W01000001,1,3,8,5,1098,1115
W01000002,1,0,6,2,1254,1263
W01000009,6,5,10,9,1873,1903
W01000023,0,0,4,9,1393,1406
W01000024,6,3,13,9,1488,1519
W01000008,22,0,7,50,1440,1519
W01000011,13,2,17,74,1124,1230
W01000015,0,1,11,42,1534,1588
W01000042,43,5,24,65,2009,2146
W01000007,2,0,5,3,1694,1704
W01000025,3,2,16,15,1980,2016
W01000027,3,5,11,8,1824,1851
W01000038,0,5,26,4,2191,2226
W01000062,133,30,37,230,1409,1839
W01000076,19,4,28,46,1219,1316
W01000077,69,15,12,119,1172,1387
W01000091,10,9,20,28,1073,1140
W01000092,80,55,91,552,3350,4128
W01000064,92,8,23,135,1591,1849
W01000072,39,2,21,117,1598,1777
W01000075,26,16,25,117,1312,1496
W01000090,9,1,14,34,1368,1426
W01000102,57,21,13,152,974,1217
W01000050,9,1,13,7,1368,1398
W01000071,5,1,37,18,2319,2380
W01000096,4,5,9,11,1216,1245
W01000097,3,0,13,3,1091,1110
W01000115,2,1,29,1,2185,2218
W01000052,1,2,11,1,1156,1171
W01000053,12,1,10,1,1195,1219
W01000087,8,1,9,3,1895,1916
W01000119,93,5,9,44,2133,2284
W01000063,4,1,9,4,1891,1909
W01000081,3,2,21,9,1991,2026
W01000099,2,2,10,5,1749,1768
W01000103,30,6,13,39,1145,1233
W01000059,3,0,15,26,2016,2060
W01000093,2,1,7,27,2159,2196
W01000098,0,5,18,18,2280,2321
W01000110,2,4,8,25,1467,1506
W01000054,12,1,7,4,1138,1162
W01000088,3,0,5,3,1983,1994
W01000111,6,0,21,29,1476,1532
W01000118,0,1,6,6,1663,1676
W01000073,0,0,3,7,1685,1695
W01000086,2,3,11,3,2234,2253
W01000104,0,6,11,4,1772,1793
W01000112,8,1,9,37,1875,1930
W01000056,6,6,8,9,1849,1878
W01000065,10,1,7,4,1104,1126
W01000113,9,1,4,6,1851,1871
W01000114,7,3,6,5,1583,1604
W01000066,0,1,9,5,1204,1219
W01000100,0,6,1,1,1046,1054
W01000105,8,2,9,17,1739,1775
W01000106,4,0,20,17,1691,1732
W01000107,0,1,1,9,1246,1257
W01000047,0,0,11,16,1327,1354
W01000061,3,2,7,14,1727,1753
W01000078,2,0,5,0,1676,1683
W01000089,0,0,7,2,2071,2080
W01000070,2,1,9,2,1261,1275
W01000094,0,0,4,0,1225,1229
W01000095,0,1,12,0,1360,1373
W01000108,2,0,15,9,2164,2190
W01000109,1,1,17,7,1860,1886
W01000069,0,0,11,2,1527,1540
W01000074,0,3,23,23,1948,1997
W01000079,2,3,9,1,1083,1098
W01000101,1,1,8,6,1517,1533
W01000080,17,4,24,12,1728,1785
W01000084,8,6,5,4,1183,1206
W01001932,22,2,14,6,2887,2931
W01000051,2,1,14,5,1952,1974
W01000060,1,1,6,4,1333,1345
W01000082,0,0,4,1,1090,1095
W01000083,0,1,4,6,1282,1293
W01000048,7,1,15,16,1341,1380
W01000049,6,5,17,5,1109,1142
W01000057,1,2,11,5,1425,1444
W01000067,0,2,10,8,1184,1204
W01000068,7,0,6,16,1455,1484
W01000085,1,16,7,14,1969,2007
W01000116,0,0,6,18,1661,1685
W01000117,1,0,6,19,1553,1579
W01001933,0,4,14,11,2214,2243
W01000132,24,3,27,50,1433,1537
W01000146,17,16,40,48,2133,2254
W01000147,2,1,15,15,1460,1493
W01000169,6,6,31,38,1774,1855
W01000186,6,4,13,14,1674,1711
W01000133,2,1,14,23,1847,1887
W01000168,4,1,23,9,1747,1784
W01000187,7,6,12,23,1513,1561
W01000188,19,1,11,27,1678,1736
W01000154,1,0,4,7,1463,1475
W01000173,8,1,9,10,1521,1549
W01000174,14,5,15,18,1650,1702
W01000175,6,2,11,17,1596,1632
W01000155,22,3,8,18,1498,1549
W01000156,3,3,15,19,1477,1517
W01000157,5,3,22,8,1427,1465
W01000158,7,1,9,12,1558,1587
W01000149,0,8,11,30,1441,1490
W01000150,1,0,7,15,1486,1509
W01000151,1,3,13,28,1544,1589
W01000152,1,5,10,15,1461,1492
W01000184,0,7,9,12,2352,2380
W01000135,3,0,15,28,2035,2081
W01000136,0,7,27,32,1789,1855
W01000165,1,1,9,12,1907,1930
W01000166,5,5,16,10,1913,1949
W01000139,11,3,11,28,1668,1721
W01000143,6,2,8,64,1463,1543
W01000144,12,3,29,32,1440,1516
W01000182,10,14,18,46,1830,1918
W01000138,3,0,11,15,1797,1826
W01000145,1,0,16,16,1248,1281
W01000180,24,15,16,46,1581,1682
W01000181,27,1,12,39,1477,1556
W01000183,10,3,15,58,1399,1485
W01000126,1,3,16,10,1686,1716
W01000127,4,0,11,5,1347,1367
W01000128,2,2,17,13,1449,1483
W01000153,0,2,13,17,1510,1542
W01000163,1,2,10,5,1319,1337
W01000164,2,4,6,9,1385,1406
W01000140,2,0,9,14,1441,1466
W01000141,0,0,21,19,1502,1542
W01000142,4,1,11,43,1544,1603
W01000178,1,2,13,32,1853,1901
W01000179,1,0,5,8,1590,1604
W01001927,5,1,5,8,1312,1331
W01001928,1,2,8,5,1114,1130
W01000167,2,1,13,31,1876,1923
W01000176,4,2,13,20,1567,1606
W01000177,1,1,5,6,1224,1237
W01001926,4,9,13,10,2160,2196
W01000124,2,2,12,1,1990,2007
W01000129,2,0,0,0,1062,1064
W01000130,4,2,22,18,1491,1537
W01000131,4,3,6,7,1444,1464
W01000123,0,1,8,15,1791,1815
W01000125,0,3,9,2,1471,1485
W01000170,2,2,21,4,1793,1822
W01000171,3,3,11,8,1557,1582
W01000172,0,2,12,3,1269,1286
W01000122,7,6,4,14,2091,2122
W01000159,1,0,9,7,1418,1435
W01000162,2,1,3,5,1914,1925
W01000190,0,1,2,3,1393,1399
W01000121,1,0,4,5,1234,1244
W01000134,1,2,19,10,2086,2118
W01000137,0,3,4,1,1529,1537
W01000148,0,0,6,0,1199,1205
W01000185,1,1,10,5,1212,1229
W01000189,0,1,11,7,1446,1465
W01000218,0,4,6,33,1503,1546
W01000219,2,5,33,39,2487,2566
W01000220,6,1,5,11,1581,1604
W01000213,2,1,4,21,1315,1343
W01000214,6,6,14,24,1121,1171
W01000215,6,4,15,17,1393,1435
W01000216,3,0,23,11,1372,1409
W01000212,0,2,13,31,2143,2189
W01000221,0,8,13,14,1313,1348
W01000222,0,2,6,1,1651,1660
W01000226,0,0,9,8,1498,1515
W01000227,1,11,8,12,1524,1556
W01000228,4,2,11,9,1120,1146
W01000239,10,5,24,114,1628,1781
W01000240,0,5,24,53,1234,1316
W01000241,1,4,23,55,1206,1289
W01000236,8,7,11,86,1763,1875
W01000237,0,0,18,50,1738,1806
W01000238,3,1,13,63,1622,1702
W01000200,3,0,9,5,1266,1283
W01000201,1,1,16,9,1471,1498
W01000217,1,1,8,18,2038,2066
W01000248,3,6,9,8,1623,1649
W01000191,5,3,12,115,2012,2147
W01000223,0,0,11,14,1300,1325
W01000224,0,0,12,9,1381,1402
W01000225,2,2,4,7,1513,1528
W01000245,2,1,16,22,1633,1674
W01000246,1,3,7,9,1661,1681
W01000247,7,3,14,30,1916,1970
W01000194,5,7,24,70,2016,2122
W01000198,1,2,6,9,1457,1475
W01000199,2,7,9,9,1663,1690
W01000195,1,0,7,9,1362,1379
W01000196,5,1,6,37,1457,1506
W01000197,0,6,11,24,1635,1676
W01000211,1,1,6,9,1839,1856
W01000203,2,1,14,11,2428,2456
W01000204,1,0,12,0,1408,1421
W01000206,5,4,17,10,2120,2156
W01000242,2,1,13,32,1858,1906
W01000243,5,5,20,112,1681,1823
W01000244,5,0,11,4,1712,1732
W01000193,5,0,9,1,1299,1314
W01000202,1,1,15,3,1666,1686
W01000207,2,3,21,15,2186,2227
W01000192,1,2,8,4,996,1011
W01000205,0,3,12,4,1103,1122
W01000208,3,0,14,8,1204,1229
W01000209,6,0,13,6,1471,1496
W01000210,0,2,18,4,1330,1354
W01000229,1,0,21,15,1569,1606
W01000230,2,6,24,13,1918,1963
W01000231,1,7,5,44,1375,1432
W01000232,3,7,14,13,1568,1605
W01000233,0,1,7,14,1254,1276
W01000234,1,5,13,39,1347,1405
W01000235,0,1,10,13,1306,1330
W01000287,2,2,11,17,1776,1808
W01000298,4,2,5,1,1515,1527
W01000338,1,3,10,4,1820,1838
W01000306,1,4,18,28,2348,2399
W01000320,1,0,8,2,1833,1844
W01000340,3,0,7,12,2300,2322
W01000253,2,1,9,10,1919,1941
W01000254,1,0,14,2,2207,2224
W01000296,0,3,3,11,1489,1506
W01000297,2,1,14,4,1214,1235
W01000304,3,1,10,28,1946,1988
W01000305,2,2,8,11,1735,1758
W01000288,3,3,26,38,2194,2264
W01000290,6,4,9,17,1233,1269
W01000292,7,1,6,4,1465,1483
W01000293,2,1,7,7,1551,1568
W01000289,0,0,1,2,1355,1358
W01000291,1,1,7,10,1382,1401
W01000294,0,1,7,8,1921,1937
W01000295,2,0,2,22,1647,1673
W01000258,2,2,4,2,2143,2153
W01000270,0,0,1,4,1281,1286
W01000271,0,1,3,5,1274,1283
W01000272,4,1,9,7,1853,1874
W01000301,2,0,10,1,1772,1785
W01000273,3,3,11,18,1550,1585
W01000274,0,1,17,18,1735,1771
W01000275,3,0,6,10,1234,1253
W01000278,0,0,16,3,1476,1495
W01000276,1,0,12,14,1366,1393
W01000277,4,0,12,9,1338,1363
W01000279,0,0,4,11,1249,1264
W01000281,4,0,3,5,1210,1222
W01000283,4,1,14,6,2234,2259
W01000332,5,0,11,32,1520,1568
W01000333,3,2,13,19,1391,1428
W01000334,4,3,9,41,1901,1958
W01000335,0,3,4,19,1085,1111
W01000336,0,6,12,21,1426,1465
W01000337,1,1,20,56,2051,2129
W01000252,0,1,9,23,1598,1631
W01000280,1,1,5,4,1415,1426
W01000282,0,0,16,12,1715,1743
W01000325,3,2,5,6,1514,1530
W01000311,0,2,4,9,1767,1782
W01000312,2,0,7,18,1687,1714
W01000328,3,2,17,34,2053,2109
W01000264,0,8,13,9,1671,1701
W01000265,0,4,4,3,1301,1312
W01000323,0,0,11,15,1519,1545
W01000324,2,0,5,9,1488,1504
W01000251,2,0,8,14,1462,1486
W01000268,2,1,2,3,1759,1767
W01000284,8,3,10,29,1658,1708
W01000285,1,1,11,22,1438,1473
W01000286,4,2,14,48,2171,2239
W01000302,1,10,15,18,1843,1887
W01000249,0,2,1,2,1253,1258
W01000250,2,2,6,4,1564,1578
W01000261,0,0,4,16,1529,1549
W01000321,3,3,5,2,1646,1659
W01000322,0,1,1,4,1336,1342
W01000255,2,1,21,25,2243,2292
W01000256,2,1,15,21,1522,1561
W01000257,0,5,19,18,2079,2121
W01000329,1,3,10,30,1329,1373
W01000330,0,3,22,47,2078,2150
W01000331,1,2,7,10,1589,1609
W01000313,3,1,5,19,1538,1566
W01000314,0,2,8,22,1097,1129
W01000315,3,0,8,18,1977,2006
W01000316,0,0,6,13,1304,1323
W01000317,0,2,9,3,1379,1393
W01000318,0,2,15,9,1146,1172
W01000319,2,10,11,7,1439,1469
W01000259,1,0,8,10,1617,1636
W01000260,5,0,5,5,1794,1809
W01000262,0,1,8,15,1466,1490
W01000263,1,0,10,3,1474,1488
W01000266,1,0,10,14,1295,1320
W01000267,1,2,11,4,1575,1593
W01000303,4,0,15,8,1670,1697
W01000326,0,0,9,4,1664,1677
W01000327,0,2,6,13,2176,2197
W01000299,0,0,9,4,1929,1942
W01000300,1,0,3,2,1720,1726
W01000309,2,2,17,9,2105,2135
W01000339,2,1,11,2,1611,1627
W01000269,1,1,14,9,1594,1619
W01000307,0,0,2,0,1361,1363
W01000308,1,2,6,6,1227,1242
W01000310,0,0,5,8,1837,1850
W01000374,6,8,14,6,1352,1386
W01000375,2,16,23,29,1927,1997
W01000376,2,4,3,3,1378,1390
W01000391,2,0,2,1,1420,1425
W01000392,2,0,10,8,1700,1720
W01000377,7,6,15,21,1491,1540
W01000378,0,0,16,15,1293,1324
W01000379,1,10,22,8,1557,1598
W01000380,0,4,7,17,1414,1442
W01000351,2,0,9,12,2152,2175
W01000373,0,19,15,31,1766,1831
W01000400,1,9,11,21,1615,1657
W01000401,0,11,14,8,1758,1791
W01000347,6,15,14,25,2464,2524
W01000348,0,3,13,8,1433,1457
W01000362,0,1,5,16,1507,1529
W01000363,1,3,11,1,1508,1524
W01000364,6,5,10,13,1615,1649
W01000343,0,1,2,5,1046,1054
W01000344,2,2,7,20,1274,1305
W01000415,2,4,9,22,1447,1484
W01000416,0,5,6,17,1238,1266
W01000368,3,2,13,10,2008,2036
W01000371,1,16,18,121,1048,1204
W01000372,11,20,20,151,1284,1486
W01000387,0,4,5,3,1245,1257
W01000388,2,2,5,15,1041,1065
W01000422,1,0,13,19,2081,2114
W01000341,0,7,13,19,1543,1582
W01000342,5,9,20,18,1531,1583
W01000393,2,12,18,35,1883,1950
W01000352,0,2,15,34,956,1007
W01000353,0,10,28,36,1312,1386
W01000413,0,11,20,19,1372,1422
W01000414,4,32,16,20,1191,1263
W01000425,4,33,13,35,2238,2323
W01000349,8,13,15,59,1758,1853
W01000350,10,14,35,339,1197,1595
W01000365,7,19,22,119,2033,2200
W01000402,19,33,28,291,2277,2648
W01000381,0,7,14,29,1080,1130
W01000382,3,15,8,19,1030,1075
W01000423,7,27,14,53,2131,2232
W01000424,3,11,6,26,1218,1264
W01001929,1,13,26,40,1223,1303
W01001931,3,12,22,42,1289,1368
W01000398,0,2,9,11,1292,1314
W01000399,1,1,1,5,1150,1158
W01000406,9,7,23,6,2160,2205
W01000408,11,3,7,3,1160,1184
W01000366,12,3,7,34,1398,1454
W01000367,4,1,7,18,1282,1312
W01000385,2,5,12,25,1706,1750
W01000410,2,4,9,8,1624,1647
W01000386,8,1,11,22,1474,1516
W01000405,3,7,11,29,2285,2335
W01000411,0,15,5,10,1569,1599
W01000412,2,6,10,16,1562,1596
W01000394,2,2,3,7,1265,1279
W01000395,0,5,2,5,1080,1092
W01000407,1,3,8,7,1330,1349
W01000419,0,24,9,14,1492,1539
W01000420,0,15,9,18,1344,1386
W01000354,5,0,5,8,1713,1731
W01000355,1,2,10,4,1597,1614
W01000356,5,0,7,0,1717,1729
W01000389,0,3,18,13,2025,2059
W01000409,2,35,21,22,1897,1977
W01000345,0,2,3,11,1567,1583
W01000346,1,0,5,2,1588,1596
W01000403,0,0,5,1,1321,1327
W01000404,1,2,9,12,1964,1988
W01000359,0,2,9,3,1163,1177
W01000360,0,1,5,7,1242,1255
W01000361,1,4,19,5,2007,2036
W01001930,2,0,8,6,2163,2179
W01000369,1,0,3,5,1261,1270
W01000370,1,0,14,25,1420,1460
W01000383,12,9,9,36,2375,2441
W01000384,0,1,4,5,1103,1113
W01000390,4,2,4,5,1654,1669
W01000396,2,5,21,13,1194,1235
W01000397,5,2,15,10,1013,1045
W01000417,1,1,17,22,1527,1568
W01000418,4,0,11,9,1639,1663
W01000461,0,0,9,6,1517,1532
W01000470,0,3,2,15,1860,1880
W01000475,0,0,7,3,2361,2371
W01001906,0,0,9,3,1904,1916
W01001907,1,3,11,6,1394,1415
W01000444,0,2,13,2,2302,2319
W01000457,5,1,7,0,2178,2191
W01000458,1,0,6,12,1770,1789
W01000498,2,4,7,15,1510,1538
W01000499,3,1,6,8,1272,1290
W01000500,0,1,12,12,1511,1536
W01000501,5,5,20,15,2255,2300
W01000442,0,0,5,1,2034,2040
W01000452,3,0,7,5,1916,1931
W01000473,1,0,20,13,2201,2235
W01000428,0,1,3,1,1329,1334
W01000441,0,1,4,2,1419,1426
W01000476,2,5,4,2,1282,1295
W01000497,0,5,5,2,1418,1430
W01000433,0,1,9,0,2306,2316
W01000460,4,3,7,2,1794,1810
W01000488,2,5,18,9,2146,2180
W01000434,2,0,13,16,1660,1691
W01000439,1,0,8,2,1961,1972
W01000447,0,1,9,4,2043,2057
W01000480,3,4,19,38,2005,2069
W01000481,1,1,12,29,2224,2267
W01000482,0,0,15,17,1812,1844
W01000478,1,1,33,10,1710,1755
W01000479,1,1,26,5,1490,1523
W01000483,1,4,5,2,1887,1899
W01000429,1,4,1,5,2283,2294
W01000453,2,0,3,5,1395,1405
W01000466,2,3,4,2,1414,1425
W01000467,2,4,7,5,1486,1504
W01000427,0,0,5,6,1400,1411
W01000448,0,0,7,2,1397,1406
W01000449,0,0,7,6,1588,1601
W01000464,5,3,15,3,1229,1255
W01000484,0,1,4,7,1550,1562
W01000485,3,1,11,6,1526,1547
W01000486,1,4,8,4,1146,1163
W01000438,0,2,7,1,1229,1239
W01000451,2,1,0,4,1122,1129
W01000472,0,0,2,5,1134,1141
W01000477,3,1,4,2,1455,1465
W01000487,0,4,8,12,2064,2088
W01000454,1,1,13,15,1197,1227
W01000455,5,1,17,22,2014,2059
W01000456,2,0,20,12,1989,2023
W01000431,1,4,11,14,1305,1335
W01000432,0,2,2,7,1222,1233
W01000450,0,2,7,3,1374,1386
W01000459,0,0,5,5,1196,1206
W01000471,0,2,20,10,1843,1875
W01000430,2,0,1,11,1268,1282
W01000443,2,2,7,6,2282,2299
W01000445,3,1,6,2,1515,1527
W01000446,1,0,6,6,1585,1598
W01000494,4,0,13,5,1702,1724
W01000489,6,1,8,82,1700,1797
W01000492,4,0,21,53,1513,1591
W01000493,11,9,25,211,1264,1520
W01001901,1,0,8,106,1815,1930
W01001902,2,4,11,15,1380,1412
W01000465,1,1,8,14,1012,1036
W01001903,1,1,12,43,2006,2063
W01001904,4,1,12,52,1668,1737
W01001905,1,3,16,23,2063,2106
W01000440,0,0,3,2,1345,1350
W01000474,1,2,11,6,1683,1703
W01000503,0,1,5,3,1029,1038
W01001897,0,2,9,4,1908,1923
W01000426,0,1,4,2,1417,1424
W01000496,0,1,9,14,2094,2118
W01000502,1,5,13,14,2038,2071
W01000504,0,1,6,10,1144,1161
W01000505,1,0,14,18,1350,1383
W01001899,0,3,13,20,2017,2053
W01000523,3,23,13,15,1856,1910
W01000548,6,4,18,29,1844,1901
W01000549,2,4,6,32,1727,1771
W01001937,0,5,11,7,2055,2078
W01000512,19,19,48,66,1923,2075
W01000513,7,18,47,103,2296,2471
W01000517,11,14,32,57,1358,1472
W01001934,40,19,69,165,3687,3980
W01000515,3,1,28,33,1381,1446
W01000516,13,10,15,27,1611,1676
W01000518,13,2,24,32,1188,1259
W01001935,10,15,22,49,999,1095
W01001936,40,13,55,67,2110,2285
W01000506,2,4,8,6,1402,1422
W01000524,2,2,10,8,1952,1974
W01000538,7,4,19,3,1529,1562
W01000539,3,0,13,1,1205,1222
W01000540,0,1,5,5,1153,1164
W01000529,2,0,10,5,1599,1616
W01000532,0,5,8,9,1957,1979
W01000544,1,0,17,6,1058,1082
W01000545,3,1,10,8,2023,2045
W01000527,32,18,19,79,1362,1510
W01000528,24,3,24,15,1394,1460
W01000535,9,2,7,10,2009,2037
W01000537,2,4,11,12,1455,1484
W01000541,14,2,8,21,1809,1854
W01000507,0,2,7,5,1182,1196
W01000508,2,21,10,11,1134,1178
W01000509,2,1,8,28,1745,1784
W01000510,15,0,12,27,1172,1226
W01000511,0,3,20,15,1136,1174
W01000546,0,0,6,3,1119,1128
W01000547,0,2,4,2,1172,1180
W01000519,2,4,12,4,1605,1627
W01000522,0,0,5,0,1288,1293
W01000531,1,1,6,3,1824,1835
W01000533,7,0,3,2,1427,1439
W01000551,0,1,16,1,1292,1310
W01000525,16,13,16,80,1081,1206
W01000534,24,1,5,21,1490,1541
W01000536,2,3,3,5,1446,1459
W01000542,15,2,12,3,2177,2209
W01000543,12,6,13,7,1982,2020
W01000550,2,0,8,1,1202,1213
W01000552,10,13,13,11,2027,2074
W01000558,2,0,18,10,2028,2058
W01000559,2,4,9,3,1433,1451
W01000560,2,1,4,0,1200,1207
W01000561,2,0,5,5,1244,1256
W01000613,2,2,20,10,2184,2218
W01000562,1,0,9,4,1682,1696
W01000565,2,5,9,12,1845,1873
W01000566,9,0,2,3,1532,1546
W01000567,2,0,15,10,1961,1988
W01000597,0,0,3,7,1151,1161
W01000617,3,0,14,7,1463,1487
W01000579,0,1,11,7,2333,2352
W01000581,0,0,4,2,1458,1464
W01000612,0,0,6,10,1825,1841
W01000618,1,3,20,4,1849,1877
W01000582,0,2,16,8,1633,1659
W01000583,1,0,4,7,1433,1445
W01000611,3,0,4,35,1622,1664
W01000623,0,0,8,9,1956,1973
W01000568,6,15,7,72,2201,2301
W01000569,2,1,4,40,1280,1327
W01000570,5,4,15,29,1421,1474
W01000572,25,22,11,166,1626,1850
W01000571,12,6,22,47,2173,2260
W01000573,1,7,22,65,2401,2496
W01000586,3,8,21,20,2150,2202
W01000577,2,0,6,15,1575,1598
W01000585,0,1,2,5,1400,1408
W01000595,2,0,19,9,1893,1923
W01000596,3,9,8,12,1477,1509
W01000555,2,1,14,26,1373,1416
W01000556,0,1,2,0,1146,1149
W01000575,2,11,16,23,2465,2517
W01000614,0,1,1,3,1400,1405
W01000622,1,1,3,10,1521,1536
W01000554,1,0,11,3,1811,1826
W01000580,3,7,8,7,2311,2336
W01000598,4,7,12,10,2186,2219
W01000599,3,2,7,9,2129,2150
W01000587,6,4,19,43,1931,2003
W01000588,2,1,5,5,2144,2157
W01000593,2,1,26,43,2691,2763
W01000553,0,0,3,3,1226,1232
W01000563,6,2,1,8,1190,1207
W01000564,2,1,6,20,1182,1211
W01000576,2,1,8,33,2218,2262
W01000615,5,7,11,8,1504,1535
W01000616,1,1,8,32,1051,1093
W01000589,0,0,5,1,1146,1152
W01000590,0,2,2,6,1077,1087
W01000591,2,0,3,6,1176,1187
W01000592,1,0,12,3,1288,1304
W01000594,4,4,16,8,2222,2254
W01000600,5,5,15,21,1612,1658
W01000601,3,1,14,4,1522,1544
W01000602,11,2,18,13,1262,1306
W01000603,1,9,24,18,1845,1897
W01000604,1,1,10,11,1491,1514
W01000605,0,0,13,14,1807,1834
W01000557,0,1,9,2,1520,1532
W01000578,1,1,7,6,1656,1671
W01000584,1,1,12,19,2050,2083
W01000609,2,2,14,10,2380,2408
W01000574,1,1,10,7,1858,1877
W01000606,3,0,5,8,1634,1650
W01000607,2,0,14,15,2029,2060
W01000608,7,1,3,9,1414,1434
W01000610,3,4,9,16,1678,1710
W01000619,4,1,16,31,2060,2112
W01000620,24,2,4,24,976,1030
W01000621,3,1,19,21,1510,1554
W01000685,0,0,5,8,1576,1589
W01000686,2,0,1,7,1252,1262
W01000701,1,1,3,10,1574,1589
W01000702,0,0,8,9,1201,1218
W01000647,1,16,7,13,1481,1518
W01000650,1,3,7,16,1586,1613
W01000678,1,2,19,6,1393,1421
W01000679,0,1,9,32,1226,1268
W01000646,13,1,13,9,2178,2214
W01000688,2,7,10,8,1781,1808
W01000689,1,1,9,7,1601,1619
W01000728,2,0,8,0,2062,2072
W01000676,2,2,10,7,1511,1532
W01000677,0,3,13,2,1421,1439
W01000687,3,1,12,2,1911,1929
W01000709,3,5,9,6,2225,2248
W01000624,0,2,8,16,2289,2315
W01000682,0,0,3,5,1373,1381
W01000683,6,0,9,6,1038,1059
W01000684,7,5,11,14,1814,1851
W01000643,5,5,6,38,1635,1689
W01000644,6,7,19,45,1780,1857
W01000645,12,5,10,22,1648,1697
W01000648,1,2,9,9,1459,1480
W01000649,3,2,7,4,1522,1538
W01000637,10,5,8,24,1380,1427
W01000638,7,3,5,31,1147,1193
W01000639,5,7,8,18,1323,1361
W01000640,7,11,14,89,1040,1161
W01000641,9,9,24,78,1955,2075
W01000642,3,6,7,26,1683,1725
W01000693,0,0,0,2,1077,1079
W01000694,1,1,3,30,1267,1302
W01000656,0,12,8,15,2104,2139
W01000657,0,1,8,7,1062,1078
W01000658,1,0,9,9,1250,1269
W01000718,1,0,9,11,1403,1424
W01000719,1,0,15,6,1475,1497
W01000680,2,0,7,6,1996,2011
W01000681,0,2,9,11,1961,1983
W01000724,0,1,11,7,1893,1912
W01000725,0,6,6,14,2173,2199
W01000675,3,3,8,10,1939,1963
W01000695,2,2,9,7,1514,1534
W01000696,0,1,0,2,1565,1568
W01000722,1,0,4,15,1284,1304
W01000723,5,1,5,1,1358,1370
W01000625,0,0,8,23,1169,1200
W01000626,4,8,12,27,1411,1462
W01000627,4,1,15,2,2153,2175
W01000714,1,1,7,5,1438,1452
W01000715,2,1,13,15,1266,1297
W01000697,0,11,17,26,1780,1834
W01000698,1,4,10,14,1877,1906
W01000699,0,5,7,13,1505,1530
W01000712,6,3,7,11,1469,1496
W01000713,1,5,4,12,1371,1393
W01000662,0,0,8,14,2133,2155
W01000663,1,0,12,5,2243,2261
W01000664,4,5,10,2,1784,1805
W01000716,0,0,4,3,1330,1337
W01000717,0,1,2,1,1427,1431
W01000665,4,2,6,13,1755,1780
W01000666,2,2,5,3,1434,1446
W01000731,1,4,22,16,2395,2438
W01000670,3,4,6,8,1598,1619
W01000671,2,4,8,7,1883,1904
W01000729,1,0,0,4,1260,1265
W01000730,0,0,17,3,1256,1276
W01000690,1,2,9,18,1725,1755
W01000691,3,1,10,22,1555,1591
W01000692,9,7,4,33,1565,1618
W01000726,4,0,0,32,1490,1526
W01000727,0,0,3,7,1000,1010
W01000651,1,1,5,17,1564,1588
W01000652,8,8,10,89,1894,2009
W01000655,3,0,15,47,1989,2054
W01000632,1,0,6,4,1446,1457
W01000633,2,1,4,6,1399,1412
W01000634,1,0,6,7,1363,1377
W01000710,0,3,6,13,2249,2271
W01000711,0,2,13,8,2007,2030
W01000703,6,0,25,25,1807,1863
W01000704,0,1,7,20,1612,1640
W01000705,2,5,13,38,1896,1954
W01000653,5,0,7,17,1436,1465
W01000654,8,0,13,24,1693,1738
W01000667,1,2,9,10,1390,1412
W01001925,6,4,6,33,2284,2333
W01000628,0,0,6,26,1561,1593
W01000629,0,1,11,28,1691,1731
W01000630,3,1,12,19,1626,1661
W01000631,0,0,10,14,1752,1776
W01000635,7,1,9,17,2231,2265
W01000636,10,2,11,36,1883,1942
W01000706,0,2,12,17,1618,1649
W01000707,5,1,10,13,1444,1473
W01000708,0,8,10,29,1337,1384
W01000659,6,0,12,37,1487,1542
W01000660,3,2,11,19,1504,1539
W01000732,17,3,10,17,1343,1390
W01000733,3,2,11,36,1204,1256
W01000734,0,6,9,22,1396,1433
W01001923,9,3,13,19,1210,1254
W01001924,5,1,9,26,1292,1333
W01000672,1,0,10,3,1615,1629
W01000673,0,0,15,5,1202,1222
W01000674,0,2,20,4,2061,2087
W01000700,1,0,15,7,1983,2006
W01000720,3,0,8,9,1612,1632
W01000721,0,2,5,4,1352,1363
W01000735,4,2,21,13,2232,2272
W01000845,1,5,5,3,2034,2048
W01000846,3,7,11,25,1684,1730
W01000847,8,1,4,4,1289,1306
W01000848,0,0,12,3,1182,1197
W01000750,7,2,11,21,1511,1552
W01000751,5,1,6,5,1405,1422
W01000752,2,9,5,24,1478,1518
W01000753,1,5,18,16,1380,1420
W01000754,3,2,20,31,1535,1591
W01000803,1,0,17,13,1819,1850
W01000806,0,4,12,102,1397,1515
W01000807,1,4,14,44,1358,1421
W01000808,11,7,14,46,1387,1465
W01000810,12,29,11,104,1220,1376
W01000815,4,8,8,15,1564,1599
W01000816,30,18,11,193,1483,1735
W01000791,0,3,6,12,1483,1504
W01000792,4,0,12,9,1620,1645
W01000793,3,3,7,19,1858,1890
W01000837,9,11,11,74,1519,1624
W01000838,4,0,7,10,1223,1244
W01000773,6,10,20,40,2587,2663
W01000774,9,0,11,14,1604,1638
W01000841,1,1,12,23,1442,1479
W01000842,0,2,9,4,1409,1424
W01000843,2,0,13,14,1350,1379
W01000844,1,5,5,3,1227,1241
W01000795,1,6,14,23,1577,1621
W01000796,0,25,20,88,2590,2723
W01000800,1,0,12,15,1472,1500
W01000801,0,16,13,8,1511,1548
W01000784,1,1,6,5,1304,1317
W01000785,0,1,3,0,1312,1316
W01000786,0,2,12,6,1355,1375
W01000802,0,2,7,15,2331,2355
W01000877,1,3,11,8,1525,1548
W01000878,1,4,6,15,1197,1223
W01000809,7,15,12,54,1516,1604
W01000811,4,12,10,13,1551,1590
W01000812,24,19,14,28,1349,1434
W01000813,9,1,10,29,1575,1624
W01000814,5,22,28,46,1464,1565
W01000817,13,18,14,33,1691,1769
W01000818,2,2,6,20,1506,1536
W01000819,3,7,1,8,1418,1437
W01000820,5,1,8,13,1368,1395
W01000821,6,6,2,23,1457,1494
W01000822,8,9,4,14,1206,1241
W01000794,14,17,21,61,2063,2176
W01000797,1,5,5,22,1481,1514
W01000798,2,4,4,29,1377,1416
W01000799,4,7,13,31,1880,1935
W01000830,8,36,18,35,1596,1693
W01000832,20,26,14,21,1523,1604
W01000833,20,34,23,54,1619,1750
W01000834,0,30,18,17,1480,1545
W01000836,37,45,21,117,2054,2274
W01000759,1,0,5,23,1537,1566
W01000777,1,2,19,24,1736,1782
W01000778,13,4,7,30,1836,1890
W01000779,2,5,26,17,1490,1540
W01000760,12,6,13,42,1597,1670
W01000761,6,19,15,39,1490,1569
W01000762,5,25,12,36,1516,1594
W01000831,15,39,24,58,1670,1806
W01000835,4,2,16,27,1398,1447
W01000738,2,20,14,4,1728,1768
W01000739,14,13,21,40,1752,1840
W01000740,1,8,5,19,1625,1658
W01000741,3,6,17,33,1532,1591
W01000763,2,5,8,13,1496,1524
W01000764,3,15,6,71,1554,1649
W01000765,0,7,17,44,1592,1660
W01000766,2,11,16,15,1541,1585
W01000767,1,6,10,12,1525,1554
W01000742,15,42,13,117,1394,1581
W01000744,8,24,18,79,1363,1492
W01000787,3,11,7,21,1509,1551
W01000788,6,10,8,50,1382,1456
W01000789,1,9,7,31,1375,1423
W01000790,11,7,31,352,1337,1738
W01000755,31,5,13,45,1863,1957
W01000756,14,4,14,15,1550,1597
W01000757,2,5,11,26,1448,1492
W01000758,49,11,22,88,1747,1917
W01000772,1,3,15,11,1553,1583
W01000828,1,1,7,1,1712,1722
W01000829,3,2,5,0,1903,1913
W01000862,41,25,31,87,1415,1599
W01000863,41,52,21,49,1423,1586
W01000864,26,77,17,44,1487,1651
W01000865,19,24,10,27,1272,1352
W01000866,31,23,9,31,1115,1209
W01000867,7,7,16,19,1250,1299
W01000768,7,1,13,4,1370,1395
W01000769,6,1,7,4,1394,1412
W01000770,10,0,13,14,1539,1576
W01000771,6,2,13,19,1291,1331
W01000849,9,17,13,44,1789,1872
W01000850,76,30,21,154,1979,2260
W01000851,6,17,26,57,1438,1544
W01000852,8,10,10,30,1453,1511
W01000853,10,7,15,53,1385,1470
W01000854,39,3,12,69,1295,1418
W01000855,7,2,10,51,1447,1517
W01000856,68,25,31,130,1511,1765
W01000857,65,5,23,76,1616,1785
W01000781,16,15,14,62,1594,1701
W01000782,9,1,10,7,1053,1080
W01001956,24,22,40,153,2682,2921
W01000747,57,52,25,357,1453,1944
W01000868,5,14,19,31,1279,1348
W01000869,32,29,20,130,1379,1590
W01000870,92,35,27,119,1338,1611
W01000872,24,11,17,47,1285,1384
W01000874,61,27,41,179,1777,2085
W01000745,136,81,40,424,1578,2259
W01000746,48,13,21,96,1527,1705
W01001938,159,19,22,138,831,1169
W01001955,64,99,24,167,1201,1555
W01001957,91,14,13,89,829,1036
W01001958,106,31,12,146,987,1282
W01000749,43,25,25,249,1518,1860
W01000871,13,54,21,218,1459,1765
W01000873,53,36,32,106,1582,1809
W01000875,15,107,29,180,1692,2023
W01000876,23,32,41,171,1783,2050
W01000858,17,7,22,79,1504,1629
W01000859,28,14,11,93,1269,1415
W01000860,23,5,16,96,1349,1489
W01000861,39,28,35,109,1602,1813
W01000736,8,1,8,8,1690,1715
W01000737,17,4,5,5,1505,1536
W01000804,6,4,26,60,1387,1483
W01000805,21,0,17,33,1122,1193
W01000879,29,4,12,24,1689,1758
W01000880,7,1,12,24,1535,1579
W01000881,16,0,11,34,1321,1382
W01000882,18,12,20,19,1660,1729
W01000775,1,2,8,4,1828,1843
W01000776,0,3,9,4,1837,1853
W01000839,1,0,12,3,995,1011
W01000840,0,4,12,4,1657,1677
W01000823,1,2,6,11,1708,1728
W01000824,4,2,14,9,1559,1588
W01000825,12,3,11,18,1393,1437
W01000826,16,1,15,14,1319,1365
W01000827,6,1,10,16,1325,1358
W01000918,0,5,3,5,1897,1910
W01000944,1,1,6,0,1186,1194
W01000965,0,0,10,6,2107,2123
W01000893,0,0,12,4,1973,1989
W01000925,1,0,4,0,1566,1571
W01000926,1,3,11,9,1835,1859
W01000888,2,0,12,17,2296,2327
W01000946,2,1,11,0,1590,1604
W01000947,1,3,13,9,2007,2033
W01000948,8,0,10,30,1736,1784
W01000955,1,1,9,7,1244,1262
W01000956,0,0,5,6,1169,1180
W01000971,0,1,6,14,1390,1411
W01000887,1,1,15,18,2365,2400
W01000953,0,0,6,11,1703,1720
W01000954,3,0,1,0,1411,1415
W01000970,0,2,6,12,1219,1239
W01000902,0,0,1,5,1054,1060
W01000903,0,0,2,7,1107,1116
W01000904,0,0,4,9,1516,1529
W01000905,1,1,12,14,1535,1563
W01000908,1,4,7,3,1669,1684
W01000906,1,1,7,9,1029,1047
W01000907,0,0,8,15,1729,1752
W01000922,0,0,9,7,1674,1690
W01000923,0,0,5,1,1466,1472
W01000934,7,3,6,18,1229,1263
W01000935,2,1,16,41,1520,1580
W01000938,1,3,16,13,1363,1396
W01000939,7,7,13,32,1203,1262
W01000940,0,1,5,11,1267,1284
W01000909,0,11,9,15,1181,1216
W01000910,0,6,2,14,1448,1470
W01000911,0,0,2,15,1237,1254
W01000969,0,3,13,11,1233,1260
W01000912,1,3,4,1,1220,1229
W01000913,1,4,5,12,1140,1162
W01000914,0,14,5,33,1547,1599
W01000915,0,0,4,10,1191,1205
W01000916,1,0,9,2,1194,1206
W01000917,15,7,20,39,2571,2652
W01000920,0,1,12,4,1239,1256
W01000921,0,2,6,7,1554,1569
W01000924,0,0,1,5,1090,1096
W01000930,0,2,13,6,1341,1362
W01000936,2,1,19,9,1487,1518
W01000941,6,5,17,25,1488,1541
W01000942,1,4,21,21,1840,1887
W01000943,0,4,4,7,1532,1547
W01000894,16,0,2,12,1340,1370
W01000895,8,4,13,23,1491,1539
W01000896,2,12,4,3,1665,1686
W01000897,3,0,8,20,1285,1316
W01000937,6,2,25,26,1981,2040
W01000898,1,2,6,7,1454,1470
W01000899,1,1,4,2,1671,1679
W01000900,2,2,13,8,1684,1709
W01000901,1,0,7,6,1666,1680
W01000945,0,0,2,13,1137,1152
W01000889,2,7,13,10,1757,1789
W01000890,1,2,10,12,1631,1656
W01000891,0,0,7,7,1501,1515
W01000892,0,8,14,14,1823,1859
W01000883,0,4,5,14,1381,1404
W01000958,2,3,15,10,1649,1679
W01000961,3,1,14,10,1583,1611
W01000962,0,6,24,12,1535,1577
W01000963,1,4,17,18,1752,1792
W01000964,4,0,10,9,1722,1745
W01000884,0,9,14,27,1194,1244
W01000885,4,11,13,53,1244,1325
W01000886,3,16,18,46,1396,1479
W01000957,1,19,15,29,1612,1676
W01000959,2,2,17,12,1785,1818
W01000960,5,7,16,30,1664,1722
W01000949,1,2,11,15,1308,1337
W01000950,1,3,27,57,1462,1550
W01000951,3,28,30,94,1428,1583
W01000952,0,2,10,50,1109,1171
W01000966,0,3,12,14,1403,1432
W01000932,0,0,1,11,1031,1043
W01000933,1,3,14,36,1920,1974
W01000967,0,1,11,18,1440,1470
W01000968,2,1,11,19,1864,1897
W01000919,0,4,9,3,1156,1172
W01000927,0,1,6,5,1632,1644
W01000928,0,4,8,15,1576,1603
W01000929,0,2,8,8,1289,1307
W01000931,0,12,10,8,1300,1330
W01000973,3,5,6,2,1464,1480
W01001900,0,0,13,12,1514,1539
W01000991,0,0,8,5,1118,1131
W01000992,0,1,11,11,1482,1505
W01000993,1,0,6,6,1512,1525
W01000994,0,1,5,4,1388,1398
W01000995,0,0,3,2,1431,1436
W01001014,1,6,6,23,1604,1640
W01001015,2,4,5,2,1462,1475
W01001017,0,0,5,13,1459,1477
W01001018,0,6,4,11,1366,1387
W01001020,2,0,5,3,1426,1436
W01000976,3,1,7,3,1091,1105
W01000977,0,0,11,14,1363,1388
W01001024,0,8,6,2,1128,1144
W01001025,0,1,11,12,1176,1200
W01001033,0,11,22,6,1699,1738
W01001034,1,13,10,10,1345,1379
W01000975,0,3,14,8,2228,2253
W01000978,0,4,14,0,1771,1789
W01001009,2,1,2,4,1234,1243
W01001042,1,1,4,6,1326,1338
W01001043,0,0,3,5,1153,1161
W01001012,0,0,8,6,1549,1563
W01001013,0,0,16,11,1442,1469
W01001016,0,7,6,10,1635,1658
W01001019,1,0,2,4,1505,1512
W01000974,5,15,7,32,1980,2039
W01001057,1,3,3,16,1412,1435
W01001058,0,4,5,5,1918,1932
W01000986,0,1,16,5,1297,1319
W01000987,3,5,19,42,2183,2252
W01001055,1,2,12,1,1209,1225
W01001056,0,4,7,4,1203,1218
W01000996,4,1,6,3,1467,1481
W01001048,2,3,6,23,1367,1401
W01001049,0,8,3,4,1300,1315
W01001050,7,7,3,20,1502,1539
W01001051,1,5,13,8,1769,1796
W01001052,0,2,8,4,1340,1354
W01001004,0,2,5,7,1072,1086
W01001005,1,1,11,18,1657,1688
W01001006,0,1,15,13,2348,2377
W01001007,1,6,7,17,1717,1748
W01001039,0,0,11,13,1640,1664
W01001040,0,0,15,6,1470,1491
W01000999,0,0,6,8,1371,1385
W01001000,2,3,8,4,1759,1776
W01001001,1,1,6,6,1435,1449
W01001002,3,3,12,27,2404,2449
W01000998,12,35,75,44,2427,2593
W01001008,14,3,8,40,2082,2147
W01001038,17,6,17,184,1997,2221
W01000997,2,5,4,15,1511,1537
W01001010,1,2,6,9,1201,1219
W01001011,4,1,11,15,1353,1384
W01001026,2,8,15,43,1927,1995
W01000989,1,1,14,13,1384,1413
W01001037,3,1,9,14,1566,1593
W01001041,10,7,21,57,2352,2447
W01001021,7,3,19,50,1524,1603
W01001022,5,1,15,11,1361,1393
W01001023,6,2,17,42,1629,1696
W01001028,4,3,14,30,1804,1855
W01001035,5,12,16,37,1552,1622
W01000979,1,4,21,45,1631,1702
W01000983,7,1,13,19,1499,1539
W01000985,3,3,20,8,1365,1399
W01001003,0,3,9,14,1339,1365
W01000980,2,1,18,27,1335,1383
W01000981,2,2,10,10,1162,1186
W01000982,4,5,8,31,1452,1500
W01000984,14,2,19,27,2095,2157
W01000990,4,3,11,28,1473,1519
W01001027,6,1,7,9,1548,1571
W01001036,0,5,11,19,1549,1584
W01001918,2,10,13,33,1535,1593
W01001919,3,10,29,53,1310,1405
W01001920,6,4,14,9,1173,1206
W01001921,12,6,13,49,1497,1577
W01001031,2,0,7,12,1503,1524
W01001032,0,0,19,8,1742,1769
W01001046,3,5,28,16,1723,1775
W01001047,1,1,7,3,1662,1674
W01001053,1,0,5,5,999,1010
W01001054,2,1,5,6,1243,1257
W01001029,0,6,12,8,1773,1799
W01001030,1,2,11,7,1788,1809
W01001044,11,3,6,16,1627,1663
W01001045,0,2,23,16,1684,1725
W01001105,7,4,12,17,2603,2643
W01001127,1,1,8,5,1184,1199
W01001128,2,1,9,2,1425,1439
W01001082,5,1,8,4,1482,1500
W01001083,0,1,14,4,1592,1611
W01001084,0,2,19,2,1540,1563
W01001085,2,2,14,12,1476,1506
W01001113,12,3,21,14,2239,2289
W01001119,8,3,15,17,1688,1731
W01001135,3,0,19,15,1457,1494
W01001136,1,2,10,27,1125,1165
W01001075,0,1,22,18,1156,1197
W01001076,6,7,19,62,1367,1461
W01001077,2,3,16,12,1399,1432
W01001078,3,4,15,24,1217,1263
W01001104,16,17,45,163,1736,1977
W01001129,0,5,23,4,1352,1384
W01001116,6,2,29,30,2034,2101
W01001123,11,5,11,27,1579,1633
W01001124,8,2,19,87,1347,1463
W01001125,4,3,15,42,1407,1471
W01001126,15,22,23,42,1809,1911
W01001130,6,2,23,29,1219,1279
W01001086,0,3,13,17,1458,1491
W01001087,0,1,20,19,1503,1543
W01001088,2,8,20,19,1778,1827
W01001089,1,3,29,12,1423,1468
W01001090,1,0,19,18,1432,1470
W01001081,1,4,18,5,1524,1552
W01001092,3,6,22,15,1660,1706
W01001094,1,6,31,12,1283,1333
W01001095,7,5,31,7,1459,1509
W01001096,3,7,14,6,1344,1374
W01001097,21,5,28,22,1603,1679
W01001114,3,2,24,25,1511,1565
W01001115,11,7,32,76,2044,2170
W01001131,2,17,29,52,1653,1753
W01001132,6,1,18,20,1325,1370
W01001133,9,9,16,39,1956,2029
W01001134,7,1,12,12,1112,1144
W01001067,12,7,15,34,1312,1380
W01001068,5,1,44,57,1660,1767
W01001070,3,5,29,38,1068,1143
W01001071,7,6,18,61,1485,1577
W01001072,3,14,59,37,2563,2676
W01001091,0,5,20,11,1626,1662
W01001098,0,4,12,10,1045,1071
W01001100,4,1,7,28,1460,1500
W01001103,4,4,16,15,1205,1244
W01001106,1,2,16,3,1401,1423
W01001107,3,1,8,6,1529,1547
W01001109,2,1,6,1,1463,1473
W01001110,18,35,35,94,1388,1570
W01001111,0,0,9,11,1462,1482
W01001112,1,2,9,5,1424,1441
W01001063,16,13,43,63,1607,1742
W01001065,1,11,16,42,1525,1595
W01001069,1,4,30,23,1401,1459
W01001079,1,11,31,37,1535,1615
W01001080,8,14,26,26,1507,1581
W01001910,12,13,37,86,1508,1656
W01001911,1,10,27,22,1135,1195
W01001062,2,9,28,12,1330,1381
W01001064,2,8,14,12,1409,1445
W01001093,0,6,22,13,1757,1798
W01001099,0,12,18,6,1305,1341
W01001101,8,7,33,28,1424,1500
W01001102,6,7,28,14,1490,1545
W01001108,4,19,23,20,1619,1685
W01001117,0,1,11,0,1404,1416
W01001118,7,11,25,5,2332,2380
W01001120,1,3,13,9,1354,1380
W01001121,1,2,16,12,1514,1545
W01001122,2,29,48,15,2856,2950
W01001059,4,2,15,11,1288,1320
W01001060,3,1,8,6,1418,1436
W01001061,6,9,31,18,2080,2144
W01001066,1,19,32,27,1496,1575
W01001073,1,2,32,14,1952,2001
W01001777,8,1,14,64,1409,1496
W01001778,25,8,41,99,1700,1873
W01001794,17,8,17,35,1343,1420
W01001799,4,1,10,42,1222,1279
W01001793,14,9,35,45,1324,1427
W01001795,3,4,29,59,1452,1547
W01001796,15,9,17,38,1412,1491
W01001798,7,7,12,26,1429,1481
W01001841,54,25,41,128,1777,2025
W01001842,68,26,30,120,1504,1748
W01001843,83,38,65,245,1736,2167
W01001844,48,18,74,137,1751,2028
W01001849,6,2,24,33,1493,1558
W01001852,6,2,18,44,1747,1817
W01001853,9,4,11,34,1504,1562
W01001854,7,4,21,20,1520,1572
W01001791,24,8,42,36,1515,1625
W01001792,18,30,47,52,1554,1701
W01001797,9,6,21,28,1375,1439
W01001800,8,25,45,60,1427,1565
W01001949,40,18,39,90,1094,1281
W01001953,11,14,32,53,1389,1499
W01001820,5,2,17,33,1139,1196
W01001846,4,2,23,65,1633,1727
W01001847,13,8,17,58,1439,1535
W01001948,17,5,35,76,1485,1618
W01001954,23,7,23,33,1451,1537
W01001802,6,6,37,62,1477,1588
W01001807,22,33,64,33,1415,1567
W01001808,11,49,90,54,1430,1634
W01001840,18,10,41,86,1597,1752
W01001730,34,18,22,115,1300,1489
W01001731,33,12,20,121,1260,1446
W01001736,22,5,35,75,1258,1395
W01001815,28,12,40,40,1233,1353
W01001811,31,39,45,122,1266,1503
W01001816,85,57,87,162,2234,2625
W01001817,30,16,34,52,1274,1406
W01001818,53,23,55,136,1261,1528
W01001888,19,11,22,58,1576,1686
W01001893,6,7,43,44,1771,1871
W01001894,4,16,18,46,1505,1589
W01001895,20,28,37,39,1510,1634
W01001877,19,8,39,59,1585,1710
W01001878,22,36,49,45,1422,1574
W01001882,46,18,38,62,1660,1824
W01001885,33,21,49,102,1812,2017
W01001773,133,15,71,274,2031,2524
W01001848,2,3,29,32,1381,1447
W01001850,8,1,21,30,1871,1931
W01001851,17,3,20,16,1426,1482
W01001879,34,51,81,98,1640,1904
W01001880,35,75,92,53,1299,1554
W01001881,18,29,64,40,1287,1438
W01001884,20,72,73,20,1189,1374
W01001727,6,2,17,18,1097,1140
W01001728,4,1,13,12,1448,1478
W01001729,6,5,48,121,2023,2203
W01001819,7,1,16,42,2221,2287
W01001803,3,29,36,65,1440,1573
W01001804,14,39,64,36,1413,1566
W01001805,7,69,47,42,1325,1490
W01001806,9,24,47,52,1510,1642
W01001866,19,21,33,35,1402,1510
W01001867,12,50,46,20,1301,1429
W01001883,11,45,66,26,1452,1600
W01001886,3,23,38,11,1124,1199
W01001809,14,19,30,80,1166,1309
W01001810,18,23,75,127,1435,1678
W01001812,12,15,41,96,1128,1292
W01001813,22,27,51,122,1297,1519
W01001814,16,30,37,60,1278,1421
W01001769,10,4,22,47,1519,1602
W01001770,7,13,19,107,961,1107
W01001771,25,9,24,92,1495,1645
W01001774,6,18,15,72,1288,1399
W01001732,31,4,37,166,1353,1591
W01001733,80,18,33,309,1637,2077
W01001734,41,9,40,252,1184,1526
W01001735,33,38,36,227,1290,1624
W01001887,1,4,25,11,1532,1573
W01001889,11,3,26,37,1469,1546
W01001891,4,3,30,28,1594,1659
W01001892,2,7,6,2,1420,1437
W01001896,7,1,26,26,1473,1533
W01001772,8,3,33,47,1322,1413
W01001775,18,24,34,83,1433,1592
W01001776,51,5,9,94,1188,1347
W01001890,9,13,29,60,1499,1610
W01001863,2,10,20,24,1508,1564
W01001864,14,15,40,48,1388,1505
W01001865,9,4,23,26,1259,1321
W01001868,2,24,55,49,1368,1498
W01001785,4,17,38,79,1045,1183
W01001786,15,27,46,27,1440,1555
W01001787,16,22,53,161,1209,1461
W01001788,18,39,57,96,1221,1431
W01001789,5,9,25,34,1454,1527
W01001790,4,11,46,56,1070,1187
W01001821,28,21,49,185,1554,1837
W01001826,37,9,15,141,1151,1353
W01001827,30,4,45,178,1353,1610
W01001828,13,9,24,122,1367,1535
W01001755,28,16,30,165,1193,1432
W01001756,39,50,105,508,3107,3809
W01001757,42,33,33,263,1122,1493
W01001758,39,48,22,271,1676,2056
W01001779,8,1,33,39,1364,1445
W01001780,14,28,48,116,1544,1750
W01001781,11,10,24,67,1624,1736
W01001782,17,6,44,45,1325,1437
W01001783,22,7,20,87,1132,1268
W01001784,6,4,14,85,1252,1361
W01001747,11,34,46,60,1473,1624
W01001748,5,15,40,33,1476,1569
W01001749,11,16,36,33,1392,1488
W01001751,17,45,65,49,1485,1661
W01001718,38,31,60,253,1298,1680
W01001719,32,40,45,306,1641,2064
W01001720,37,31,36,155,1633,1892
W01001722,36,15,38,139,1343,1571
W01001726,26,23,49,238,1379,1715
W01001822,7,21,52,164,1403,1647
W01001823,8,5,31,72,1218,1334
W01001824,20,19,40,227,1260,1566
W01001825,54,32,68,192,1429,1775
W01001831,30,35,36,248,1216,1565
W01001836,19,18,37,250,1275,1599
W01001837,23,26,43,294,1138,1524
W01001838,28,16,50,390,1298,1782
W01001839,38,24,45,257,1245,1609
W01001750,18,22,36,35,1539,1650
W01001752,1,1,25,25,1573,1625
W01001753,17,46,73,79,1438,1653
W01001754,18,30,46,68,1549,1711
W01001721,73,71,66,461,2235,2906
W01001724,14,23,43,135,1769,1984
W01001725,66,32,56,236,1824,2214
W01001922,25,24,54,305,1568,1976
W01001939,289,9,21,168,533,1020
W01001941,245,21,43,190,600,1099
W01001829,39,35,52,335,1346,1807
W01001830,53,63,71,264,1187,1638
W01001832,49,30,31,287,1390,1787
W01001833,25,20,40,134,1407,1626
W01001834,34,40,60,178,1295,1607
W01001835,37,52,36,150,1347,1622
W01001858,8,27,52,72,1535,1694
W01001859,15,16,27,60,1303,1421
W01001860,22,11,50,115,1509,1707
W01001861,31,32,26,145,1475,1709
W01001714,7,12,29,56,1418,1522
W01001715,12,18,31,80,1430,1571
W01001716,3,8,28,63,1172,1274
W01001717,23,15,46,97,1399,1580
W01001694,74,129,72,299,1387,1961
W01001695,176,235,166,257,2409,3243
W01001696,47,119,93,171,1123,1553
W01001697,48,66,47,175,1310,1646
W01001698,92,97,102,370,1307,1968
W01001870,4,57,55,73,1188,1377
W01001871,23,53,66,56,1396,1594
W01001875,111,80,113,291,2100,2695
W01001876,19,46,51,80,1351,1547
W01001869,15,39,48,55,1238,1395
W01001872,43,35,40,127,1280,1525
W01001873,29,77,75,175,1343,1699
W01001874,29,146,87,101,1066,1429
W01001737,15,36,58,80,1396,1585
W01001738,2,25,64,60,1270,1421
W01001739,17,53,63,62,1166,1361
W01001740,13,33,52,60,1363,1521
W01001741,14,28,95,71,1411,1619
W01001709,41,40,65,239,1513,1898
W01001710,28,24,44,177,1324,1597
W01001711,47,42,45,235,1263,1632
W01001712,9,31,31,88,1347,1506
W01001713,33,54,66,180,1391,1724
W01001704,3,37,48,39,1425,1552
W01001706,8,14,51,8,1163,1244
W01001707,13,17,80,63,1895,2068
W01001746,16,39,74,50,1363,1542
W01001855,74,71,68,697,889,1799
W01001856,91,170,74,806,711,1852
W01001857,94,129,58,425,1150,1856
W01001862,101,115,71,645,801,1733
W01001742,7,28,74,26,1380,1515
W01001743,4,9,24,11,1376,1424
W01001744,12,45,65,24,1446,1592
W01001745,1,5,34,18,1297,1355
W01001764,70,253,67,596,1007,1993
W01001765,65,100,62,467,724,1418
W01001766,61,129,100,444,929,1663
W01001767,88,137,61,302,1070,1658
W01001768,87,197,52,670,685,1691
W01001702,3,33,74,46,1694,1850
W01001703,7,10,39,29,1181,1266
W01001705,19,55,68,25,1609,1776
W01001708,14,12,50,45,1441,1562
W01001759,56,73,45,235,1179,1588
W01001760,89,151,120,255,1078,1693
W01001761,80,126,84,457,1043,1790
W01001762,125,218,102,247,1053,1745
W01001940,36,19,46,108,902,1111
W01001943,65,53,34,95,851,1098
W01001944,18,57,31,74,847,1027
W01001945,23,24,39,136,1081,1303
W01001947,22,70,48,122,1242,1504
W01001699,379,579,218,253,769,2198
W01001942,123,151,132,118,831,1355
W01001946,55,152,95,107,930,1339
W01001950,34,40,36,140,832,1082
W01001951,43,66,48,78,781,1016
W01001952,75,180,28,118,837,1238
W01001186,2,3,14,7,1727,1753
W01001187,1,6,3,26,1357,1393
W01001188,0,0,9,8,1021,1038
W01001221,0,0,13,10,1444,1467
W01001222,0,45,15,21,1515,1596
W01001233,0,2,8,5,1685,1700
W01001148,6,0,11,40,1605,1662
W01001152,9,0,8,8,1559,1584
W01001153,0,2,7,18,1472,1499
W01001155,2,1,8,21,1502,1534
W01001149,1,9,14,21,1383,1428
W01001150,8,0,10,40,1612,1670
W01001151,0,3,4,13,1659,1679
W01001154,0,3,9,20,1373,1405
W01001156,3,1,5,10,1527,1546
W01001147,1,3,6,42,1749,1801
W01001168,1,3,12,23,1418,1457
W01001169,1,1,22,33,1669,1726
W01001170,0,2,8,10,1198,1218
W01001137,8,9,28,21,2323,2389
W01001138,3,14,8,11,1326,1362
W01001139,0,5,2,13,1453,1473
W01001140,1,7,5,10,1409,1432
W01001141,7,14,2,6,1588,1617
W01001142,1,9,7,17,1558,1592
W01001204,1,2,8,7,1303,1321
W01001205,2,2,2,8,1574,1588
W01001206,0,0,2,1,1479,1482
W01001207,1,54,11,34,1287,1387
W01001208,1,2,8,15,1570,1596
W01001265,0,1,12,11,1511,1535
W01001266,4,3,4,20,1312,1343
W01001267,0,1,8,4,1410,1423
W01001268,0,1,6,4,1415,1426
W01001209,3,8,7,7,1378,1403
W01001210,7,2,1,12,1427,1449
W01001211,4,1,4,6,1580,1595
W01001212,1,5,5,1,1330,1342
W01001175,0,0,7,5,1427,1439
W01001177,0,3,10,4,1262,1279
W01001202,0,1,4,9,1766,1780
W01001203,1,0,7,5,1367,1380
W01001269,1,1,4,6,1404,1416
W01001270,0,0,7,13,1425,1445
W01001271,1,0,4,12,1603,1620
W01001272,1,2,9,7,1526,1545
W01001273,4,1,4,4,1655,1668
W01001213,1,1,8,25,1326,1361
W01001214,0,1,5,5,1288,1299
W01001215,1,5,7,6,1018,1037
W01001216,0,1,2,2,1530,1535
W01001143,4,5,15,14,1562,1600
W01001144,1,9,5,13,1578,1606
W01001145,0,13,8,15,1729,1765
W01001146,0,4,10,27,1378,1419
W01001176,0,8,2,9,1441,1460
W01001274,3,17,4,12,1308,1344
W01001275,5,9,11,7,1775,1807
W01001276,7,24,6,17,1341,1395
W01001200,1,1,5,4,998,1009
W01001201,1,7,13,46,1171,1238
W01001260,1,3,7,18,1062,1091
W01001285,0,7,12,13,1419,1451
W01001286,3,4,5,7,1516,1535
W01001287,0,5,8,9,1434,1456
W01001288,3,2,12,27,1368,1412
W01001180,1,5,15,28,1414,1463
W01001181,2,7,10,3,1374,1396
W01001282,5,7,18,11,1959,2000
W01001283,0,3,4,10,1486,1503
W01001284,1,3,3,12,1142,1161
W01001166,0,5,5,13,1298,1321
W01001167,0,8,10,6,1454,1478
W01001247,10,18,9,11,1648,1696
W01001248,1,47,4,43,1959,2054
W01001171,0,3,8,7,1242,1260
W01001229,0,2,14,29,1388,1433
W01001230,1,1,16,15,1570,1603
W01001231,8,1,6,11,1514,1540
W01001280,1,36,19,22,1553,1631
W01001281,0,3,8,11,1667,1689
W01001217,0,8,8,23,1163,1202
W01001218,0,0,4,7,1530,1541
W01001219,0,3,5,13,1311,1332
W01001220,0,0,6,1,1472,1479
W01001259,1,1,11,4,1674,1691
W01001261,0,32,7,25,1194,1258
W01001164,2,5,10,19,1515,1551
W01001165,1,2,8,20,1273,1304
W01001256,1,4,14,10,1193,1222
W01001257,2,0,8,13,1244,1267
W01001258,2,7,7,13,1236,1265
W01001172,2,10,3,5,1472,1492
W01001173,0,0,8,8,1352,1368
W01001174,2,0,11,6,1366,1385
W01001232,7,26,9,22,1330,1394
W01001182,6,22,21,23,1407,1479
W01001183,4,34,16,39,918,1011
W01001227,11,2,14,19,1288,1334
W01001228,0,10,19,30,1443,1502
W01001234,1,0,7,5,1443,1456
W01001235,2,5,4,17,1657,1685
W01001236,1,2,9,9,1495,1516
W01001185,0,16,7,25,1577,1625
W01001237,2,4,3,5,1453,1467
W01001238,0,6,4,15,1648,1673
W01001262,18,88,24,106,1120,1356
W01001263,20,173,26,256,1236,1711
W01001264,22,173,28,226,1634,2083
W01001178,1,1,11,13,1683,1709
W01001179,0,2,5,10,1710,1727
W01001253,2,1,12,0,1413,1428
W01001255,1,0,6,23,1568,1598
W01001914,0,0,7,22,1812,1841
W01001917,7,0,4,12,1484,1507
W01001249,0,0,2,36,1351,1389
W01001250,0,0,5,14,1439,1458
W01001251,0,1,18,24,1514,1557
W01001252,0,0,6,17,1500,1523
W01001162,1,7,20,25,1665,1718
W01001244,2,4,9,17,1332,1364
W01001245,0,7,6,26,1264,1303
W01001246,0,4,7,37,1333,1381
W01001184,5,8,7,23,1920,1963
W01001239,4,1,10,26,1324,1365
W01001240,2,5,7,13,1918,1945
W01001241,2,18,35,22,1650,1727
W01001196,1,0,14,15,1545,1575
W01001197,3,5,4,18,1228,1258
W01001198,0,1,10,9,1536,1556
W01001199,7,0,16,10,1677,1710
W01001915,2,2,12,6,1752,1774
W01001916,4,2,7,32,1484,1529
W01001157,0,0,8,17,1361,1386
W01001158,1,1,13,13,1463,1491
W01001159,0,2,6,18,1253,1279
W01001277,0,2,18,15,1176,1211
W01001278,0,0,10,13,1131,1154
W01001279,0,11,4,10,1157,1182
W01001160,1,1,9,9,1574,1594
W01001161,4,7,17,12,2184,2224
W01001189,0,5,6,13,1639,1663
W01001190,8,6,23,81,2413,2531
W01001193,1,1,9,2,1200,1213
W01001194,1,2,15,24,2123,2165
W01001195,2,14,15,14,1453,1498
W01001242,2,4,17,31,1303,1357
W01001243,0,8,16,36,1317,1377
W01001191,1,7,24,18,2444,2494
W01001192,0,3,5,13,1470,1491
W01001223,2,4,15,14,1558,1593
W01001224,0,10,18,50,2051,2129
W01001225,3,7,25,32,1507,1574
W01001226,0,4,26,24,1665,1719
W01001295,1,13,8,19,1533,1574
W01001296,1,0,8,17,1651,1677
W01001297,3,1,10,6,1870,1890
W01001298,7,10,18,28,1722,1785
W01001310,2,0,16,19,1593,1630
W01001311,4,5,12,6,1165,1192
W01001291,3,8,20,26,1788,1845
W01001294,0,1,12,18,1613,1644
W01001305,3,3,9,10,1267,1292
W01001306,4,1,10,25,1509,1549
W01001324,10,1,15,25,1982,2033
W01001292,8,17,18,28,1659,1730
W01001293,3,1,14,9,1623,1650
W01001307,1,0,6,18,1460,1485
W01001315,10,16,25,46,1612,1709
W01001314,2,0,13,10,2154,2179
W01001316,9,2,21,27,2803,2862
W01001317,6,0,15,9,1569,1599
W01001318,2,0,5,2,1492,1501
W01001289,0,1,7,4,1380,1392
W01001302,1,0,6,1,1116,1124
W01001303,1,1,4,10,1184,1200
W01001304,0,8,11,5,1483,1507
W01001312,0,2,10,5,1540,1557
W01001313,2,1,7,11,1539,1560
W01001290,2,2,17,10,1854,1885
W01001319,1,1,11,21,1612,1646
W01001320,1,0,7,9,1529,1546
W01001321,2,1,9,8,1552,1572
W01001322,14,1,6,32,1539,1592
W01001299,2,2,21,74,1517,1616
W01001300,1,23,14,75,1640,1753
W01001301,0,9,40,38,1824,1911
W01001308,0,6,18,27,1269,1320
W01001309,2,4,10,8,1253,1277
W01001898,2,2,9,10,1495,1518
W01001374,0,0,1,2,1459,1462
W01001375,1,1,6,21,1446,1475
W01001376,0,0,7,10,1513,1530
W01001406,6,4,7,13,1894,1924
W01001428,0,15,4,3,1275,1297
W01001429,2,0,4,6,1145,1157
W01001360,0,2,8,0,1347,1357
W01001361,0,0,2,9,1239,1250
W01001384,2,3,8,12,1622,1647
W01001385,0,1,8,4,1563,1576
W01001386,0,0,8,12,1723,1743
W01001325,1,1,5,10,1523,1540
W01001326,1,1,15,23,2062,2102
W01001362,0,2,3,18,2039,2062
W01001336,6,1,8,3,1419,1437
W01001337,1,1,4,13,1539,1558
W01001338,2,0,12,8,1722,1744
W01001339,0,5,8,13,1431,1457
W01001334,1,0,15,4,1475,1495
W01001335,1,0,8,4,1261,1274
W01001347,1,3,12,14,1412,1442
W01001351,1,2,3,11,1487,1504
W01001356,0,5,5,6,1243,1259
W01001357,2,2,9,12,1575,1600
W01001358,0,1,10,2,1527,1540
W01001359,0,2,11,8,1527,1548
W01001390,0,0,3,12,1828,1843
W01001391,1,3,9,8,1618,1639
W01001352,1,5,18,22,1799,1845
W01001353,0,0,1,8,1586,1595
W01001387,4,3,5,10,1263,1285
W01001388,3,3,12,36,1801,1855
W01001389,1,0,6,1,1154,1162
W01001414,2,0,8,13,1577,1600
W01001415,2,1,8,10,1786,1807
W01001416,0,2,9,7,1444,1462
W01001417,1,1,10,3,1475,1490
W01001418,0,2,11,4,1441,1458
W01001348,0,1,20,12,1779,1812
W01001349,16,3,11,27,1914,1971
W01001350,7,2,15,14,1729,1767
W01001392,2,1,14,11,1741,1769
W01001380,2,0,5,6,1802,1815
W01001381,1,0,7,11,1516,1535
W01001382,1,0,18,17,1617,1653
W01001383,6,3,22,11,1464,1506
W01001401,1,0,13,13,1916,1943
W01001402,4,1,3,3,1688,1699
W01001403,3,1,5,13,1599,1621
W01001404,1,0,1,5,1405,1412
W01001405,0,0,9,2,1866,1877
W01001363,1,0,6,10,1476,1493
W01001364,0,0,5,21,1904,1930
W01001365,0,6,18,11,2090,2125
W01001369,1,1,18,9,2213,2242
W01001377,0,4,20,16,1503,1543
W01001378,2,0,7,7,1576,1592
W01001379,3,6,7,3,1493,1512
W01001432,4,2,21,24,2159,2210
W01001433,3,5,16,28,1361,1413
W01001434,0,0,14,6,1400,1420
W01001327,0,0,22,9,2138,2169
W01001328,1,2,13,9,1581,1606
W01001329,2,0,14,8,1553,1577
W01001354,1,1,16,5,1623,1646
W01001355,2,2,9,4,1602,1619
W01001430,3,2,15,6,2341,2367
W01001431,0,3,8,5,1565,1581
W01001407,2,3,15,4,1392,1416
W01001408,1,6,7,8,1493,1515
W01001409,2,1,7,3,1664,1677
W01001410,7,5,20,5,1819,1856
W01001411,2,1,8,13,1685,1709
W01001412,3,6,8,22,1654,1693
W01001413,1,3,10,23,1790,1827
W01001330,4,0,5,6,1458,1473
W01001331,13,5,12,15,1740,1785
W01001332,4,1,8,9,1904,1926
W01001333,3,0,11,9,1592,1615
W01001366,0,0,10,12,1670,1692
W01001367,0,1,13,7,1495,1516
W01001368,7,0,11,7,1528,1553
W01001393,1,2,18,9,1315,1345
W01001397,0,3,27,23,1679,1732
W01001400,1,2,9,25,1417,1454
W01001340,1,1,7,4,1796,1809
W01001341,2,2,8,6,1789,1807
W01001344,1,4,13,10,1680,1708
W01001346,3,7,4,8,1513,1535
W01001342,1,0,10,5,1152,1168
W01001343,0,1,13,7,1173,1194
W01001345,2,0,9,11,1515,1537
W01001419,1,6,12,29,1508,1556
W01001371,1,1,19,20,1409,1450
W01001372,2,11,12,19,1899,1943
W01001373,2,1,13,8,1668,1692
W01001420,4,1,14,13,1273,1305
W01001421,3,1,14,9,1516,1543
W01001422,0,5,15,22,1530,1572
W01001370,2,6,11,24,1643,1686
W01001394,0,1,7,10,1359,1377
W01001395,2,5,16,16,1416,1455
W01001396,0,3,15,16,1632,1666
W01001399,1,5,10,5,1295,1316
W01001398,0,14,14,51,2428,2507
W01001423,1,0,9,21,1386,1417
W01001424,0,1,5,38,1453,1497
W01001425,3,2,25,25,1565,1620
W01001426,5,1,14,24,1337,1381
W01001427,1,6,23,44,1761,1835
W01001440,0,0,6,2,1372,1380
W01001441,0,4,6,9,1229,1248
W01001442,0,1,6,11,1220,1238
W01001470,2,1,3,18,1458,1482
W01001471,0,3,9,6,1734,1752
W01001446,2,0,2,9,1260,1273
W01001447,2,0,19,9,1540,1570
W01001448,4,9,2,35,1188,1238
W01001449,1,2,1,28,1417,1449
W01001472,1,0,16,10,1446,1473
W01001473,1,0,12,0,1386,1399
W01001474,2,3,17,15,1512,1549
W01001475,0,1,11,16,1181,1209
W01001480,0,0,5,9,1481,1495
W01001438,0,0,3,5,1417,1425
W01001439,2,1,2,15,1665,1685
W01001456,1,1,5,12,1302,1321
W01001457,0,1,7,1,1700,1709
W01001458,6,2,7,23,1493,1531
W01001443,1,1,6,8,1353,1369
W01001444,1,0,8,1,1923,1933
W01001445,0,3,24,14,1465,1506
W01001467,0,5,6,10,1925,1946
W01001468,1,0,9,12,1356,1378
W01001469,1,1,11,3,1295,1311
W01001462,5,0,2,12,1499,1518
W01001463,0,1,7,3,1881,1892
W01001478,5,2,9,14,1441,1471
W01001479,7,0,7,6,1491,1511
W01001481,26,2,13,14,1531,1586
W01001450,0,0,2,12,1296,1310
W01001451,2,2,5,0,1420,1429
W01001452,2,3,16,17,1518,1556
W01001459,0,1,5,0,1105,1111
W01001460,0,21,6,18,1698,1743
W01001461,7,4,4,26,1379,1420
W01001435,0,0,2,14,1426,1442
W01001436,1,1,18,8,1385,1413
W01001437,0,0,10,6,1545,1561
W01001453,3,0,11,7,1542,1563
W01001454,0,0,9,5,1390,1404
W01001455,0,2,10,8,1716,1736
W01001464,2,3,14,6,1519,1544
W01001465,2,3,6,2,1553,1566
W01001466,0,7,10,4,1666,1687
W01001476,0,3,9,7,1020,1039
W01001477,0,1,16,15,1411,1443
W01001487,3,1,7,1,1538,1550
W01001488,1,0,11,8,1572,1592
W01001489,1,2,8,26,1579,1616
W01001490,0,2,2,10,1283,1297
W01001482,3,0,6,1,1203,1213
W01001483,1,2,3,6,1366,1378
W01001484,1,1,12,10,1716,1740
W01001485,2,1,2,4,1202,1211
W01001486,2,1,4,14,1501,1522
W01001525,0,1,7,5,1528,1541
W01001529,4,0,10,17,2032,2063
W01001530,6,4,24,11,1799,1844
W01001531,2,1,14,3,1742,1762
W01001491,1,7,9,13,1778,1808
W01001496,1,5,11,25,1396,1438
W01001523,6,1,5,8,1472,1492
W01001524,3,2,11,12,1808,1836
W01001540,0,1,7,1,1263,1272
W01001541,0,0,4,0,1158,1162
W01001510,1,0,2,8,1511,1522
W01001511,1,0,6,2,1595,1604
W01001512,0,0,3,4,1350,1357
W01001513,0,0,4,14,1485,1503
W01001514,0,2,5,13,1160,1180
W01001515,0,7,11,9,1485,1512
W01001516,0,0,8,7,1419,1434
W01001517,0,0,10,23,1951,1984
W01001518,1,1,4,3,1098,1107
W01001519,0,3,23,38,1287,1351
W01001520,0,0,9,12,1780,1801
W01001521,9,1,9,26,1407,1452
W01001522,16,2,12,6,1665,1701
W01001537,0,1,12,8,1179,1200
W01001493,1,15,14,32,1879,1941
W01001494,0,4,10,10,1485,1509
W01001495,1,6,11,20,1758,1796
W01001507,1,4,20,26,1962,2013
W01001501,1,5,18,3,1317,1344
W01001503,1,4,12,28,1350,1395
W01001536,3,4,20,7,1195,1229
W01001538,0,1,11,11,1304,1327
W01001539,1,4,11,9,1447,1472
W01001506,0,9,13,68,1311,1401
W01001526,1,6,7,20,1307,1341
W01001527,1,1,6,35,1163,1206
W01001528,2,0,2,1,1113,1118
W01001532,0,3,17,18,1718,1756
W01001497,0,0,7,8,1512,1527
W01001498,0,4,6,5,1161,1176
W01001499,1,1,13,18,1170,1203
W01001500,1,4,11,36,1271,1323
W01001502,1,3,17,5,1303,1329
W01001492,2,5,12,24,2292,2335
W01001533,3,4,9,23,1598,1637
W01001534,1,3,20,16,1444,1484
W01001535,2,1,10,12,1310,1335
W01001504,2,5,13,69,1956,2045
W01001505,2,15,18,87,1958,2080
W01001508,1,6,11,33,1175,1226
W01001509,1,3,9,5,1464,1482
W01001545,17,2,10,25,1404,1458
W01001548,2,3,13,4,2099,2121
W01001557,4,11,20,70,1748,1853
W01001571,1,0,9,4,1241,1255
W01001579,1,1,12,34,1413,1461
W01001546,7,7,24,56,1443,1537
W01001558,1,7,20,36,1463,1527
W01001580,4,6,17,21,1743,1791
W01001909,11,7,16,35,2582,2651
W01001561,1,2,3,11,1463,1480
W01001562,1,0,8,6,1391,1406
W01001563,3,2,3,7,998,1013
W01001564,5,6,18,13,2277,2319
W01001569,1,5,11,18,1412,1447
W01001552,1,1,12,25,1525,1564
W01001553,6,2,25,32,2681,2746
W01001554,1,6,18,85,1581,1691
W01001576,0,4,5,26,1053,1088
W01001577,1,1,6,19,1273,1300
W01001599,2,1,11,16,2089,2119
W01001566,2,1,8,8,1249,1268
W01001567,1,2,9,3,1001,1016
W01001568,3,1,8,6,1737,1755
W01001575,0,3,11,2,1237,1253
W01001581,0,1,6,3,1918,1928
W01001555,2,0,3,2,1182,1189
W01001556,1,4,9,3,1187,1204
W01001560,0,2,12,3,1282,1299
W01001565,1,0,12,7,1841,1861
W01001596,2,16,11,9,1294,1332
W01001597,2,6,5,12,1477,1502
W01001549,4,1,7,7,1461,1480
W01001583,4,0,13,4,1597,1618
W01001585,2,0,15,8,1274,1299
W01001586,10,1,21,19,2466,2517
W01001594,7,0,3,1,1424,1435
W01001595,0,0,8,7,1309,1324
W01001559,1,0,4,15,1336,1356
W01001584,1,1,7,2,1880,1891
W01001587,0,6,16,30,1795,1847
W01001592,2,4,27,11,1669,1713
W01001593,3,1,9,13,1701,1727
W01001542,0,1,3,8,1779,1791
W01001543,0,1,14,13,1412,1440
W01001578,2,3,11,10,2107,2133
W01001590,1,1,18,22,2159,2201
W01001551,1,1,3,9,1165,1179
W01001588,1,1,8,14,1688,1712
W01001589,1,0,9,40,1417,1467
W01001598,1,1,13,8,1642,1665
W01001908,0,1,10,13,2117,2141
W01001572,0,2,13,4,1564,1583
W01001573,0,0,12,2,1489,1503
W01001574,2,4,11,15,1455,1487
W01001582,1,3,10,16,1783,1813
W01001591,1,1,4,8,1553,1567
W01001623,4,4,13,37,1433,1491
W01001624,1,7,15,11,1241,1275
W01001625,0,4,7,9,1259,1279
W01001626,3,11,9,15,1356,1394
W01001627,0,22,13,16,1502,1553
W01001628,0,13,18,21,1017,1069
W01001651,13,0,6,15,1491,1525
W01001652,7,17,36,33,1680,1773
W01001653,9,8,3,6,1423,1449
W01001654,12,4,25,23,1565,1629
W01001655,4,9,14,14,1580,1621
W01001617,13,41,29,8,1198,1289
W01001618,6,24,27,11,1055,1123
W01001619,6,30,32,5,1313,1386
W01001620,10,35,24,7,1090,1166
W01001621,1,23,26,24,1294,1368
W01001622,2,12,14,1,1245,1274
W01001639,12,6,21,116,1756,1911
W01001640,4,1,9,2,1130,1146
W01001641,5,7,14,30,1312,1368
W01001649,3,1,11,15,1442,1472
W01001650,1,5,17,12,1454,1489
W01001614,7,20,19,40,1410,1496
W01001615,12,9,19,39,1452,1531
W01001616,6,12,7,28,1383,1436
W01001678,11,21,41,31,1505,1609
W01001601,24,55,53,71,1260,1463
W01001681,15,66,53,45,1136,1315
W01001682,13,19,14,16,1245,1307
W01001683,5,16,18,7,1058,1104
W01001684,11,28,21,36,1313,1409
W01001675,12,19,34,87,1398,1550
W01001676,25,42,47,134,1405,1653
W01001677,2,8,21,24,1406,1461
W01001679,0,3,7,38,1107,1155
W01001680,7,19,28,52,1141,1247
W01001606,2,0,31,26,1218,1277
W01001608,1,5,27,49,1462,1544
W01001663,4,23,26,49,1398,1500
W01001665,18,16,23,37,1567,1661
W01001669,1,1,10,33,1305,1350
W01001670,17,7,16,70,2275,2385
W01001672,5,24,24,61,1647,1761
W01001673,1,3,14,29,1402,1449
W01001674,7,12,29,27,1414,1489
W01001664,2,21,20,34,1348,1425
W01001666,0,14,28,5,1430,1477
W01001667,0,24,38,12,1273,1347
W01001668,1,14,10,1,1114,1140
W01001611,7,14,28,142,1128,1319
W01001612,5,17,27,141,1369,1559
W01001613,6,11,6,118,1413,1554
W01001691,15,35,23,123,1283,1479
W01001692,29,70,66,469,1354,1988
W01001600,4,4,28,83,1465,1584
W01001602,14,6,13,25,1455,1513
W01001603,7,23,36,171,1151,1388
W01001604,10,17,17,74,1348,1466
W01001642,17,47,40,33,1554,1691
W01001643,14,56,68,114,1234,1486
W01001644,46,20,66,275,2274,2681
W01001690,46,117,69,349,1635,2216
W01001693,41,88,34,864,754,1781
W01001605,21,50,25,133,1139,1368
W01001685,32,57,31,167,1365,1652
W01001686,23,31,22,124,1192,1392
W01001687,95,140,40,403,1051,1729
W01001607,5,44,43,82,1249,1423
W01001609,3,24,47,18,1375,1467
W01001610,10,25,24,12,1230,1301
W01001645,3,15,19,11,1315,1363
W01001646,12,65,56,63,1924,2120
W01001647,8,9,10,18,1438,1483
W01001648,0,9,26,27,1467,1529
W01001635,3,7,13,18,1307,1348
W01001637,4,23,29,24,1644,1724
W01001638,0,4,6,6,1174,1190
W01001671,7,36,26,34,1621,1724
W01001629,9,18,15,28,1325,1395
W01001630,15,5,40,27,1375,1462
W01001631,8,3,21,27,1364,1423
W01001632,1,10,33,50,1283,1377
W01001659,137,119,108,410,1029,1803
W01001660,64,80,60,377,988,1569
W01001661,191,122,111,478,1697,2599
W01001662,89,124,51,368,715,1347
W01001633,6,29,44,93,1363,1535
W01001634,18,34,28,98,1351,1529
W01001688,22,44,68,115,2399,2648
W01001689,14,33,50,44,1632,1773
W01001636,21,11,20,60,1785,1897
W01001657,9,9,24,21,1402,1465
W01001658,6,11,22,43,1803,1885
W01001912,5,6,15,54,1400,1480
W01001913,11,28,43,60,1298,1440
